INSEE_COM;Annee;Nb_mutations;NbMaisons;NbApparts;propmaison;propappart;PrixMoyen;Prixm2Moyen;SurfaceMoy
01001;2023;8;8;0;100;0;269375;2249.5;118.125
01002;2023;2;2;0;100;0;199350;1913.5;96
01004;2023;158;89;69;56.3291139240506;43.6708860759494;210114.639240506;2399.62025316456;89.6392405063291
01005;2023;27;22;5;81.4814814814815;18.5185185185185;357840.259259259;3287.96296296296;109.185185185185
01007;2023;39;38;1;97.4358974358974;2.56410256410256;231436.461538462;2274.87179487179;105.230769230769
01008;2023;5;5;0;100;0;182550;2538.8;72.4
01009;2023;6;4;2;66.6666666666667;33.3333333333333;222916.666666667;1862.66666666667;112.166666666667
01010;2023;18;10;8;55.5555555555556;44.4444444444444;191888.833333333;2795.94444444444;71.5
01011;2023;5;4;1;80;20;193800;2210.8;92.8
01012;2023;8;8;0;100;0;162462.5;1925.375;90.5
01013;2023;2;2;0;100;0;77000;1006.5;70.5
01014;2023;20;12;8;60;40;168688.25;1763.6;90.25
01015;2023;9;9;0;100;0;216688.888888889;1926.55555555556;109.777777777778
01016;2023;4;4;0;100;0;209375;2274;91.75
01017;2023;9;8;1;88.8888888888889;11.1111111111111;117111.111111111;1388.33333333333;81.3333333333333
01021;2023;6;5;1;83.3333333333333;16.6666666666667;403089.166666667;4077.33333333333;99.6666666666667
01022;2023;17;16;1;94.1176470588235;5.88235294117647;198789.705882353;2069.82352941176;96.3529411764706
01023;2023;1;1;0;100;0;155000;1845;84
01024;2023;29;24;5;82.7586206896552;17.2413793103448;257846.551724138;2348.79310344828;114.931034482759
01025;2023;33;32;1;96.969696969697;3.03030303030303;232281.212121212;2112.09090909091;112.757575757576
01026;2023;6;6;0;100;0;226000;2300.33333333333;110.166666666667
01027;2023;10;10;0;100;0;294626.5;3153.4;100.7
01028;2023;6;6;0;100;0;271783.333333333;2622.5;111.5
01029;2023;7;7;0;100;0;166428.571428571;1778.14285714286;95.8571428571429
01030;2023;9;8;1;88.8888888888889;11.1111111111111;198744.444444444;2287;87.5555555555556
01031;2023;26;10;16;38.4615384615385;61.5384615384615;142051.923076923;1913.38461538462;72.4230769230769
01032;2023;21;16;5;76.1904761904762;23.8095238095238;295619.904761905;3371.09523809524;94.7142857142857
01033;2023;210;63;147;30;70;186027.576190476;2444.85238095238;77.7428571428571
01034;2023;94;46;48;48.936170212766;51.063829787234;184513.404255319;2048.74468085106;89.6914893617021
01035;2023;5;4;1;80;20;210900;2369;88.2
01036;2023;15;15;0;100;0;200233.333333333;2036.8;105.333333333333
01037;2023;4;4;0;100;0;167750;2470.75;63
01038;2023;4;4;0;100;0;213750;1586;115
01039;2023;2;2;0;100;0;77100;1396;71
01040;2023;3;3;0;100;0;153333.333333333;1399.66666666667;120.666666666667
01041;2023;7;7;0;100;0;198714.285714286;2167.14285714286;91.7142857142857
01042;2023;2;2;0;100;0;228250;2939.5;78
01043;2023;45;34;11;75.5555555555556;24.4444444444444;414462.822222222;3926.64444444444;105.844444444444
01044;2023;4;4;0;100;0;305950;2707.75;111
01045;2023;2;2;0;100;0;306000;2232.5;131
01046;2023;13;13;0;100;0;310196.153846154;2275.84615384615;139.769230769231
01047;2023;10;10;0;100;0;387710;2989.5;140.4
01049;2023;35;28;7;80;20;302524.428571429;3244.14285714286;94.0571428571429
01050;2023;6;6;0;100;0;185833.333333333;1763.5;108.666666666667
01051;2023;1;1;0;100;0;80000;1127;71
01052;2023;2;2;0;100;0;216650;1885;109
01053;2023;596;100;496;16.7785234899329;83.2214765100671;148151.008389262;2258.12080536913;70.1342281879195
01054;2023;14;14;0;100;0;305632.142857143;2817.14285714286;110.928571428571
01056;2023;3;3;0;100;0;155000;1400.33333333333;143.666666666667
01057;2023;6;6;0;100;0;242000;2238.66666666667;107.5
01058;2023;11;11;0;100;0;240486.363636364;2240.54545454545;107.909090909091
01061;2023;14;14;0;100;0;294636.642857143;2430.35714285714;123.571428571429
01062;2023;5;5;0;100;0;428932;3683.2;131.4
01063;2023;3;2;1;66.6666666666667;33.3333333333333;205833.333333333;1691;99.6666666666667
01064;2023;11;11;0;100;0;200936.363636364;2087.36363636364;98.2727272727273
01065;2023;16;16;0;100;0;294936.1875;2491.4375;119
01066;2023;2;2;0;100;0;141000;1713;80.5
01067;2023;2;2;0;100;0;215500;1701;126.5
01068;2023;4;3;1;75;25;71750;1235.5;59
01069;2023;14;11;3;78.5714285714286;21.4285714285714;254076.785714286;2236.35714285714;115.714285714286
01071;2023;64;26;38;40.625;59.375;471991.921875;4799.765625;99.1875
01072;2023;38;35;3;92.1052631578947;7.89473684210526;300624.315789474;2501.18421052632;118.368421052632
01073;2023;12;12;0;100;0;195541.666666667;1968.5;99.75
01074;2023;17;10;7;58.8235294117647;41.1764705882353;232647.058823529;2609.64705882353;95.9411764705882
01075;2023;16;12;4;75;25;330500.5;3188.4375;112.9375
01076;2023;1;0;1;0;100;40000;702;57
01077;2023;3;3;0;100;0;128333.333333333;1463.33333333333;85.6666666666667
01078;2023;16;10;6;62.5;37.5;607350.625;4764.625;137.875
01079;2023;4;4;0;100;0;240302;2100.75;112.75
01080;2023;4;4;0;100;0;162925;1922;93.25
01081;2023;8;5;3;62.5;37.5;215834.75;2087.875;110.75
01082;2023;4;3;1;75;25;213425;2249.75;94.75
01083;2023;15;15;0;100;0;379080.266666667;3029.8;123.733333333333
01084;2023;7;7;0;100;0;192714.285714286;1882.57142857143;103
01085;2023;1;1;0;100;0;142000;1420;100
01087;2023;3;3;0;100;0;111666.666666667;1307.33333333333;78.6666666666667
01088;2023;11;11;0;100;0;347409.090909091;3323.18181818182;106
01089;2023;19;19;0;100;0;225926.578947368;2335.05263157895;97.4736842105263
01090;2023;4;4;0;100;0;228102;1647.75;129.25
01092;2023;14;13;1;92.8571428571429;7.14285714285714;230728.571428571;2411.64285714286;96.3571428571429
01093;2023;59;34;25;57.6271186440678;42.3728813559322;258094.830508475;2890.37288135593;90.0847457627119
01094;2023;10;10;0;100;0;257899;2200;121.4
01095;2023;9;8;1;88.8888888888889;11.1111111111111;104000;1304.33333333333;91.4444444444444
01096;2023;7;6;1;85.7142857142857;14.2857142857143;224048.571428571;2597.14285714286;88.5714285714286
01098;2023;12;12;0;100;0;239372.916666667;2097.16666666667;114.416666666667
01099;2023;13;12;1;92.3076923076923;7.69230769230769;274159.230769231;3086.61538461538;92.5384615384615
01100;2023;2;2;0;100;0;60000;842;71
01101;2023;1;1;0;100;0;310000;2541;122
01102;2023;11;11;0;100;0;223760;2333.27272727273;96.8181818181818
01103;2023;23;13;10;56.5217391304348;43.4782608695652;508298;4689.95652173913;108.391304347826
01104;2023;4;3;1;75;25;195000;2234;87.75
01105;2023;15;13;2;86.6666666666667;13.3333333333333;378181.666666667;3830.86666666667;99.8666666666667
01106;2023;2;2;0;100;0;226000;2495.5;90.5
01107;2023;2;2;0;100;0;191500;1191;160.5
01108;2023;20;17;3;85;15;178400;1552.3;110
01109;2023;38;22;16;57.8947368421053;42.1052631578947;344304.605263158;3944.81578947368;87.5263157894737
01110;2023;1;1;0;100;0;160000;1860;86
01111;2023;6;6;0;100;0;129500;1996.16666666667;90.5
01112;2023;7;7;0;100;0;234135.714285714;2209.85714285714;112.285714285714
01113;2023;5;4;1;80;20;184600;1526.4;129.6
01114;2023;7;6;1;85.7142857142857;14.2857142857143;306714.285714286;2754.14285714286;109.428571428571
01115;2023;11;10;1;90.9090909090909;9.09090909090909;234185.454545455;2102.18181818182;109.818181818182
01116;2023;12;11;1;91.6666666666667;8.33333333333333;194083.333333333;1917.83333333333;103.083333333333
01117;2023;2;2;0;100;0;204000;2015.5;101.5
01118;2023;12;9;3;75;25;247145.833333333;2760;88.6666666666667
01121;2023;1;1;0;100;0;169000;538;314
01123;2023;13;13;0;100;0;278615.384615385;2553.92307692308;110.538461538462
01124;2023;11;11;0;100;0;169318.181818182;1882.27272727273;99.2727272727273
01125;2023;16;16;0;100;0;143007.5625;1343;93.375
01127;2023;9;9;0;100;0;288673.333333333;1634.77777777778;179.444444444444
01128;2023;4;4;0;100;0;183500;1790.5;102.5
01129;2023;2;2;0;100;0;209000;3353;65
01130;2023;18;17;1;94.4444444444444;5.55555555555556;230347.222222222;2041.77777777778;109.5
01133;2023;3;3;0;100;0;270000;2414;106.333333333333
01134;2023;13;13;0;100;0;295947.692307692;2281.46153846154;137.538461538462
01135;2023;20;16;4;80;20;678713.25;4990.1;132.8
01136;2023;7;7;0;100;0;264965.714285714;2524.14285714286;114
01138;2023;35;26;9;74.2857142857143;25.7142857142857;184667.6;2053.68571428571;93.2
01139;2023;5;5;0;100;0;168700;2078.2;85
01140;2023;4;4;0;100;0;329750;2260.75;156.25
01141;2023;5;5;0;100;0;221620;1951.6;110
01142;2023;47;31;16;65.9574468085106;34.0425531914894;299550.553191489;3417.3829787234;89.7446808510638
01143;2023;153;36;117;23.5294117647059;76.4705882352941;603682.803921569;5986.08496732026;100.535947712418
01145;2023;9;9;0;100;0;259100;2554.77777777778;107.666666666667
01146;2023;6;6;0;100;0;250625;2771;91.8333333333333
01147;2023;6;6;0;100;0;242501.666666667;2182.33333333333;113
01148;2023;10;9;1;90;10;197430;2148;89.2
01149;2023;7;7;0;100;0;275104.285714286;2481.57142857143;107
01150;2023;3;3;0;100;0;221633.333333333;1706.66666666667;134.666666666667
01151;2023;14;14;0;100;0;275976.571428571;2551.78571428571;108.714285714286
01152;2023;6;5;1;83.3333333333333;16.6666666666667;275000;3313.5;86.1666666666667
01153;2023;29;21;8;72.4137931034483;27.5862068965517;584525.551724138;4787.93103448276;122.448275862069
01155;2023;3;3;0;100;0;223050;1424.66666666667;154.333333333333
01156;2023;7;7;0;100;0;392465.714285714;3708.57142857143;107.428571428571
01157;2023;18;16;2;88.8888888888889;11.1111111111111;374479.444444444;3050.33333333333;121.444444444444
01158;2023;15;11;4;73.3333333333333;26.6666666666667;509688.8;4074.06666666667;128.333333333333
01159;2023;32;26;6;81.25;18.75;198897.8125;2157.96875;91.5625
01160;2023;149;9;140;6.04026845637584;93.9597315436242;362270.167785235;4744.95973154362;76.013422818792
01163;2023;16;16;0;100;0;187765.625;2090.5;104.4375
01165;2023;11;11;0;100;0;266700;3111.63636363636;94.1818181818182
01166;2023;47;40;7;85.1063829787234;14.8936170212766;278979.638297872;2925.89361702128;94.6170212765958
01167;2023;6;6;0;100;0;302504.333333333;2598.66666666667;118.166666666667
01169;2023;4;4;0;100;0;320000;2470.25;117.75
01170;2023;2;2;0;100;0;201500;2829.5;72.5
01171;2023;6;6;0;100;0;186666.666666667;1916.83333333333;96.6666666666667
01173;2023;217;46;171;21.1981566820277;78.8018433179724;323208.276497696;4410.76958525346;74.4930875576037
01174;2023;2;2;0;100;0;222500;2347;95
01175;2023;6;6;0;100;0;197407;1819;105.333333333333
01177;2023;2;2;0;100;0;166173;1080;149
01179;2023;19;18;1;94.7368421052632;5.26315789473684;256423.263157895;2381.31578947368;111.736842105263
01180;2023;9;4;5;44.4444444444444;55.5555555555556;850917.111111111;6125.77777777778;131.111111111111
01181;2023;3;2;1;66.6666666666667;33.3333333333333;76166.6666666667;857;82
01183;2023;19;19;0;100;0;288280;2614.63157894737;111.473684210526
01184;2023;8;8;0;100;0;206756.25;2519.25;93
01185;2023;63;47;16;74.6031746031746;25.3968253968254;156406.222222222;1741.07936507937;92.1904761904762
01187;2023;12;11;1;91.6666666666667;8.33333333333333;225465.833333333;2298.33333333333;116.833333333333
01188;2023;4;4;0;100;0;420750;3425.25;119
01189;2023;7;7;0;100;0;310622.142857143;2998;104.428571428571
01190;2023;2;2;0;100;0;160515;1381.5;116.5
01191;2023;2;2;0;100;0;162500;1262.5;167
01192;2023;15;15;0;100;0;194990.733333333;1912.8;104.466666666667
01193;2023;1;1;0;100;0;150000;2344;64
01194;2023;57;37;20;64.9122807017544;35.0877192982456;298370.877192982;3153.33333333333;95.5614035087719
01195;2023;16;14;2;87.5;12.5;249804.75;2476.1875;101.375
01196;2023;14;14;0;100;0;183714.285714286;1866.28571428571;105.357142857143
01197;2023;4;4;0;100;0;183875;2218.75;86.5
01199;2023;24;17;7;70.8333333333333;29.1666666666667;152250;1852.20833333333;83.4166666666667
01200;2023;2;1;1;50;50;77500;1424.5;54.5
01202;2023;73;48;25;65.7534246575342;34.2465753424658;225640.301369863;2444.56164383562;91.8356164383562
01203;2023;11;11;0;100;0;306413;2630.81818181818;117.727272727273
01204;2023;6;6;0;100;0;208500;2250.83333333333;106.666666666667
01206;2023;2;2;0;100;0;111000;1216.5;88.5
01207;2023;3;3;0;100;0;287216.666666667;2066.66666666667;138.333333333333
01208;2023;1;1;0;100;0;185000;1762;105
01209;2023;12;10;2;83.3333333333333;16.6666666666667;391966.666666667;3686.66666666667;107.166666666667
01210;2023;23;2;21;8.69565217391304;91.304347826087;110342.130434783;2633.4347826087;45.1304347826087
01211;2023;14;14;0;100;0;199667.785714286;2112.64285714286;96.2857142857143
01212;2023;12;10;2;83.3333333333333;16.6666666666667;151833.333333333;1676.33333333333;96.5833333333333
01213;2023;16;15;1;93.75;6.25;232784.375;2667.5;89.9375
01214;2023;2;2;0;100;0;99750;1075.5;91.5
01215;2023;1;1;0;100;0;235000;1865;126
01216;2023;9;9;0;100;0;205055.333333333;1956.88888888889;106.333333333333
01219;2023;3;3;0;100;0;144666.666666667;1771.33333333333;88
01224;2023;42;30;12;71.4285714285714;28.5714285714286;255838.952380952;2821.2380952381;91.1666666666667
01225;2023;4;4;0;100;0;382192.5;4196.75;93.5
01227;2023;4;4;0;100;0;208375;2098.5;100.25
01228;2023;5;5;0;100;0;217360;2196.4;97.2
01229;2023;5;4;1;80;20;206000;3354.4;84.8
01230;2023;3;3;0;100;0;143333.333333333;1390.66666666667;89.6666666666667
01231;2023;11;11;0;100;0;278951.818181818;2094.18181818182;132.363636363636
01232;2023;24;21;3;87.5;12.5;204633.416666667;1811.45833333333;114.916666666667
01233;2023;3;3;0;100;0;146333.333333333;1533.66666666667;94
01234;2023;2;2;0;100;0;39000;2586.5;25.5
01235;2023;14;13;1;92.8571428571429;7.14285714285714;322701.071428571;2757.07142857143;125.357142857143
01236;2023;10;10;0;100;0;224050;1800.1;124.7
01237;2023;8;7;1;87.5;12.5;227393.75;1963;115.875
01238;2023;13;13;0;100;0;267555.384615385;3118.76923076923;77.1538461538462
01239;2023;5;5;0;100;0;329940;2672.2;121.4
01240;2023;11;10;1;90.9090909090909;9.09090909090909;171382.727272727;1709.36363636364;97.9090909090909
01241;2023;11;11;0;100;0;190935.909090909;2004.81818181818;96.1818181818182
01242;2023;1;1;0;100;0;137000;895;153
01243;2023;10;10;0;100;0;374405;3765.3;105.8
01244;2023;77;44;33;57.1428571428571;42.8571428571429;271342.363636364;3002.32467532468;92.2337662337662
01245;2023;3;3;0;100;0;180000;1471.33333333333;123.333333333333
01246;2023;34;30;4;88.2352941176471;11.7647058823529;225113.529411765;2143.47058823529;110.617647058824
01247;2023;21;3;18;14.2857142857143;85.7142857142857;132028.571428571;2348.14285714286;53.3333333333333
01248;2023;13;9;4;69.2307692307692;30.7692307692308;389644.615384615;3998.30769230769;97.7692307692308
01249;2023;116;57;59;49.1379310344828;50.8620689655172;312889.706896552;3547.88793103448;88.448275862069
01250;2023;12;12;0;100;0;330291.666666667;3257.16666666667;102.5
01252;2023;9;9;0;100;0;275903.888888889;3085.22222222222;92.8888888888889
01254;2023;16;16;0;100;0;410968.375;3100.875;126.9375
01255;2023;12;12;0;100;0;145162.5;1593;89.9166666666667
01257;2023;3;3;0;100;0;360333.333333333;3469.66666666667;134.666666666667
01258;2023;10;10;0;100;0;240295;2433.8;95.5
01259;2023;3;3;0;100;0;253333.333333333;2247;110.333333333333
01260;2023;4;4;0;100;0;411500;3305.75;125
01261;2023;2;2;0;100;0;337500;2927;117
01262;2023;70;22;48;31.4285714285714;68.5714285714286;212459.157142857;2778.67142857143;80.3285714285714
01263;2023;37;29;8;78.3783783783784;21.6216216216216;285129.891891892;3070;93.5675675675676
01264;2023;9;9;0;100;0;291672.222222222;2535.44444444444;128.666666666667
01265;2023;15;7;8;46.6666666666667;53.3333333333333;156346;1841.33333333333;82.1333333333333
01266;2023;29;14;15;48.2758620689655;51.7241379310345;196015.103448276;2191.72413793103;88.2758620689655
01267;2023;4;4;0;100;0;248250;2361.5;106
01268;2023;3;3;0;100;0;281350;2885.33333333333;97.3333333333333
01269;2023;28;7;21;25;75;128930.357142857;1475.89285714286;90.5714285714286
01272;2023;16;16;0;100;0;244405.125;2417.25;102.375
01273;2023;19;19;0;100;0;184352.631578947;1882.78947368421;96.6842105263158
01274;2023;7;6;1;85.7142857142857;14.2857142857143;161142.857142857;1489.14285714286;138.285714285714
01275;2023;24;18;6;75;25;447483.625;4246.79166666667;104.333333333333
01276;2023;14;14;0;100;0;396620.285714286;3778.21428571429;107
01277;2023;2;2;0;100;0;51250;1088;44
01279;2023;1;1;0;100;0;1,00E+05;1250;80
01280;2023;3;3;0;100;0;162750;1567.66666666667;110
01281;2023;53;25;28;47.1698113207547;52.8301886792453;493849.339622642;5236.03773584906;94.7358490566038
01282;2023;4;4;0;100;0;113750;1050.75;92.25
01283;2023;140;48;92;34.2857142857143;65.7142857142857;135939.785714286;1595.7;84.8571428571429
01284;2023;7;7;0;100;0;219142.857142857;2638;84.4285714285714
01285;2023;9;9;0;100;0;304380;3573.77777777778;84.4444444444444
01286;2023;10;10;0;100;0;376961;2962.6;131.2
01288;2023;39;20;19;51.2820512820513;48.7179487179487;400385.538461538;4475.17948717949;94.3589743589744
01289;2023;69;50;19;72.463768115942;27.536231884058;232347.014492754;2401.60869565217;100.246376811594
01290;2023;9;5;4;55.5555555555556;44.4444444444444;320763.333333333;3244.44444444444;102.111111111111
01291;2023;12;12;0;100;0;302250;2476.25;130.75
01294;2023;5;5;0;100;0;224800;2223.6;97.6
01295;2023;4;3;1;75;25;228612.5;3101.75;76.5
01296;2023;1;1;0;100;0;310000;1834;169
01297;2023;2;2;0;100;0;245650;2930.5;84
01298;2023;2;2;0;100;0;263000;2531.5;104
01299;2023;6;5;1;83.3333333333333;16.6666666666667;297666.666666667;2671.5;111
01301;2023;43;38;5;88.3720930232558;11.6279069767442;234071.372093023;2276.81395348837;103.162790697674
01303;2023;17;17;0;100;0;212947.058823529;1930;109.941176470588
01304;2023;34;27;7;79.4117647058823;20.5882352941176;191036.294117647;2244.55882352941;85.4705882352941
01305;2023;26;14;12;53.8461538461538;46.1538461538462;160637.884615385;1872.5;88.1923076923077
01306;2023;15;6;9;40;60;152138.666666667;1797.6;86.2
01307;2023;5;3;2;60;40;165600;1930.4;89.6
01308;2023;14;13;1;92.8571428571429;7.14285714285714;343268.428571429;3247.21428571429;105.071428571429
01309;2023;1;1;0;100;0;27000;458;59
01310;2023;1;1;0;100;0;95000;633;150
01311;2023;2;2;0;100;0;1,00E+05;1479.5;69.5
01313;2023;137;50;87;36.4963503649635;63.5036496350365;555209.459854015;5657.49635036496;98.036496350365
01314;2023;22;19;3;86.3636363636364;13.6363636363636;238955.909090909;2565.5;95.1363636363636
01317;2023;5;5;0;100;0;226400;1624.8;136.2
01318;2023;2;2;0;100;0;266250;2045.5;134.5
01319;2023;4;4;0;100;0;404000;2883;156.25
01320;2023;27;23;4;85.1851851851852;14.8148148148148;229165.259259259;2479.25925925926;93
01321;2023;7;7;0;100;0;234438.571428571;3367.85714285714;127.714285714286
01322;2023;27;26;1;96.2962962962963;3.7037037037037;427804.037037037;3583.22222222222;120.259259259259
01323;2023;12;12;0;100;0;203170;2046.83333333333;97.5833333333333
01325;2023;11;11;0;100;0;280769.727272727;3185.45454545455;89.1818181818182
01328;2023;6;4;2;66.6666666666667;33.3333333333333;303823.333333333;2931.83333333333;113.666666666667
01329;2023;2;2;0;100;0;137000;2465.5;58.5
01332;2023;2;2;0;100;0;236012.5;2315;100.5
01333;2023;25;17;8;68;32;312512;3537.88;91.28
01334;2023;7;7;0;100;0;228000;1931.42857142857;119
01335;2023;3;3;0;100;0;277020;2578;105
01336;2023;5;5;0;100;0;261800;2292;116.8
01337;2023;16;16;0;100;0;260325;2103.1875;124.5
01338;2023;12;12;0;100;0;167042.166666667;1799.66666666667;91.9166666666667
01339;2023;11;11;0;100;0;582021.818181818;4565.36363636364;132.181818181818
01342;2023;1;1;0;100;0;504000;3452;146
01343;2023;14;14;0;100;0;267108.571428571;2240.64285714286;124.071428571429
01344;2023;64;55;9;85.9375;14.0625;239429.640625;2376;102.265625
01345;2023;24;18;6;75;25;217954.291666667;2374.70833333333;98.7083333333333
01346;2023;9;9;0;100;0;179277.777777778;1867.44444444444;96.1111111111111
01347;2023;17;16;1;94.1176470588235;5.88235294117647;410372.235294118;3772.52941176471;113.705882352941
01348;2023;27;25;2;92.5925925925926;7.40740740740741;308358.37037037;2711.25925925926;115
01349;2023;7;7;0;100;0;314699.285714286;3185.14285714286;105.714285714286
01350;2023;28;24;4;85.7142857142857;14.2857142857143;212693.928571429;2042.21428571429;101.714285714286
01351;2023;17;16;1;94.1176470588235;5.88235294117647;319071.176470588;2947.41176470588;116
01352;2023;2;2;0;100;0;262750;2275.5;115
01353;2023;16;14;2;87.5;12.5;385559.875;3174.5625;122.0625
01354;2023;183;41;142;22.4043715846995;77.5956284153005;408782.912568306;4674.44808743169;88.2349726775956
01355;2023;5;5;0;100;0;261686;2449.8;108.6
01357;2023;3;2;1;66.6666666666667;33.3333333333333;126666.666666667;1964;77.6666666666667
01358;2023;7;7;0;100;0;190657.714285714;2033.71428571429;97
01359;2023;3;3;0;100;0;324333.333333333;2750.33333333333;118.666666666667
01360;2023;31;19;12;61.2903225806452;38.7096774193548;526296.032258064;4665.29032258064;109.516129032258
01361;2023;21;19;2;90.4761904761905;9.52380952380952;348526.523809524;3523.61904761905;100.238095238095
01362;2023;9;7;2;77.7777777777778;22.2222222222222;457200;3380.11111111111;132.222222222222
01363;2023;17;17;0;100;0;245305.882352941;1926.29411764706;127.117647058824
01364;2023;11;11;0;100;0;186668.181818182;1722.63636363636;109
01365;2023;5;5;0;100;0;269540;2996.8;95.8
01366;2023;9;8;1;88.8888888888889;11.1111111111111;249777.777777778;2858.88888888889;84.1111111111111
01367;2023;12;12;0;100;0;188541.666666667;1695.33333333333;119.916666666667
01368;2023;8;8;0;100;0;315499.375;2782.375;120.125
01369;2023;7;7;0;100;0;323071.428571429;2501.28571428571;126.571428571429
01370;2023;38;5;33;13.1578947368421;86.8421052631579;144746.947368421;2192.89473684211;65.6052631578947
01371;2023;11;10;1;90.9090909090909;9.09090909090909;346739.090909091;3119.90909090909;112.909090909091
01372;2023;6;6;0;100;0;186916.666666667;1638.66666666667;108
01373;2023;2;2;0;100;0;160250;1580;99
01374;2023;20;20;0;100;0;195113.85;1944.95;98.75
01375;2023;6;6;0;100;0;273170;2731.66666666667;102.833333333333
01376;2023;50;21;29;42;58;273824.46;3253.94;84.7
01378;2023;20;17;3;85;15;337309.5;3183.5;106.9
01379;2023;7;5;2;71.4285714285714;28.5714285714286;158428.571428571;1691.85714285714;101.571428571429
01380;2023;6;6;0;100;0;197666.666666667;1679.33333333333;127.333333333333
01381;2023;7;7;0;100;0;237106.428571429;2039.42857142857;116.285714285714
01383;2023;16;14;2;87.5;12.5;221575;2400;92.8125
01384;2023;21;17;4;80.9523809523809;19.047619047619;118452.380952381;1837.7619047619;69.0952380952381
01385;2023;7;7;0;100;0;336738.714285714;2723.14285714286;122.428571428571
01386;2023;7;6;1;85.7142857142857;14.2857142857143;247814.285714286;2720.42857142857;96.5714285714286
01387;2023;3;3;0;100;0;212433.333333333;2040.33333333333;101.666666666667
01388;2023;10;9;1;90;10;199851;1999.9;99.4
01389;2023;20;16;4;80;20;288857.25;2795.35;103.4
01390;2023;4;4;0;100;0;251500;2582;106.75
01391;2023;3;3;0;100;0;187000;1544;123
01392;2023;2;2;0;100;0;103500;885;120
01393;2023;7;7;0;100;0;353857.142857143;2943.28571428571;121
01396;2023;6;4;2;66.6666666666667;33.3333333333333;127266.666666667;1738.83333333333;75
01397;2023;13;10;3;76.9230769230769;23.0769230769231;703978.461538462;5119.15384615385;140.461538461538
01398;2023;12;10;2;83.3333333333333;16.6666666666667;318203.333333333;2889.33333333333;110.75
01399;2023;33;18;15;54.5454545454545;45.4545454545455;438144.060606061;4661.63636363636;100.060606060606
01400;2023;1;1;0;100;0;110000;873;126
01401;2023;25;17;8;68;32;562206.6;4904.04;112.16
01402;2023;7;7;0;100;0;195950.142857143;1735.14285714286;112.857142857143
01403;2023;18;18;0;100;0;213666.666666667;2143.5;106.388888888889
01404;2023;2;2;0;100;0;171100;2139;82
01405;2023;9;5;4;55.5555555555556;44.4444444444444;175611.111111111;1782;94
01406;2023;2;2;0;100;0;317250;2611;120.5
01407;2023;22;12;10;54.5454545454545;45.4545454545455;211524.090909091;2515.18181818182;84.1818181818182
01408;2023;6;6;0;100;0;136750;1725.33333333333;86.8333333333333
01410;2023;7;6;1;85.7142857142857;14.2857142857143;197714.285714286;2064.28571428571;100.714285714286
01411;2023;3;3;0;100;0;167796.666666667;1791.33333333333;93.3333333333333
01412;2023;5;5;0;100;0;316755;2709;117
01415;2023;3;3;0;100;0;306666.666666667;2530.33333333333;122
01416;2023;10;7;3;70;30;141850;1441.2;94.1
01418;2023;10;10;0;100;0;383038;3895.4;96.2
01419;2023;64;32;32;50;50;467573.421875;4767.65625;101.0625
01420;2023;20;5;15;25;75;143295.05;1946.25;76.45
01421;2023;5;5;0;100;0;223400;2239.8;98.4
01422;2023;13;12;1;92.3076923076923;7.69230769230769;232693.461538462;2456.38461538462;102.461538461538
01423;2023;7;7;0;100;0;433621.428571429;4032.71428571429;108.142857142857
01424;2023;13;11;2;84.6153846153846;15.3846153846154;487490.769230769;4320.30769230769;112.923076923077
01425;2023;2;2;0;100;0;372500;2370;155.5
01426;2023;35;31;4;88.5714285714286;11.4285714285714;213642.8;2053.31428571429;107.914285714286
01427;2023;75;35;40;46.6666666666667;53.3333333333333;277707.56;3254.01333333333;86.4
01428;2023;1;1;0;100;0;365000;2325;157
01429;2023;4;4;0;100;0;227835;2311.25;97.75
01430;2023;6;6;0;100;0;182250;2469.66666666667;88.5
01431;2023;13;13;0;100;0;194515.153846154;2381.76923076923;86.8461538461538
01432;2023;3;3;0;100;0;179333.333333333;1853.66666666667;99.3333333333333
01433;2023;1;1;0;100;0;135000;1570;86
01434;2023;2;2;0;100;0;325780;3355.5;99
01435;2023;22;18;4;81.8181818181818;18.1818181818182;539365.863636364;4806.86363636364;116.454545454545
01436;2023;10;5;5;50;50;534271;4519.9;120.7
01437;2023;5;5;0;100;0;166300;1638;104
01441;2023;2;2;0;100;0;173000;1892;92
01443;2023;46;31;15;67.3913043478261;32.6086956521739;272916.413043478;3045.45652173913;92.8260869565217
01444;2023;18;16;2;88.8888888888889;11.1111111111111;131238.222222222;1827.83333333333;78.9444444444444
01445;2023;7;6;1;85.7142857142857;14.2857142857143;167271.428571429;1855;92.4285714285714
01446;2023;9;9;0;100;0;368246.666666667;3287.88888888889;117
01447;2023;15;13;2;86.6666666666667;13.3333333333333;175436.866666667;1725.6;104.866666666667
01448;2023;3;2;1;66.6666666666667;33.3333333333333;214000;2429.66666666667;91.6666666666667
01449;2023;5;5;0;100;0;259320;2507;107.2
01450;2023;40;35;5;87.5;12.5;323758.75;2950.975;113.775
01451;2023;55;51;4;92.7272727272727;7.27272727272727;277368.836363636;2689.98181818182;105.945454545455
01452;2023;15;10;5;66.6666666666667;33.3333333333333;124100;1706.8;76.1333333333333
01453;2023;6;6;0;100;0;212966.666666667;2100.5;96
01454;2023;14;10;4;71.4285714285714;28.5714285714286;261268.571428571;2493.92857142857;111.285714285714
01457;2023;40;26;14;65;35;202973.75;2364.525;86.95
02001;2023;2;2;0;100;0;140000;1478.5;102
02002;2023;10;10;0;100;0;126371.5;1035.6;124.1
02003;2023;13;13;0;100;0;142300;1578.76923076923;91.7692307692308
02004;2023;2;2;0;100;0;102825;1152.5;94
02005;2023;1;1;0;100;0;134700;2173;62
02006;2023;3;3;0;100;0;39333.3333333333;650;69
02008;2023;2;2;0;100;0;160950;1408.5;115.5
02010;2023;2;2;0;100;0;189500;1104;172
02011;2023;16;16;0;100;0;223240.5625;1725.875;134.5
02013;2023;5;5;0;100;0;152650;1925.6;93
02014;2023;2;2;0;100;0;163950;2136.5;97.5
02016;2023;2;2;0;100;0;137500;1556.5;88.5
02017;2023;6;6;0;100;0;64250;731.5;86.3333333333333
02018;2023;21;21;0;100;0;128823.80952381;1467.19047619048;90.6190476190476
02019;2023;1;1;0;100;0;90000;523;172
02020;2023;2;2;0;100;0;95000;1068;91
02021;2023;1;1;0;100;0;44000;587;75
02022;2023;6;6;0;100;0;163166.666666667;1622.33333333333;100.5
02023;2023;1;1;0;100;0;110000;1209;91
02025;2023;2;2;0;100;0;160000;1329.5;131.5
02027;2023;2;2;0;100;0;109950;1047;105.5
02028;2023;29;29;0;100;0;113616.793103448;1392.86206896552;83.0344827586207
02029;2023;4;4;0;100;0;160750;1780;104.5
02030;2023;4;4;0;100;0;98625;784.25;127.75
02031;2023;5;5;0;100;0;76300;850.8;88.8
02032;2023;4;4;0;100;0;82250;851.25;92.25
02033;2023;2;2;0;100;0;166442.5;1327;123
02034;2023;2;2;0;100;0;75802;1134;66.5
02035;2023;2;2;0;100;0;217800;978.5;194
02037;2023;10;10;0;100;0;161505;1491.4;106.8
02038;2023;2;2;0;100;0;135335;933.5;155
02040;2023;2;2;0;100;0;79250;1028.5;75
02041;2023;7;7;0;100;0;127200;1385.57142857143;91.4285714285714
02042;2023;4;4;0;100;0;157600;1524.25;103
02044;2023;2;2;0;100;0;57500;737.5;74
02046;2023;3;3;0;100;0;129750;1615.66666666667;81.3333333333333
02048;2023;1;1;0;100;0;150000;1293;116
02049;2023;8;8;0;100;0;107187.5;1064.125;97.375
02050;2023;3;3;0;100;0;110000;1339;82.6666666666667
02051;2023;4;4;0;100;0;88595;1471.75;63
02052;2023;1;1;0;100;0;158900;1528;104
02053;2023;6;6;0;100;0;176216.666666667;1802.66666666667;107.333333333333
02054;2023;1;1;0;100;0;132000;1571;84
02055;2023;2;2;0;100;0;111500;1135.5;97
02056;2023;5;5;0;100;0;80380;1002;85
02057;2023;8;8;0;100;0;77437.5;870.375;95
02058;2023;12;11;1;91.6666666666667;8.33333333333333;156184.166666667;1579.41666666667;96.3333333333333
02059;2023;23;21;2;91.304347826087;8.69565217391304;102839.130434783;1181.5652173913;88.5652173913043
02060;2023;1;1;0;100;0;121000;807;150
02061;2023;5;5;0;100;0;141870;1315.4;109.8
02062;2023;3;3;0;100;0;192320;1542.33333333333;151.333333333333
02063;2023;3;3;0;100;0;222066.666666667;1667;142.333333333333
02064;2023;30;30;0;100;0;135540.433333333;1700.46666666667;79.7666666666667
02065;2023;6;6;0;100;0;101400;1256.83333333333;105
02066;2023;1;1;0;100;0;1,00E+05;1299;77
02067;2023;2;2;0;100;0;181000;1898.5;93.5
02068;2023;4;4;0;100;0;120042.5;1370.25;88.5
02070;2023;6;6;0;100;0;83833.3333333333;863.5;103.333333333333
02071;2023;7;7;0;100;0;167714.285714286;1555.85714285714;110
02072;2023;1;1;0;100;0;53300;740;72
02073;2023;4;4;0;100;0;180431.25;2295.25;82.75
02074;2023;5;5;0;100;0;114154;1469.4;75.8
02075;2023;3;3;0;100;0;144333.333333333;1678;94.6666666666667
02076;2023;2;2;0;100;0;240000;2652;91
02077;2023;3;3;0;100;0;194666.666666667;2055.33333333333;96.6666666666667
02078;2023;2;2;0;100;0;131450;1488.5;88.5
02079;2023;2;2;0;100;0;116500;1161;94.5
02080;2023;4;4;0;100;0;171750;1567;115.25
02081;2023;3;3;0;100;0;141000;1082.66666666667;137.666666666667
02082;2023;2;2;0;100;0;80000;1420.5;63.5
02083;2023;7;7;0;100;0;141357.142857143;1484.57142857143;93.5714285714286
02084;2023;1;1;0;100;0;208000;1891;110
02085;2023;6;6;0;100;0;160333.333333333;1503.83333333333;103.166666666667
02086;2023;11;11;0;100;0;109063.636363636;1125.36363636364;95.0909090909091
02088;2023;1;1;0;100;0;110000;1392;79
02089;2023;8;8;0;100;0;153075;1671.125;90.125
02090;2023;4;4;0;100;0;181250;1471.5;156.5
02093;2023;15;15;0;100;0;125433.333333333;1356.26666666667;92.3333333333333
02094;2023;3;3;0;100;0;177333.333333333;1599.66666666667;106
02095;2023;49;46;3;93.8775510204082;6.12244897959184;69373.8775510204;810.265306122449;84.2448979591837
02096;2023;1;1;0;100;0;72400;746;97
02097;2023;2;2;0;100;0;117500;1056;111.5
02098;2023;2;2;0;100;0;196000;1414.5;139
02099;2023;2;2;0;100;0;346000;1370;256
02101;2023;2;2;0;100;0;96000;878;101.5
02103;2023;14;14;0;100;0;70555;808.285714285714;88.1428571428571
02104;2023;2;2;0;100;0;132250;1261.5;104
02105;2023;6;6;0;100;0;125528.333333333;1018.16666666667;125.666666666667
02106;2023;8;8;0;100;0;129063.75;1340.75;104.625
02108;2023;3;3;0;100;0;130700;1387.33333333333;94
02109;2023;4;4;0;100;0;127500;1002;132.5
02110;2023;23;21;2;91.304347826087;8.69565217391304;124986.956521739;1415.47826086957;100.521739130435
02111;2023;10;10;0;100;0;165587;1442.6;118.5
02112;2023;2;2;0;100;0;66000;858.5;76
02114;2023;11;10;1;90.9090909090909;9.09090909090909;166581.818181818;1999.45454545455;84.0909090909091
02115;2023;2;2;0;100;0;127375;1665.5;80
02116;2023;2;2;0;100;0;1,00E+05;841;124.5
02119;2023;5;5;0;100;0;121800;959;133.2
02120;2023;1;1;0;100;0;55500;505;110
02121;2023;3;3;0;100;0;106666.666666667;952.666666666667;125.333333333333
02123;2023;1;1;0;100;0;102000;1397;73
02124;2023;12;12;0;100;0;107229.166666667;1448.91666666667;72.8333333333333
02125;2023;5;5;0;100;0;176800;2402.6;86.8
02126;2023;3;3;0;100;0;92766.6666666667;1161.66666666667;97.6666666666667
02127;2023;2;2;0;100;0;103500;1641.5;71.5
02128;2023;25;25;0;100;0;147139.04;1534.88;99.72
02130;2023;2;2;0;100;0;157500;1126.5;139
02131;2023;9;9;0;100;0;138083.333333333;1677.44444444444;91.5555555555556
02132;2023;1;1;0;100;0;125000;1316;95
02133;2023;6;6;0;100;0;96416.6666666667;1355;75.6666666666667
02134;2023;9;9;0;100;0;118994.444444444;1229.66666666667;100
02135;2023;8;7;1;87.5;12.5;71456.25;779.25;90
02137;2023;1;1;0;100;0;165000;1269;130
02139;2023;6;6;0;100;0;152633.333333333;1549.83333333333;95
02140;2023;6;6;0;100;0;130033.333333333;1232.33333333333;121.333333333333
02141;2023;16;16;0;100;0;92125;1120.875;81.9375
02142;2023;1;1;0;100;0;225000;1630;138
02143;2023;3;3;0;100;0;74666.6666666667;1132;81.3333333333333
02144;2023;1;1;0;100;0;191132;1056;181
02145;2023;8;8;0;100;0;159475;1176.25;134.625
02148;2023;3;3;0;100;0;146666.666666667;2091;68.6666666666667
02150;2023;1;1;0;100;0;197500;1097;180
02151;2023;2;2;0;100;0;146975;1582.5;92.5
02152;2023;1;1;0;100;0;178000;1648;108
02153;2023;7;7;0;100;0;154760;1685.28571428571;99.8571428571429
02154;2023;1;1;0;100;0;38000;514;74
02155;2023;2;2;0;100;0;158925;2283;72
02156;2023;2;2;0;100;0;112475;1202.5;93
02157;2023;3;3;0;100;0;132200;1582;82.6666666666667
02158;2023;3;3;0;100;0;107800;1224.66666666667;87.6666666666667
02159;2023;1;1;0;100;0;129000;1633;79
02160;2023;7;7;0;100;0;53357.1428571429;735.142857142857;73.1428571428571
02162;2023;6;6;0;100;0;136666.666666667;1514;89.1666666666667
02163;2023;13;11;2;84.6153846153846;15.3846153846154;156530.769230769;1409.07692307692;109.615384615385
02164;2023;2;2;0;100;0;115500;1885;64
02165;2023;21;21;0;100;0;112361.904761905;1158;96.9523809523809
02166;2023;8;8;0;100;0;145312.5;1544.5;108.625
02167;2023;8;8;0;100;0;136200;1575;87.875
02168;2023;138;74;64;53.6231884057971;46.3768115942029;154933;1939.34782608696;82.304347826087
02170;2023;3;3;0;100;0;163800;1451;115.333333333333
02171;2023;3;3;0;100;0;64100;998.333333333333;77.6666666666667
02172;2023;2;2;0;100;0;124500;1210;97
02173;2023;137;116;21;84.6715328467153;15.3284671532847;108832.97080292;1314.39416058394;83.1605839416058
02174;2023;9;9;0;100;0;140183.333333333;1271.11111111111;116.666666666667
02177;2023;2;2;0;100;0;117650;1176.5;100
02178;2023;1;1;0;100;0;60000;800;75
02179;2023;4;4;0;100;0;138000;1486.75;95.25
02180;2023;8;8;0;100;0;119212.5;1318;96.25
02181;2023;2;2;0;100;0;96625;1019;96
02182;2023;2;2;0;100;0;70750;563.5;128
02184;2023;1;1;0;100;0;124950;1436;87
02185;2023;6;6;0;100;0;160120.833333333;1521.5;102.333333333333
02186;2023;22;19;3;86.3636363636364;13.6363636363636;147123.181818182;1856.09090909091;85.6363636363636
02187;2023;13;12;1;92.3076923076923;7.69230769230769;163380.769230769;1875.84615384615;86.5384615384615
02188;2023;4;4;0;100;0;101625;1447.25;73.75
02189;2023;2;2;0;100;0;108350;965;107
02190;2023;2;2;0;100;0;124000;1974.5;66
02191;2023;3;3;0;100;0;79700;1060;95
02192;2023;7;7;0;100;0;168571.428571429;1473.71428571429;112.571428571429
02193;2023;1;1;0;100;0;55000;611;90
02194;2023;1;1;0;100;0;45000;634;71
02195;2023;8;8;0;100;0;110125;1492;79.875
02196;2023;3;3;0;100;0;136100;1892.66666666667;72
02197;2023;5;5;0;100;0;121360;1282.6;97.8
02198;2023;2;2;0;100;0;175250;2120;83
02199;2023;6;6;0;100;0;117544;1509.16666666667;78
02200;2023;2;2;0;100;0;212500;863.5;237.5
02201;2023;3;3;0;100;0;143333.333333333;1815;85
02203;2023;17;17;0;100;0;147517.647058824;1448.17647058824;100
02204;2023;2;2;0;100;0;96000;996.5;93
02205;2023;2;2;0;100;0;102500;1698;62.5
02207;2023;4;4;0;100;0;126700;1245.5;101.75
02208;2023;6;6;0;100;0;116879.166666667;1533;73.3333333333333
02209;2023;9;9;0;100;0;140611.111111111;1513.44444444444;90.4444444444444
02210;2023;2;2;0;100;0;112450;2048;56.5
02211;2023;2;2;0;100;0;114000;1231.5;90
02212;2023;3;3;0;100;0;112333.333333333;1430.66666666667;76.6666666666667
02213;2023;5;5;0;100;0;155997;1635.4;96
02215;2023;5;5;0;100;0;157920;1676.8;106
02216;2023;4;4;0;100;0;199950;2060.75;104.25
02217;2023;12;12;0;100;0;135271.666666667;1333.58333333333;103.916666666667
02218;2023;8;8;0;100;0;124587.5;1500.625;87.625
02220;2023;6;6;0;100;0;81750;1146.83333333333;82.1666666666667
02223;2023;4;4;0;100;0;124500;1286.25;98
02224;2023;5;5;0;100;0;140780;1550.2;90
02225;2023;5;5;0;100;0;153600;1330.8;116.8
02226;2023;18;18;0;100;0;160833.333333333;1729.5;93.2777777777778
02227;2023;2;2;0;100;0;147000;1466;101.5
02228;2023;4;4;0;100;0;168500;1689.75;99
02231;2023;7;7;0;100;0;94450;1225.71428571429;81.4285714285714
02232;2023;4;4;0;100;0;237100;2888.25;82
02233;2023;1;1;0;100;0;120000;1333;90
02235;2023;1;1;0;100;0;226000;2260;100
02236;2023;4;4;0;100;0;119000;1149.5;103.5
02237;2023;11;11;0;100;0;105577.272727273;1010.90909090909;109.545454545455
02238;2023;9;8;1;88.8888888888889;11.1111111111111;110200;1528.77777777778;80.8888888888889
02239;2023;17;16;1;94.1176470588235;5.88235294117647;145573.529411765;1702.58823529412;88.6470588235294
02240;2023;2;2;0;100;0;93000;1344.5;68.5
02241;2023;2;2;0;100;0;233195;1803.5;125.5
02242;2023;8;8;0;100;0;136800;2090.625;71.375
02243;2023;30;23;7;76.6666666666667;23.3333333333333;146226.433333333;1802.06666666667;83.7333333333333
02245;2023;17;16;1;94.1176470588235;5.88235294117647;194676.588235294;1890.17647058824;99.4117647058823
02246;2023;7;7;0;100;0;116142.857142857;1279.71428571429;94
02248;2023;3;3;0;100;0;166333.333333333;1327.33333333333;123.666666666667
02249;2023;1;1;0;100;0;178510;1822;98
02250;2023;1;1;0;100;0;40950;1706;24
02251;2023;1;1;0;100;0;50000;633;79
02253;2023;3;3;0;100;0;131000;1517;86.3333333333333
02254;2023;1;1;0;100;0;2,00E+05;1399;143
02255;2023;1;1;0;100;0;149000;1490;100
02257;2023;3;3;0;100;0;266000;2011.33333333333;132.666666666667
02258;2023;5;5;0;100;0;309690;2013;189.2
02259;2023;5;5;0;100;0;287900;2039.2;142.8
02260;2023;5;5;0;100;0;80440;1154.4;73.2
02261;2023;5;5;0;100;0;127250;1354;93.2
02262;2023;3;3;0;100;0;196300;1545.33333333333;127
02263;2023;2;2;0;100;0;112500;1305;85
02264;2023;6;6;0;100;0;73750;863.166666666667;83.5
02265;2023;1;1;0;100;0;145000;967;150
02266;2023;1;1;0;100;0;27000;482;56
02267;2023;5;5;0;100;0;181600;2782.6;74.2
02268;2023;7;7;0;100;0;152428.571428571;1559.14285714286;91.2857142857143
02270;2023;2;2;0;100;0;72500;1176.5;62
02271;2023;2;2;0;100;0;508585;2889.5;166
02272;2023;4;4;0;100;0;73000;1026.25;75.75
02274;2023;5;5;0;100;0;101960;994.8;106.2
02275;2023;1;1;0;100;0;35000;538;65
02276;2023;2;2;0;100;0;106250;1663;64.5
02277;2023;5;5;0;100;0;152400;1453;102.8
02279;2023;6;6;0;100;0;169563.166666667;1601.16666666667;110
02280;2023;3;3;0;100;0;105500;1068;100
02281;2023;4;4;0;100;0;145375;1805.5;99.5
02282;2023;3;3;0;100;0;215350;2096.33333333333;102
02283;2023;2;2;0;100;0;55000;603.5;90.5
02284;2023;3;3;0;100;0;119666.666666667;949.333333333333;122.666666666667
02286;2023;9;9;0;100;0;129781.333333333;1325.22222222222;99.8888888888889
02287;2023;11;11;0;100;0;154318.181818182;1678.63636363636;90.1818181818182
02288;2023;3;3;0;100;0;84166.6666666667;1168;72
02289;2023;7;7;0;100;0;156142.857142857;1767.71428571429;86
02290;2023;16;15;1;93.75;6.25;163731.875;1846.125;92.25
02291;2023;3;3;0;100;0;132633.333333333;832;157
02292;2023;13;11;2;84.6153846153846;15.3846153846154;161514.923076923;1723.76923076923;100.230769230769
02293;2023;3;3;0;100;0;104500;995.333333333333;106.333333333333
02294;2023;2;2;0;100;0;112000;1504;71.5
02295;2023;7;7;0;100;0;78042.8571428571;840;100
02296;2023;9;9;0;100;0;148233.333333333;1298.77777777778;108.222222222222
02297;2023;1;1;0;100;0;115000;1250;92
02298;2023;8;8;0;100;0;85663.75;930.375;89
02299;2023;3;3;0;100;0;134700;1585.66666666667;87.6666666666667
02302;2023;6;6;0;100;0;162687.5;1878.83333333333;95.8333333333333
02303;2023;6;6;0;100;0;337283.333333333;2240.33333333333;143.5
02304;2023;26;19;7;73.0769230769231;26.9230769230769;80450.7692307692;850.538461538462;98.6923076923077
02305;2023;27;26;1;96.2962962962963;3.7037037037037;106991.777777778;1326.77777777778;85.5185185185185
02306;2023;5;5;0;100;0;66000;759.2;83.6
02307;2023;24;23;1;95.8333333333333;4.16666666666667;179529.166666667;2011.625;90.8333333333333
02308;2023;13;13;0;100;0;122993.769230769;1265.53846153846;103.615384615385
02309;2023;6;6;0;100;0;135550;1334.83333333333;113.166666666667
02310;2023;4;4;0;100;0;146750;1020.25;150.5
02312;2023;9;9;0;100;0;102176;1078.44444444444;96.3333333333333
02313;2023;5;5;0;100;0;98200;1061.6;96.2
02315;2023;16;16;0;100;0;124400;1341.5;94.9375
02316;2023;1;1;0;100;0;278000;2376;117
02317;2023;2;2;0;100;0;88500;983.5;90
02318;2023;17;17;0;100;0;126685.294117647;1386.52941176471;93
02319;2023;3;3;0;100;0;94466.6666666667;747.666666666667;92.3333333333333
02320;2023;2;2;0;100;0;82000;1381;65.5
02321;2023;8;8;0;100;0;87037.5;999;89.25
02322;2023;3;3;0;100;0;110333.333333333;1063.66666666667;115
02323;2023;2;2;0;100;0;182750;1407.5;130
02324;2023;2;2;0;100;0;125250;1060.5;118
02326;2023;2;2;0;100;0;149500;1675.5;87.5
02327;2023;3;3;0;100;0;134233.333333333;2199.66666666667;71
02328;2023;5;5;0;100;0;211230;1930;112.2
02329;2023;2;2;0;100;0;132025;1376;91.5
02330;2023;2;2;0;100;0;292250;2407.5;120
02331;2023;2;2;0;100;0;102500;1276;78.5
02332;2023;3;3;0;100;0;132333.333333333;1498;88
02333;2023;2;2;0;100;0;76500;717;106.5
02334;2023;20;20;0;100;0;105991.1;1117.8;98.45
02335;2023;2;2;0;100;0;89000;1484.5;63.5
02336;2023;5;5;0;100;0;158660;1917.4;78.6
02337;2023;1;1;0;100;0;45000;474;95
02338;2023;4;4;0;100;0;63973.75;878.75;71.75
02339;2023;10;9;1;90;10;145350;1375.9;103.7
02340;2023;54;54;0;100;0;116510.925925926;1380.85185185185;84.1481481481482
02341;2023;1;1;0;100;0;50000;714;70
02342;2023;1;1;0;100;0;165000;1500;110
02343;2023;1;1;0;100;0;77000;579;133
02346;2023;8;8;0;100;0;138625;1482.5;88.75
02347;2023;3;3;0;100;0;196333.333333333;1509;141.333333333333
02349;2023;1;1;0;100;0;165000;1793;92
02350;2023;2;2;0;100;0;167022.5;1733;99
02351;2023;1;1;0;100;0;135000;1646;82
02352;2023;5;5;0;100;0;139840;893.4;136.4
02353;2023;2;2;0;100;0;52500;758;67.5
02354;2023;1;1;0;100;0;123850;1251;99
02355;2023;8;8;0;100;0;147335;1484.875;92.75
02356;2023;3;3;0;100;0;143000;1593.33333333333;91.6666666666667
02357;2023;1;1;0;100;0;149000;1862;80
02358;2023;2;2;0;100;0;143950;1241;119
02359;2023;15;11;4;73.3333333333333;26.6666666666667;108686.666666667;1296.06666666667;79.8
02360;2023;32;31;1;96.875;3.125;193114.375;1969.6875;100.5625
02361;2023;41;41;0;100;0;85932.5853658537;948;90.219512195122
02362;2023;2;2;0;100;0;135000;1120.5;119
02363;2023;3;2;1;66.6666666666667;33.3333333333333;147300;1102.66666666667;135.666666666667
02364;2023;4;4;0;100;0;158050;1431.5;109.5
02366;2023;3;3;0;100;0;74293.3333333333;1061;58
02368;2023;6;6;0;100;0;221725;2501;89.5
02369;2023;2;2;0;100;0;67500;694.5;97.5
02370;2023;6;6;0;100;0;209583.333333333;1616.33333333333;132.333333333333
02371;2023;11;11;0;100;0;100618.181818182;1150.90909090909;87.0909090909091
02372;2023;4;4;0;100;0;100750;1275.5;72.75
02373;2023;4;4;0;100;0;106500;1171;94.25
02374;2023;13;9;4;69.2307692307692;30.7692307692308;89000;1173;74.3846153846154
02376;2023;1;1;0;100;0;40000;500;80
02377;2023;1;1;0;100;0;290000;2057;141
02378;2023;1;1;0;100;0;110000;629;175
02379;2023;4;4;0;100;0;77250;752.25;92.5
02381;2023;94;86;8;91.4893617021277;8.51063829787234;69590.4255319149;850.244680851064;83.2553191489362
02382;2023;16;16;0;100;0;178656.25;1646.9375;108.0625
02383;2023;12;12;0;100;0;158525;2427.41666666667;88.1666666666667
02385;2023;1;1;0;100;0;158150;1400;113
02386;2023;1;1;0;100;0;30000;423;71
02387;2023;12;12;0;100;0;159232.083333333;1399.83333333333;112.916666666667
02388;2023;4;4;0;100;0;72000;1112.75;64.75
02389;2023;6;6;0;100;0;140333.333333333;1749;85.3333333333333
02390;2023;4;4;0;100;0;149585;1438.25;99.25
02391;2023;2;2;0;100;0;175505;1688.5;103
02392;2023;2;2;0;100;0;141000;941.5;150
02393;2023;1;1;0;100;0;142100;1215;117
02395;2023;4;4;0;100;0;124807;1558.5;83.5
02397;2023;9;9;0;100;0;139488.888888889;1426.22222222222;98.4444444444444
02398;2023;2;2;0;100;0;159000;1745.5;91.5
02399;2023;3;3;0;100;0;202833.333333333;2003;101
02400;2023;3;3;0;100;0;178093.333333333;1718.33333333333;100.666666666667
02401;2023;2;2;0;100;0;112000;1477.5;80.5
02403;2023;2;2;0;100;0;89850;705.5;125
02404;2023;1;1;0;100;0;65000;722;90
02405;2023;8;8;0;100;0;113075;1173.375;97.375
02406;2023;1;1;0;100;0;1,00E+05;1786;56
02407;2023;5;5;0;100;0;240760;1321.8;175
02408;2023;276;165;111;59.7826086956522;40.2173913043478;97445.3514492754;1264.08695652174;77.1050724637681
02409;2023;4;4;0;100;0;91250;934.75;94
02410;2023;5;5;0;100;0;141600;2026.4;70.6
02411;2023;6;6;0;100;0;144450;1676.66666666667;92.1666666666667
02414;2023;4;4;0;100;0;84827.5;672;133.5
02415;2023;1;1;0;100;0;181000;3771;48
02416;2023;4;4;0;100;0;73250;854.25;80.25
02417;2023;2;2;0;100;0;78250;778.5;102.5
02418;2023;2;2;0;100;0;240500;1623.5;132.5
02419;2023;5;5;0;100;0;97244;824;113.6
02420;2023;6;6;0;100;0;186300;1327;136.166666666667
02422;2023;9;9;0;100;0;105500;988.888888888889;100.222222222222
02423;2023;2;2;0;100;0;111500;969;119.5
02424;2023;3;3;0;100;0;144333.333333333;1404.66666666667;103
02425;2023;2;2;0;100;0;146200;1362.5;110.5
02426;2023;8;8;0;100;0;109600;1190.375;91.625
02427;2023;2;2;0;100;0;184000;1754.5;104
02429;2023;1;1;0;100;0;221500;2461;90
02430;2023;11;11;0;100;0;112481.818181818;1289.27272727273;84.4545454545455
02431;2023;3;3;0;100;0;129833.333333333;1599.66666666667;82.3333333333333
02432;2023;4;4;0;100;0;138250;1791.25;105.25
02433;2023;3;2;1;66.6666666666667;33.3333333333333;190133.333333333;1532.33333333333;124.333333333333
02438;2023;7;7;0;100;0;278071.428571429;2107;128.571428571429
02439;2023;8;8;0;100;0;152300;1503.375;108.875
02441;2023;2;2;0;100;0;197500;1853.5;107
02442;2023;1;1;0;100;0;143000;715;200
02443;2023;3;3;0;100;0;175333.333333333;1409.66666666667;109
02444;2023;3;3;0;100;0;56333.3333333333;682;85.6666666666667
02445;2023;4;4;0;100;0;101000;1494.5;76
02447;2023;1;1;0;100;0;65900;998;66
02448;2023;2;2;0;100;0;123475;1262.5;96.5
02450;2023;5;5;0;100;0;139154;1162.6;135.6
02451;2023;1;1;0;100;0;113000;1202;94
02452;2023;2;2;0;100;0;83500;1171.5;71
02453;2023;4;4;0;100;0;171625;992.25;160.75
02454;2023;6;6;0;100;0;118942.166666667;1405;84.5
02456;2023;4;4;0;100;0;260625;1988;133.5
02457;2023;3;3;0;100;0;91850.6666666667;958.333333333333;93
02458;2023;8;8;0;100;0;171431.875;1711.125;106.5
02459;2023;1;1;0;100;0;2,00E+05;1835;109
02460;2023;1;1;0;100;0;120000;536;224
02461;2023;8;8;0;100;0;125468.75;1546.875;85.25
02462;2023;8;8;0;100;0;152378.125;1351.125;115.25
02464;2023;1;1;0;100;0;152100;1127;135
02465;2023;5;5;0;100;0;191355.8;2167;95.8
02468;2023;17;17;0;100;0;80472.6470588235;810.117647058824;100.470588235294
02469;2023;5;5;0;100;0;65036;905.8;95.4
02470;2023;8;8;0;100;0;89512.5;864;114.5
02472;2023;3;3;0;100;0;76066.6666666667;1447;49.3333333333333
02473;2023;1;1;0;100;0;86000;1036;83
02474;2023;9;9;0;100;0;90138.8888888889;994.444444444444;85.8888888888889
02476;2023;3;3;0;100;0;74500;996.666666666667;76.6666666666667
02477;2023;10;9;1;90;10;185220;1758.1;106.4
02480;2023;4;4;0;100;0;56512.5;854.5;68.75
02481;2023;7;7;0;100;0;139185.714285714;1462;101.285714285714
02483;2023;7;7;0;100;0;171965.142857143;1386.28571428571;121.285714285714
02484;2023;2;2;0;100;0;188150;2114;90.5
02487;2023;8;8;0;100;0;255790;1757.375;142.25
02489;2023;1;1;0;100;0;70000;1346;52
02490;2023;3;3;0;100;0;292666.666666667;2689.33333333333;105
02491;2023;5;5;0;100;0;63700;669.6;93.8
02492;2023;6;6;0;100;0;110705;1276.5;97.5
02493;2023;2;2;0;100;0;128225;906;144.5
02495;2023;13;13;0;100;0;116078.076923077;1081;101.923076923077
02497;2023;7;7;0;100;0;192235.714285714;1681.14285714286;113.285714285714
02498;2023;10;10;0;100;0;135260;1365.3;98.3
02500;2023;11;11;0;100;0;129272.727272727;1109.72727272727;113.454545454545
02502;2023;14;14;0;100;0;96189.2857142857;1081.78571428571;88.8571428571429
02503;2023;11;11;0;100;0;117345.454545455;1037.72727272727;110.454545454545
02504;2023;21;21;0;100;0;116719.047619048;1326.38095238095;87.8571428571429
02505;2023;3;3;0;100;0;121333.333333333;1592.33333333333;71.6666666666667
02506;2023;1;1;0;100;0;222860;1581;141
02508;2023;1;1;0;100;0;115000;1438;80
02509;2023;1;1;0;100;0;302000;1924;157
02510;2023;3;3;0;100;0;174000;1771.66666666667;92
02511;2023;3;3;0;100;0;155366.666666667;1567;99
02512;2023;3;3;0;100;0;288000;1785.66666666667;158
02513;2023;1;1;0;100;0;80000;1333;60
02514;2023;4;4;0;100;0;170250;2587.5;68.25
02517;2023;4;4;0;100;0;105762.5;1116;98.25
02518;2023;1;1;0;100;0;80000;1250;64
02519;2023;1;1;0;100;0;140000;581;241
02520;2023;8;8;0;100;0;160212.5;1416.625;113.25
02521;2023;20;19;1;95;5;188425;2145.05;92.2
02524;2023;6;6;0;100;0;195000;1766;110.5
02525;2023;5;5;0;100;0;138030;1635.8;84.8
02527;2023;4;3;1;75;25;88000;898.5;104.75
02528;2023;3;3;0;100;0;187500;1667.33333333333;118
02529;2023;1;1;0;100;0;80000;1111;72
02530;2023;1;1;0;100;0;235000;2080;113
02532;2023;14;14;0;100;0;131938.071428571;1358.14285714286;100.642857142857
02533;2023;5;5;0;100;0;123270;1059.2;123.2
02535;2023;3;3;0;100;0;115000;1046.33333333333;99.6666666666667
02538;2023;1;1;0;100;0;209020;1727;121
02539;2023;7;7;0;100;0;79714.2857142857;894.571428571429;89.8571428571429
02540;2023;11;11;0;100;0;149136.363636364;1599.63636363636;99.0909090909091
02541;2023;4;4;0;100;0;167175;2248;82.5
02543;2023;26;24;2;92.3076923076923;7.69230769230769;128377.692307692;1391.84615384615;94.1153846153846
02544;2023;3;3;0;100;0;113428.333333333;1155;112.666666666667
02545;2023;2;2;0;100;0;149120;1529.5;98
02546;2023;4;4;0;100;0;128350;1184;109
02547;2023;2;2;0;100;0;77950;814;95.5
02548;2023;2;2;0;100;0;195287.5;1378;124
02549;2023;11;11;0;100;0;137879.090909091;1542.27272727273;87.9090909090909
02550;2023;2;2;0;100;0;244950;2371.5;100.5
02551;2023;3;3;0;100;0;57050;658.666666666667;95
02552;2023;3;3;0;100;0;95000;835.666666666667;116.666666666667
02553;2023;2;2;0;100;0;141000;1035;163.5
02554;2023;10;9;1;90;10;186024;2060.8;93.4
02555;2023;38;31;7;81.5789473684211;18.4210526315789;148651.815789474;1883.60526315789;83.8684210526316
02556;2023;1;1;0;100;0;36000;450;80
02558;2023;30;30;0;100;0;91343.3333333333;998.366666666667;94.0333333333333
02559;2023;7;7;0;100;0;98900;1019.28571428571;97.4285714285714
02560;2023;2;2;0;100;0;88500;1299.5;91.5
02561;2023;1;1;0;100;0;160000;1356;118
02562;2023;1;1;0;100;0;136000;2345;58
02563;2023;1;1;0;100;0;26064;668;39
02564;2023;2;2;0;100;0;142500;1904;75
02565;2023;7;7;0;100;0;115500;1292;89.1428571428571
02566;2023;12;12;0;100;0;131173.666666667;1590.5;83.8333333333333
02567;2023;1;1;0;100;0;45000;529;85
02568;2023;4;4;0;100;0;223650;2223.75;101.75
02569;2023;9;9;0;100;0;86608.3333333333;893.555555555556;94.1111111111111
02570;2023;2;2;0;100;0;164900;1713.5;96
02571;2023;3;3;0;100;0;115800;1040.66666666667;124.333333333333
02572;2023;2;2;0;100;0;214675;2309.5;96
02573;2023;1;1;0;100;0;194900;2998;65
02574;2023;13;13;0;100;0;129811.538461538;1101.23076923077;118.692307692308
02575;2023;17;17;0;100;0;86641.9411764706;822.294117647059;102.647058823529
02576;2023;1;1;0;100;0;254000;1776;143
02577;2023;1;1;0;100;0;110000;1375;80
02579;2023;1;1;0;100;0;130000;1313;99
02580;2023;6;6;0;100;0;114316.666666667;1110.5;112.833333333333
02581;2023;3;3;0;100;0;105833.333333333;1115.66666666667;96.6666666666667
02582;2023;1;1;0;100;0;140000;1591;88
02584;2023;1;1;0;100;0;160000;1379;116
02585;2023;2;2;0;100;0;82500;1110.5;68.5
02587;2023;2;2;0;100;0;95475;1195.5;98.5
02588;2023;1;1;0;100;0;29000;1074;27
02589;2023;3;3;0;100;0;117666.666666667;1407.66666666667;80.6666666666667
02590;2023;1;1;0;100;0;436000;1384;315
02591;2023;1;1;0;100;0;57000;655;87
02592;2023;2;2;0;100;0;214950;1219.5;217.5
02593;2023;13;13;0;100;0;231115.384615385;1933.38461538462;125.923076923077
02594;2023;4;4;0;100;0;129500;1717.25;76.25
02595;2023;4;4;0;100;0;96625;1260.5;75.25
02596;2023;13;13;0;100;0;142423.076923077;1547.30769230769;99.5384615384615
02598;2023;9;9;0;100;0;180433.333333333;1858.33333333333;101.333333333333
02599;2023;3;3;0;100;0;122633.333333333;1024.66666666667;119
02600;2023;5;5;0;100;0;83810;1081.6;78.6
02601;2023;3;3;0;100;0;169683.333333333;1838.66666666667;95.3333333333333
02602;2023;17;17;0;100;0;121482.352941176;1527.47058823529;81.4117647058823
02604;2023;1;1;0;100;0;93000;1368;68
02605;2023;2;2;0;100;0;80000;1084.5;75
02606;2023;2;2;0;100;0;172500;2021.5;91.5
02607;2023;1;1;0;100;0;111000;1110;100
02608;2023;5;5;0;100;0;67900;881;76.8
02610;2023;10;10;0;100;0;167966.3;2000.8;97.2
02612;2023;1;1;0;100;0;380000;2568;148
02613;2023;8;8;0;100;0;151948.75;1911.25;79.5
02614;2023;1;1;0;100;0;55000;1122;49
02615;2023;3;3;0;100;0;107666.666666667;898.333333333333;130.333333333333
02616;2023;1;1;0;100;0;205500;1038;198
02617;2023;4;4;0;100;0;69875;819;82.75
02618;2023;1;1;0;100;0;50000;676;74
02619;2023;4;4;0;100;0;98000;1283.25;76.5
02620;2023;3;3;0;100;0;70333.3333333333;897.333333333333;78.3333333333333
02621;2023;3;3;0;100;0;143266.666666667;1669.66666666667;81.6666666666667
02622;2023;1;1;0;100;0;37000;597;62
02623;2023;3;3;0;100;0;131000;1353.33333333333;104
02624;2023;6;6;0;100;0;96916.6666666667;914.5;101.5
02625;2023;3;3;0;100;0;42333.3333333333;561.666666666667;76
02626;2023;5;5;0;100;0;167886.4;2112.8;79.2
02627;2023;2;2;0;100;0;151500;907.5;165
02628;2023;2;2;0;100;0;153010;2689;62
02629;2023;3;3;0;100;0;105816.666666667;1111.66666666667;106
02631;2023;8;8;0;100;0;97377.5;1540.125;75.625
02632;2023;2;2;0;100;0;98450;1092;93
02635;2023;2;2;0;100;0;141500;1037;138.5
02636;2023;3;3;0;100;0;108833.333333333;853;128.333333333333
02637;2023;8;8;0;100;0;88937.5;1041.625;93.75
02638;2023;2;2;0;100;0;114950;1234;98
02639;2023;5;5;0;100;0;118100;1174.4;101
02640;2023;1;1;0;100;0;134000;1229;109
02641;2023;2;2;0;100;0;114000;1105;109
02642;2023;3;3;0;100;0;118333.333333333;930.666666666667;126.333333333333
02643;2023;11;11;0;100;0;194054.545454545;1990.72727272727;103.545454545455
02644;2023;4;4;0;100;0;318875;2984.75;110.5
02645;2023;3;3;0;100;0;97916.6666666667;1346.66666666667;73
02648;2023;16;16;0;100;0;102525;1008.8125;96.5625
02649;2023;3;3;0;100;0;155123.333333333;1194.33333333333;135.333333333333
02650;2023;2;1;1;50;50;149000;878.5;178.5
02651;2023;2;2;0;100;0;132500;1504.5;91
02653;2023;5;5;0;100;0;220800;2411.8;90.8
02654;2023;1;1;0;100;0;170200;1737;98
02655;2023;1;1;0;100;0;158000;1463;108
02656;2023;1;1;0;100;0;92510;1028;90
02657;2023;1;1;0;100;0;55000;1146;48
02658;2023;1;1;0;100;0;319800;1599;200
02659;2023;6;6;0;100;0;185608.333333333;1928.16666666667;98
02660;2023;1;1;0;100;0;45000;692;65
02661;2023;2;2;0;100;0;290000;1610;170
02662;2023;6;6;0;100;0;192516.666666667;1415.5;140.833333333333
02663;2023;1;1;0;100;0;276500;1975;140
02664;2023;1;1;0;100;0;1,00E+05;1818;55
02665;2023;1;1;0;100;0;48000;1333;36
02666;2023;8;8;0;100;0;83687.5;936.875;86
02667;2023;5;5;0;100;0;146030;1306.2;123.8
02668;2023;6;6;0;100;0;86750;800.666666666667;110.333333333333
02670;2023;2;2;0;100;0;77500;895.5;92.5
02671;2023;1;1;0;100;0;65800;783;84
02672;2023;5;5;0;100;0;187000;1788.6;108
02673;2023;2;2;0;100;0;162400;1617.5;102
02675;2023;3;3;0;100;0;234666.666666667;1135.33333333333;202.666666666667
02676;2023;29;28;1;96.551724137931;3.44827586206897;119702.068965517;1099.24137931034;111.310344827586
02677;2023;2;2;0;100;0;170500;1842.5;99
02678;2023;2;2;0;100;0;126500;1422;93
02680;2023;29;29;0;100;0;102094.034482759;1195.68965517241;87
02681;2023;4;4;0;100;0;46541.75;551.75;87
02682;2023;1;1;0;100;0;230000;1586;145
02683;2023;2;2;0;100;0;105000;856.5;117.5
02684;2023;20;19;1;95;5;85697.5;967.75;92.95
02686;2023;1;1;0;100;0;89900;1124;80
02687;2023;4;4;0;100;0;230550;2461.25;92.25
02688;2023;1;1;0;100;0;45000;529;85
02690;2023;1;1;0;100;0;80000;2000;40
02691;2023;652;517;135;79.2944785276074;20.7055214723926;105626.604294479;1262.60429447853;85.8481595092025
02693;2023;1;1;0;100;0;93000;1550;60
02694;2023;4;4;0;100;0;101850;1446;78
02696;2023;1;1;0;100;0;90000;592;152
02697;2023;5;5;0;100;0;221090;1351.4;184
02698;2023;1;1;0;100;0;65000;2167;30
02699;2023;4;4;0;100;0;129750;1112.5;103.5
02701;2023;21;21;0;100;0;139480.952380952;1575.80952380952;95.8571428571429
02702;2023;3;3;0;100;0;191833.333333333;1654.66666666667;122.666666666667
02703;2023;12;12;0;100;0;109608.333333333;1062.16666666667;103.583333333333
02704;2023;2;2;0;100;0;139000;1519.5;106
02705;2023;2;2;0;100;0;95900;705.5;139.5
02706;2023;4;4;0;100;0;160400;1620;97.75
02707;2023;2;2;0;100;0;77500;1010.5;76
02708;2023;3;3;0;100;0;216600;1511;147.333333333333
02709;2023;2;2;0;100;0;117500;786.5;150
02710;2023;7;7;0;100;0;134250;1865.14285714286;74
02711;2023;4;4;0;100;0;130725;1406.5;90.25
02712;2023;3;3;0;100;0;186666.666666667;1252;139.333333333333
02713;2023;1;1;0;100;0;149000;2292;65
02714;2023;6;5;1;83.3333333333333;16.6666666666667;109766.666666667;1208;96.1666666666667
02715;2023;1;1;0;100;0;169150;1301;130
02716;2023;3;3;0;100;0;177966.666666667;1671.33333333333;106.333333333333
02717;2023;7;7;0;100;0;103414.285714286;1167.28571428571;87.1428571428571
02718;2023;3;3;0;100;0;132742.666666667;1859.33333333333;72.6666666666667
02719;2023;26;26;0;100;0;94678.3076923077;1184.76923076923;79.8461538461538
02720;2023;16;16;0;100;0;117081.25;1258.5;93.5
02721;2023;6;6;0;100;0;139033.333333333;1280.33333333333;115.333333333333
02722;2023;278;125;153;44.9640287769784;55.0359712230216;147063.935251799;1789.44964028777;83.1115107913669
02726;2023;4;4;0;100;0;95770;880.5;108.5
02727;2023;4;4;0;100;0;89237.5;1005;86.75
02728;2023;2;2;0;100;0;92000;648;140
02730;2023;2;2;0;100;0;103500;1335;86
02731;2023;2;2;0;100;0;148500;1926.5;78.5
02734;2023;3;3;0;100;0;365443.333333333;2087.66666666667;157.666666666667
02736;2023;2;2;0;100;0;88000;1040;81
02737;2023;3;3;0;100;0;128593.333333333;1043.66666666667;135
02738;2023;137;131;6;95.6204379562044;4.37956204379562;95625.6934306569;1132.03649635037;86.6496350364963
02739;2023;2;2;0;100;0;174500;1087.5;156.5
02740;2023;4;4;0;100;0;61250;952.75;61
02741;2023;5;5;0;100;0;66680;945.8;72.2
02742;2023;2;2;0;100;0;95000;1012;93.5
02743;2023;2;2;0;100;0;75050;861;87.5
02744;2023;1;1;0;100;0;265000;2208;120
02745;2023;1;1;0;100;0;128800;628;205
02746;2023;6;6;0;100;0;123083.333333333;1355;96
02747;2023;1;1;0;100;0;120000;1062;113
02748;2023;7;7;0;100;0;170714.285714286;1650;98.2857142857143
02749;2023;1;1;0;100;0;188000;1664;113
02750;2023;7;7;0;100;0;119142.857142857;1418.28571428571;83.8571428571429
02751;2023;1;1;0;100;0;196500;1228;160
02752;2023;3;3;0;100;0;106166.666666667;1613.33333333333;71
02753;2023;5;5;0;100;0;117650;1328.8;93.6
02754;2023;1;1;0;100;0;90000;1084;83
02755;2023;4;4;0;100;0;156487.5;1275.75;132.5
02756;2023;6;6;0;100;0;162516.666666667;1328.5;110.833333333333
02757;2023;11;11;0;100;0;89736.5454545455;744.090909090909;116.545454545455
02758;2023;22;20;2;90.9090909090909;9.09090909090909;125154.5;1538.13636363636;84.1363636363636
02759;2023;3;3;0;100;0;140690.666666667;1203.33333333333;134.666666666667
02760;2023;1;1;0;100;0;84680;985;86
02761;2023;2;2;0;100;0;274000;1556.5;175
02762;2023;1;1;0;100;0;235000;1567;150
02764;2023;1;1;0;100;0;39000;1114;35
02766;2023;5;5;0;100;0;110738.4;1285.4;90
02767;2023;4;4;0;100;0;158750;1709.25;93.25
02768;2023;4;4;0;100;0;167000;1787.5;95.75
02769;2023;6;5;1;83.3333333333333;16.6666666666667;81088.3333333333;1407.83333333333;90.1666666666667
02770;2023;5;4;1;80;20;160860;1640.8;98.8
02772;2023;2;2;0;100;0;184725;1716;111.5
02774;2023;2;2;0;100;0;95000;715;135.5
02775;2023;8;8;0;100;0;148125;1428.25;95.375
02776;2023;6;6;0;100;0;94466.6666666667;777.5;112.166666666667
02777;2023;2;2;0;100;0;323850;1883;174
02779;2023;2;2;0;100;0;110000;1187.5;92
02780;2023;8;8;0;100;0;106750;1438.75;76.125
02781;2023;3;3;0;100;0;247400;2390.66666666667;104.666666666667
02782;2023;1;1;0;100;0;70000;864;81
02784;2023;3;3;0;100;0;99000;1034;96.3333333333333
02785;2023;3;3;0;100;0;160000;1677.33333333333;95
02787;2023;6;6;0;100;0;93832.3333333333;951.5;99.8333333333333
02788;2023;5;5;0;100;0;146260;1123.2;117.8
02789;2023;13;13;0;100;0;99588.8461538462;1010.92307692308;97.5384615384615
02790;2023;3;3;0;100;0;141000;979;152.333333333333
02791;2023;6;6;0;100;0;122225;1138.83333333333;104.166666666667
02792;2023;3;3;0;100;0;215000;1865.66666666667;107.666666666667
02793;2023;2;2;0;100;0;148000;1617;90.5
02794;2023;5;5;0;100;0;201570;2370.4;116.4
02795;2023;14;11;3;78.5714285714286;21.4285714285714;149464.214285714;1569.57142857143;94.1428571428571
02798;2023;6;6;0;100;0;182341.666666667;1919.66666666667;99.1666666666667
02799;2023;5;5;0;100;0;120780;1409.2;91
02800;2023;2;2;0;100;0;115000;1287;89.5
02801;2023;1;1;0;100;0;129000;1252;103
02802;2023;2;2;0;100;0;131000;1235;99.5
02803;2023;1;1;0;100;0;148400;1413;105
02804;2023;3;3;0;100;0;174666.666666667;1582;113.666666666667
02805;2023;25;15;10;60;40;111006.4;1552.44;70.36
02806;2023;7;7;0;100;0;138642.857142857;1526.28571428571;98
02807;2023;6;6;0;100;0;139985;1393.16666666667;100
02808;2023;3;3;0;100;0;108333.333333333;936.333333333333;113
02809;2023;2;2;0;100;0;218050;2441;89
02810;2023;101;63;38;62.3762376237624;37.6237623762376;178154.00990099;2093.08910891089;85.7623762376238
02813;2023;5;5;0;100;0;108190;1030.2;101
02815;2023;4;4;0;100;0;166575;1417;113.5
02817;2023;1;1;0;100;0;80000;548;146
02818;2023;6;6;0;100;0;144333.333333333;1950.33333333333;78
02819;2023;2;2;0;100;0;93000;883;109.5
02820;2023;20;20;0;100;0;158197.5;1365.6;115.65
02821;2023;6;6;0;100;0;146991.666666667;1285.33333333333;116.333333333333
02823;2023;1;1;0;100;0;76000;704;108
02824;2023;2;2;0;100;0;331000;2235;142
02826;2023;1;1;0;100;0;85000;752;113
02827;2023;3;3;0;100;0;132000;937.333333333333;167.333333333333
02828;2023;2;2;0;100;0;104750;1159;90.5
02829;2023;1;1;0;100;0;275000;2115;130
02830;2023;9;9;0;100;0;85638.8888888889;1052.22222222222;74.5555555555556
02831;2023;2;2;0;100;0;163200;1798.5;99
02832;2023;3;3;0;100;0;154733.333333333;1363.33333333333;114
02833;2023;3;3;0;100;0;115666.666666667;1303.66666666667;71.3333333333333
02834;2023;2;2;0;100;0;152350;1441.5;103.5
03001;2023;39;37;2;94.8717948717949;5.12820512820513;187879.948717949;2066.33333333333;99.1538461538462
03002;2023;3;3;0;100;0;224333.333333333;2219.66666666667;101.333333333333
03003;2023;13;13;0;100;0;87142.3076923077;1034.38461538462;83.0769230769231
03004;2023;3;3;0;100;0;114730;733.333333333333;136.666666666667
03005;2023;4;4;0;100;0;56650;1769.25;38.25
03006;2023;10;10;0;100;0;100906;1261;77.5
03007;2023;6;6;0;100;0;73833.3333333333;745.166666666667;90.8333333333333
03008;2023;2;2;0;100;0;97261;1188.5;87.5
03009;2023;1;1;0;100;0;270000;1646;164
03011;2023;6;6;0;100;0;174500;1573.16666666667;110.666666666667
03012;2023;2;2;0;100;0;192500;2187.5;94
03013;2023;35;35;0;100;0;164690.257142857;1700.14285714286;98.4857142857143
03014;2023;7;7;0;100;0;203757.714285714;2477.57142857143;88.1428571428571
03015;2023;4;4;0;100;0;129500;1744.25;74
03016;2023;2;2;0;100;0;117500;1789.5;70.5
03018;2023;7;7;0;100;0;116935.857142857;1364.28571428571;90
03019;2023;18;18;0;100;0;136170;1490.38888888889;104.777777777778
03020;2023;3;3;0;100;0;95616.6666666667;928.666666666667;103.666666666667
03022;2023;16;16;0;100;0;103840.3125;1108;93.625
03023;2023;124;91;33;73.3870967741936;26.6129032258064;171407.822580645;1824.23387096774;92.8225806451613
03024;2023;6;6;0;100;0;111600.833333333;1374.33333333333;111.166666666667
03025;2023;16;16;0;100;0;118250;1121.8125;107.0625
03026;2023;6;5;1;83.3333333333333;16.6666666666667;101600;1086.33333333333;88.8333333333333
03027;2023;13;13;0;100;0;96801.5384615385;984.769230769231;98.0769230769231
03028;2023;4;4;0;100;0;123850;1124.75;118.5
03029;2023;18;18;0;100;0;131178.888888889;1364.72222222222;97
03030;2023;9;9;0;100;0;160098.888888889;1765.33333333333;90.5555555555556
03031;2023;2;2;0;100;0;56033.5;900;62
03032;2023;5;5;0;100;0;90346;1175;76
03033;2023;3;3;0;100;0;120066.666666667;1609.66666666667;84.3333333333333
03034;2023;6;6;0;100;0;91566.6666666667;1079.33333333333;83.8333333333333
03035;2023;1;1;0;100;0;65000;637;102
03036;2023;37;35;2;94.5945945945946;5.40540540540541;151728.27027027;1500.89189189189;99.5405405405405
03037;2023;1;1;0;100;0;70000;875;80
03038;2023;2;2;0;100;0;111500;916.5;119.5
03039;2023;3;3;0;100;0;146916.666666667;1155.33333333333;132.666666666667
03040;2023;10;10;0;100;0;189515;1802.1;103.6
03041;2023;4;4;0;100;0;97710.25;989.25;111
03042;2023;8;8;0;100;0;88375;909.375;95.75
03043;2023;10;10;0;100;0;107341;1161.9;95.5
03044;2023;18;17;1;94.4444444444444;5.55555555555556;173740;1838.94444444444;96.9444444444444
03045;2023;7;7;0;100;0;123874;1181.14285714286;111.142857142857
03046;2023;14;14;0;100;0;87520.3571428571;981.357142857143;84
03047;2023;9;9;0;100;0;69544.4444444444;882.111111111111;72.5555555555556
03048;2023;17;15;2;88.2352941176471;11.7647058823529;93656.8235294118;972.705882352941;96.5294117647059
03049;2023;9;9;0;100;0;130944.444444444;1370.66666666667;93
03050;2023;4;4;0;100;0;104728.75;1521.5;66
03051;2023;6;6;0;100;0;106454;927.166666666667;118.5
03052;2023;11;11;0;100;0;143936.363636364;1395.45454545455;101.090909090909
03053;2023;17;17;0;100;0;113794.117647059;1154.11764705882;110.470588235294
03054;2023;5;5;0;100;0;227040.2;2922;87.2
03055;2023;10;10;0;100;0;68430;805.5;86.2
03056;2023;1;1;0;100;0;37000;1156;32
03058;2023;3;3;0;100;0;77833.3333333333;660.666666666667;105.666666666667
03059;2023;2;2;0;100;0;197500;1522;128.5
03060;2023;14;14;0;100;0;235345.714285714;2026.64285714286;117
03061;2023;4;4;0;100;0;143037.5;1198.5;107.25
03062;2023;3;3;0;100;0;137166.666666667;1463.33333333333;86
03063;2023;14;14;0;100;0;114784.857142857;1230.42857142857;94.2142857142857
03064;2023;1;1;0;100;0;154720;2063;75
03065;2023;6;6;0;100;0;106416.666666667;1133.83333333333;93.6666666666667
03066;2023;6;6;0;100;0;52633.3333333333;590.833333333333;88
03067;2023;2;2;0;100;0;168000;1165.5;156.5
03070;2023;1;1;0;100;0;185000;2681;69
03071;2023;5;5;0;100;0;93380;952.4;98.2
03072;2023;4;4;0;100;0;71875;980;77.25
03073;2023;5;5;0;100;0;147750;1176.4;118.6
03074;2023;7;7;0;100;0;120810;1047;108.285714285714
03075;2023;4;4;0;100;0;90000;911.25;89.75
03076;2023;1;1;0;100;0;211800;1581;134
03077;2023;2;2;0;100;0;88750;955;97.5
03078;2023;6;6;0;100;0;114429.166666667;1328.33333333333;88.6666666666667
03079;2023;7;7;0;100;0;153057.142857143;1301.28571428571;114.857142857143
03080;2023;7;7;0;100;0;149800;1581.28571428571;92.2857142857143
03081;2023;6;6;0;100;0;103000;903.833333333333;117
03082;2023;76;71;5;93.4210526315789;6.57894736842105;83709.6052631579;970.473684210526;88.4473684210526
03083;2023;9;9;0;100;0;152344.444444444;1419.88888888889;111.666666666667
03084;2023;29;28;1;96.551724137931;3.44827586206897;74665.5172413793;973.758620689655;79.4137931034483
03085;2023;5;5;0;100;0;214100;1184.4;188.8
03086;2023;2;2;0;100;0;91500;813;116.5
03087;2023;10;10;0;100;0;78147.5;977.3;81.8
03088;2023;3;3;0;100;0;45000;847;50
03089;2023;4;4;0;100;0;88475;1073.25;87.5
03090;2023;3;3;0;100;0;130000;1047;128.666666666667
03091;2023;4;3;1;75;25;113750;1162.5;104.75
03092;2023;5;5;0;100;0;102940;1059.6;99.6
03093;2023;11;11;0;100;0;167306.363636364;1642.27272727273;104.454545454545
03094;2023;37;34;3;91.8918918918919;8.10810810810811;153959.027027027;1683.62162162162;88.8378378378378
03095;2023;197;115;82;58.3756345177665;41.6243654822335;117425.279187817;1488.12182741117;78.2944162436548
03096;2023;2;2;0;100;0;98125;1077;91.5
03097;2023;6;6;0;100;0;77500;901.833333333333;72.1666666666667
03098;2023;64;59;5;92.1875;7.8125;94744.765625;1123.53125;81.890625
03099;2023;5;5;0;100;0;50650;760.2;61.6
03100;2023;18;18;0;100;0;102791.111111111;1134.22222222222;94.7777777777778
03101;2023;87;83;4;95.4022988505747;4.59770114942529;118145.310344828;1270.72413793103;92.5057471264368
03102;2023;26;26;0;100;0;115590;1189.65384615385;95.9615384615385
03103;2023;13;13;0;100;0;75261.5384615385;948.769230769231;76.5384615384615
03104;2023;8;8;0;100;0;65064.875;661.75;97
03105;2023;5;5;0;100;0;84960;969.6;80
03106;2023;17;17;0;100;0;113500.058823529;1118.29411764706;97.5882352941177
03107;2023;14;12;2;85.7142857142857;14.2857142857143;165526;1368.71428571429;126.5
03108;2023;4;4;0;100;0;93375;1170.25;77.5
03109;2023;4;4;0;100;0;161450;1699.25;93.25
03110;2023;4;4;0;100;0;187256.25;2197.25;90.75
03111;2023;12;12;0;100;0;116745.833333333;1200.83333333333;100.833333333333
03112;2023;11;11;0;100;0;111590;1334.09090909091;88.0909090909091
03113;2023;8;8;0;100;0;151103.75;1466.5;96.875
03114;2023;3;3;0;100;0;102000;1149.66666666667;92.3333333333333
03115;2023;1;1;0;100;0;119000;744;160
03116;2023;1;1;0;100;0;126500;2259;56
03117;2023;4;4;0;100;0;87250;979.25;93.5
03118;2023;62;55;7;88.7096774193548;11.2903225806452;126049;1462.74193548387;86.0161290322581
03119;2023;10;10;0;100;0;96203;1135.7;84.6
03120;2023;10;10;0;100;0;110895;1205.8;92.9
03121;2023;5;5;0;100;0;135300;1311.4;101.6
03122;2023;4;4;0;100;0;206543.75;1381.25;160
03124;2023;3;3;0;100;0;156833.333333333;1597.33333333333;108.666666666667
03125;2023;2;2;0;100;0;41200;968;43
03126;2023;17;13;4;76.4705882352941;23.5294117647059;153600;1647.41176470588;88.6470588235294
03127;2023;12;12;0;100;0;138471;1321.16666666667;105.75
03128;2023;26;25;1;96.1538461538462;3.84615384615385;102432.038461538;1188.26923076923;88.3076923076923
03129;2023;5;5;0;100;0;77800;721.6;104.4
03130;2023;1;1;0;100;0;140000;1647;85
03131;2023;5;5;0;100;0;117560;1188.2;98.8
03132;2023;4;4;0;100;0;52750;704;72
03133;2023;12;12;0;100;0;137635;1417;96.5833333333333
03134;2023;3;3;0;100;0;119333.333333333;1138.33333333333;111.333333333333
03135;2023;6;6;0;100;0;70916.6666666667;941;78.3333333333333
03136;2023;2;2;0;100;0;106750;870;122
03137;2023;3;3;0;100;0;150300;1728;93.3333333333333
03138;2023;36;32;4;88.8888888888889;11.1111111111111;111566.694444444;1190.08333333333;96.1111111111111
03139;2023;8;7;1;87.5;12.5;107500;1493.375;90.75
03140;2023;14;13;1;92.8571428571429;7.14285714285714;100375;1072.28571428571;89.5
03142;2023;4;4;0;100;0;138425;1346.5;104.75
03143;2023;1;1;0;100;0;95000;880;108
03144;2023;1;1;0;100;0;182000;2116;86
03145;2023;5;5;0;100;0;159154;1327.2;119.6
03146;2023;1;1;0;100;0;114000;966;118
03147;2023;4;4;0;100;0;116500;1042.5;103.25
03148;2023;5;5;0;100;0;90959.6;1139.8;78.8
03149;2023;4;4;0;100;0;94247.5;1164;83.5
03150;2023;3;3;0;100;0;109416.666666667;1115.66666666667;86.6666666666667
03151;2023;5;5;0;100;0;146700;1856.4;91.8
03152;2023;4;4;0;100;0;115812.5;853;138.5
03154;2023;4;4;0;100;0;158125;1070.25;182.75
03155;2023;26;26;0;100;0;82748.2692307692;1008.46153846154;83.4230769230769
03156;2023;14;14;0;100;0;125580;1426.85714285714;95.2857142857143
03157;2023;5;5;0;100;0;135290;1425.2;103.6
03158;2023;11;11;0;100;0;116014.545454545;1012.36363636364;112.545454545455
03159;2023;8;8;0;100;0;105518.75;949.25;114.875
03160;2023;3;3;0;100;0;213333.333333333;1770.33333333333;121
03161;2023;10;10;0;100;0;103250;1197.1;89.8
03162;2023;3;3;0;100;0;140963.333333333;1438;99
03163;2023;4;4;0;100;0;143075;1731.5;94.75
03164;2023;3;3;0;100;0;101250;1122;95.6666666666667
03165;2023;15;15;0;100;0;66696.6666666667;1071.46666666667;68.5333333333333
03166;2023;2;2;0;100;0;181100;1880.5;98.5
03167;2023;4;4;0;100;0;58125;831.5;81.25
03168;2023;20;19;1;95;5;122558.65;1392.65;95.75
03169;2023;5;5;0;100;0;166468;1540.4;112.6
03170;2023;1;1;0;100;0;199000;948;210
03171;2023;6;6;0;100;0;110250;1270.83333333333;86.6666666666667
03172;2023;1;1;0;100;0;32000;800;40
03173;2023;6;6;0;100;0;98526.6666666667;1569.66666666667;65.8333333333333
03174;2023;13;13;0;100;0;165815.384615385;1935.07692307692;98.2307692307692
03175;2023;7;7;0;100;0;125952.857142857;1207.71428571429;110.571428571429
03176;2023;7;7;0;100;0;113142.857142857;1272.28571428571;89.5714285714286
03177;2023;4;4;0;100;0;77625;940.25;105
03178;2023;5;5;0;100;0;109751;999.8;111.8
03179;2023;3;3;0;100;0;94250;1278.66666666667;76
03180;2023;3;3;0;100;0;144333.333333333;1193;121.333333333333
03181;2023;9;9;0;100;0;54264.4444444444;831.111111111111;67.3333333333333
03182;2023;2;2;0;100;0;71000;900.5;68.5
03183;2023;5;5;0;100;0;86872;570;147.6
03184;2023;4;4;0;100;0;152100;1466;108.5
03185;2023;511;251;260;49.119373776908;50.880626223092;76861.28962818;1013.48140900196;74.9099804305284
03186;2023;16;14;2;87.5;12.5;78848.75;980.0625;89
03187;2023;2;2;0;100;0;98300;1079;88.5
03189;2023;12;12;0;100;0;91429.1666666667;1052.16666666667;85
03190;2023;256;91;165;35.546875;64.453125;108439.87890625;1468.48828125;74.00390625
03191;2023;4;4;0;100;0;76812.5;1075.25;70.25
03192;2023;6;6;0;100;0;131172.5;1044.66666666667;122.5
03193;2023;4;4;0;100;0;287300;1912;123.75
03194;2023;2;2;0;100;0;86300;1319;66
03195;2023;46;30;16;65.2173913043478;34.7826086956522;114510.760869565;1302.84782608696;89.0869565217391
03196;2023;1;1;0;100;0;80000;1333;60
03197;2023;9;8;1;88.8888888888889;11.1111111111111;154905.555555556;1426.55555555556;109.333333333333
03198;2023;2;2;0;100;0;58500;708;77.5
03200;2023;9;9;0;100;0;190144.444444444;1579.22222222222;121.555555555556
03201;2023;3;3;0;100;0;118100;1079.66666666667;112.333333333333
03202;2023;12;12;0;100;0;96047.5;1069.58333333333;93.3333333333333
03203;2023;3;3;0;100;0;48500;938.666666666667;47.6666666666667
03204;2023;4;4;0;100;0;142218.75;1239.25;113.5
03205;2023;4;4;0;100;0;116050;1891.75;83.25
03206;2023;2;2;0;100;0;88717.5;668;130.5
03207;2023;9;9;0;100;0;127735.555555556;1447.88888888889;85.8888888888889
03208;2023;8;8;0;100;0;85113.75;733.875;123.375
03209;2023;3;3;0;100;0;181800;1438;118.666666666667
03210;2023;3;3;0;100;0;84000;985.666666666667;83
03211;2023;25;25;0;100;0;180132.44;1547;116.08
03212;2023;18;18;0;100;0;127336.111111111;1364.94444444444;92.1111111111111
03213;2023;4;4;0;100;0;153031.25;1539.25;93.25
03214;2023;4;4;0;100;0;72187.5;792.5;100.5
03215;2023;6;6;0;100;0;141241.666666667;1349.33333333333;122
03216;2023;1;1;0;100;0;86000;688;125
03217;2023;5;5;0;100;0;97809;1046.4;93.4
03218;2023;4;4;0;100;0;167680;1554.25;120.75
03219;2023;3;3;0;100;0;86333.3333333333;1633.33333333333;84.6666666666667
03220;2023;9;9;0;100;0;133140;1367.66666666667;97.7777777777778
03221;2023;8;8;0;100;0;84875;1163;67.5
03222;2023;1;1;0;100;0;63000;1969;32
03223;2023;1;1;0;100;0;486977;3775;129
03224;2023;7;7;0;100;0;81787.1428571429;1299.85714285714;70.7142857142857
03225;2023;7;7;0;100;0;122138.571428571;767.428571428571;134.571428571429
03226;2023;5;5;0;100;0;64598;899.6;70.2
03227;2023;7;7;0;100;0;185021.428571429;1202.71428571429;125.714285714286
03229;2023;6;6;0;100;0;77175;875.666666666667;84.1666666666667
03230;2023;2;2;0;100;0;162800;1114;146.5
03231;2023;3;3;0;100;0;51833.3333333333;588.333333333333;86.3333333333333
03233;2023;9;9;0;100;0;121888.888888889;1022.77777777778;117.666666666667
03234;2023;1;1;0;100;0;85000;1417;60
03235;2023;9;9;0;100;0;111722.222222222;1475.55555555556;94.7777777777778
03236;2023;36;29;7;80.5555555555556;19.4444444444444;116860.638888889;1207.41666666667;89.9722222222222
03237;2023;4;4;0;100;0;125512.5;1521.25;84.25
03238;2023;4;4;0;100;0;131517.5;1449.25;88
03239;2023;2;2;0;100;0;81000;1130;74
03240;2023;6;6;0;100;0;65038.3333333333;802;80.1666666666667
03241;2023;8;8;0;100;0;106125;1058.25;103.25
03242;2023;7;7;0;100;0;103838.571428571;1213.28571428571;88.2857142857143
03244;2023;1;1;0;100;0;30000;500;60
03245;2023;1;1;0;100;0;185000;1402;132
03246;2023;6;6;0;100;0;85433.3333333333;826.833333333333;94.5
03247;2023;2;2;0;100;0;96250;1267;78
03248;2023;5;5;0;100;0;82550;1327.2;64
03249;2023;6;6;0;100;0;110393.333333333;1308.5;79.1666666666667
03250;2023;8;8;0;100;0;112324.375;1215.375;91.375
03251;2023;6;6;0;100;0;103100;1202.5;91.6666666666667
03252;2023;2;2;0;100;0;191300;2118.5;89
03253;2023;7;7;0;100;0;104480;1095.14285714286;97.1428571428571
03254;2023;51;42;9;82.3529411764706;17.6470588235294;100782.941176471;1220.98039215686;81.843137254902
03255;2023;3;3;0;100;0;136666.666666667;1333.66666666667;99.3333333333333
03256;2023;6;6;0;100;0;121025;1339.66666666667;101.333333333333
03257;2023;12;12;0;100;0;130197.083333333;1404.75;90.75
03258;2023;19;19;0;100;0;187657.315789474;1825.36842105263;107.210526315789
03259;2023;9;9;0;100;0;89722.2222222222;1178.11111111111;73.7777777777778
03260;2023;5;5;0;100;0;108600;1214.2;89.4
03261;2023;2;2;0;100;0;140750;999.5;143.5
03262;2023;12;12;0;100;0;149882.166666667;1530.83333333333;95.5833333333333
03263;2023;1;1;0;100;0;80000;1176;68
03264;2023;29;28;1;96.551724137931;3.44827586206897;143898.275862069;1700.68965517241;89.2758620689655
03265;2023;8;8;0;100;0;78312.5;1080.5;69.125
03266;2023;3;3;0;100;0;166833.333333333;1283;125
03267;2023;10;10;0;100;0;117730;1240;98.5
03268;2023;6;6;0;100;0;167292.5;1322;116.666666666667
03270;2023;1;1;0;100;0;382000;2247;170
03271;2023;5;5;0;100;0;277888;1972;130.6
03272;2023;10;10;0;100;0;55682;987.7;59
03273;2023;2;2;0;100;0;186000;2628;80
03274;2023;6;6;0;100;0;86487.6666666667;1034.16666666667;86.6666666666667
03275;2023;23;22;1;95.6521739130435;4.34782608695652;122547.826086957;1459.13043478261;86.2608695652174
03276;2023;1;1;0;100;0;193500;1344;144
03277;2023;1;1;0;100;0;80000;584;137
03278;2023;3;3;0;100;0;114000;1221.33333333333;86.6666666666667
03279;2023;2;2;0;100;0;73500;828.5;88.5
03280;2023;4;4;0;100;0;84500;807.5;107
03281;2023;10;10;0;100;0;95300;1293.8;87.4
03282;2023;5;5;0;100;0;111800;1139.4;104.8
03283;2023;11;11;0;100;0;106927.272727273;1137.09090909091;93.7272727272727
03284;2023;6;6;0;100;0;165666.666666667;2266.33333333333;76
03285;2023;3;3;0;100;0;121915;1959;62
03286;2023;10;10;0;100;0;201145.2;1699.4;114
03287;2023;6;6;0;100;0;67750;845.333333333333;81.1666666666667
03288;2023;12;12;0;100;0;83858.3333333333;959.666666666667;95.1666666666667
03289;2023;4;4;0;100;0;83975;1143.25;79
03290;2023;15;15;0;100;0;141420;1490;97.1333333333333
03291;2023;5;5;0;100;0;111812;1004.6;112.2
03292;2023;8;8;0;100;0;105125;965.875;110
03293;2023;3;3;0;100;0;47000;1042.66666666667;47.6666666666667
03294;2023;1;1;0;100;0;62000;969;64
03296;2023;5;5;0;100;0;63000;875.4;71.2
03297;2023;27;27;0;100;0;79923.7037037037;958.62962962963;85.6296296296296
03298;2023;47;36;11;76.5957446808511;23.4042553191489;95247.3404255319;1159.40425531915;82.0212765957447
03299;2023;2;2;0;100;0;78240;953.5;74
03300;2023;3;3;0;100;0;107783.333333333;844.333333333333;116.333333333333
03301;2023;10;9;1;90;10;129650;1438.4;88.5
03303;2023;1;1;0;100;0;49700;710;70
03304;2023;29;29;0;100;0;219130;1794.65517241379;118.965517241379
03305;2023;4;4;0;100;0;174875;1574;109
03306;2023;17;17;0;100;0;160550.588235294;1965.47058823529;85.7058823529412
03307;2023;4;4;0;100;0;131350;1582;90.25
03308;2023;3;3;0;100;0;97916.6666666667;1047.33333333333;97
03309;2023;4;4;0;100;0;72775;811.75;100.5
03310;2023;681;153;528;22.4669603524229;77.5330396475771;133323.856093979;1911.27459618209;68.56093979442
03311;2023;8;8;0;100;0;92883.875;1082.625;77.5
03312;2023;3;3;0;100;0;75000;913.666666666667;91
03313;2023;5;5;0;100;0;172860;1782.8;95.8
03314;2023;12;12;0;100;0;136750;1564.08333333333;90.8333333333333
03315;2023;15;15;0;100;0;112754.666666667;1004.86666666667;107.6
03316;2023;11;11;0;100;0;120634.545454545;1614.81818181818;84.6363636363636
03317;2023;3;3;0;100;0;60833.3333333333;802;76
03319;2023;7;7;0;100;0;82785.7142857143;927.571428571429;99
03320;2023;4;4;0;100;0;79512.5;1638.5;62.75
03321;2023;163;114;49;69.9386503067485;30.0613496932515;140742.306748466;1691.71165644172;82.2944785276074
04001;2023;7;7;0;100;0;351021.428571429;5218;88.4285714285714
04004;2023;10;10;0;100;0;159748;2031.3;77.9
04005;2023;4;3;1;75;25;59106.25;1043.25;58.25
04006;2023;291;13;278;4.46735395189003;95.53264604811;89627.4261168385;2786.04467353952;30.7766323024055
04007;2023;1;1;0;100;0;131500;1801;73
04008;2023;9;4;5;44.4444444444444;55.5555555555556;135088.888888889;1799.33333333333;72.2222222222222
04012;2023;1;1;0;100;0;660000;5593;118
04013;2023;8;8;0;100;0;327048;2586.75;120.875
04016;2023;1;1;0;100;0;93610;851;110
04017;2023;4;1;3;25;75;77877.25;1502.75;56
04018;2023;22;18;4;81.8181818181818;18.1818181818182;269374.318181818;2822.36363636364;96.6818181818182
04019;2023;98;16;82;16.3265306122449;83.6734693877551;151690.663265306;2946;51.530612244898
04020;2023;1;1;0;100;0;60000;571;105
04022;2023;8;6;2;75;25;110916.25;2068;68.375
04023;2023;5;5;0;100;0;141880;1634.6;91.8
04024;2023;1;1;0;100;0;155000;1505;103
04025;2023;9;6;3;66.6666666666667;33.3333333333333;160045.555555556;2434.77777777778;64.6666666666667
04026;2023;4;4;0;100;0;149437.5;1897.25;89.5
04027;2023;3;3;0;100;0;382666.666666667;4147.33333333333;89.6666666666667
04028;2023;2;1;1;50;50;227500;5756.5;39
04030;2023;1;1;0;100;0;55000;1170;47
04031;2023;11;11;0;100;0;276582.272727273;2191.18181818182;117.636363636364
04032;2023;4;3;1;75;25;118550;2789.5;42.25
04033;2023;9;9;0;100;0;153724.222222222;2928.55555555556;60.8888888888889
04034;2023;9;9;0;100;0;218522.222222222;2636;85.7777777777778
04035;2023;6;4;2;66.6666666666667;33.3333333333333;223275;1882.33333333333;107.666666666667
04036;2023;6;5;1;83.3333333333333;16.6666666666667;214158.333333333;3679.33333333333;85
04037;2023;1;1;0;100;0;210000;1721;122
04039;2023;27;19;8;70.3703703703704;29.6296296296296;215357.555555556;2740;73.0740740740741
04040;2023;1;1;0;100;0;90000;1667;54
04041;2023;1;1;0;100;0;279000;2790;100
04042;2023;1;1;0;100;0;120000;1091;110
04043;2023;1;1;0;100;0;202500;3375;60
04045;2023;22;19;3;86.3636363636364;13.6363636363636;352877.590909091;3273.77272727273;98.5454545454545
04046;2023;4;4;0;100;0;217100;1922.25;109
04047;2023;5;4;1;80;20;113200;1346.2;95.2
04049;2023;77;33;44;42.8571428571429;57.1428571428571;152152.337662338;2059.87012987013;74
04051;2023;1;0;1;0;100;84000;1000;84
04053;2023;6;6;0;100;0;239823.333333333;2491.33333333333;98.5
04054;2023;1;1;0;100;0;180000;1000;180
04057;2023;3;3;0;100;0;249600;1940.33333333333;141.666666666667
04058;2023;3;3;0;100;0;110466.666666667;1219;87.6666666666667
04059;2023;4;4;0;100;0;196250;2268;87
04061;2023;7;4;3;57.1428571428571;42.8571428571429;169392.142857143;1979.14285714286;79.1428571428571
04062;2023;8;3;5;37.5;62.5;118595.625;2482.625;49.5
04063;2023;16;16;0;100;0;228793.375;2517.5625;94.375
04065;2023;14;14;0;100;0;181035.285714286;2284.42857142857;79.2142857142857
04066;2023;3;3;0;100;0;548266.666666667;3514.33333333333;151.666666666667
04068;2023;9;8;1;88.8888888888889;11.1111111111111;253411.111111111;3072.55555555556;81
04069;2023;1;1;0;100;0;62000;1722;36
04070;2023;256;61;195;23.828125;76.171875;126222.05078125;1859.69921875;65.609375
04072;2023;1;1;0;100;0;175000;1842;95
04073;2023;61;10;51;16.3934426229508;83.6065573770492;110844.803278689;2470.62295081967;39.2622950819672
04074;2023;1;1;0;100;0;343500;2748;125
04075;2023;3;3;0;100;0;474333.333333333;5550;100.666666666667
04076;2023;17;12;5;70.5882352941177;29.4117647058824;149165.294117647;1599.23529411765;88.7647058823529
04077;2023;1;1;0;100;0;432000;4454;97
04079;2023;16;12;4;75;25;205538.4375;2395;86.625
04081;2023;6;5;1;83.3333333333333;16.6666666666667;166258.333333333;2646.5;67
04084;2023;16;16;0;100;0;168588.75;2479.625;69.6875
04086;2023;3;1;2;33.3333333333333;66.6666666666667;151515;2541.66666666667;57
04087;2023;3;3;0;100;0;268766.666666667;2570;114
04088;2023;76;46;30;60.5263157894737;39.4736842105263;264749.986842105;3007.51315789474;90.4473684210526
04090;2023;1;1;0;100;0;63500;1058;60
04092;2023;3;2;1;66.6666666666667;33.3333333333333;68686.6666666667;1461.33333333333;47.6666666666667
04094;2023;143;35;108;24.4755244755245;75.5244755244755;135446.230769231;3029.43356643357;45.979020979021
04095;2023;3;3;0;100;0;243561.666666667;3018;84.6666666666667
04096;2023;20;6;14;30;70;192926.25;2937.4;70.35
04097;2023;5;5;0;100;0;236839;2341;103
04099;2023;4;4;0;100;0;134275;1839;69.5
04101;2023;2;2;0;100;0;224050;1700;129
04102;2023;3;0;3;0;100;35900;864.666666666667;49.3333333333333
04104;2023;3;3;0;100;0;212316.666666667;2664;80.6666666666667
04106;2023;4;4;0;100;0;463233.75;8694.5;70.5
04107;2023;1;1;0;100;0;33750;785;43
04108;2023;19;17;2;89.4736842105263;10.5263157894737;186641.210526316;2250.31578947368;80.5263157894737
04109;2023;2;2;0;100;0;222875;3704.5;59.5
04110;2023;8;8;0;100;0;240485.625;2051;118
04111;2023;15;14;1;93.3333333333333;6.66666666666667;299482.266666667;3329.46666666667;96.2
04112;2023;336;115;221;34.2261904761905;65.7738095238095;183944.092261905;2424.47023809524;75.0744047619048
04113;2023;4;4;0;100;0;164637.5;1691.5;91
04115;2023;2;2;0;100;0;135500;3550;38
04116;2023;47;36;11;76.5957446808511;23.4042553191489;242173.531914894;2296.1914893617;103.234042553191
04120;2023;1;1;0;100;0;560000;3353;167
04121;2023;8;6;2;75;25;168755.5;1500.75;102.375
04122;2023;6;6;0;100;0;198325;2065.83333333333;87
04123;2023;14;14;0;100;0;202521.928571429;2162.57142857143;96.0714285714286
04124;2023;9;8;1;88.8888888888889;11.1111111111111;137869.444444444;2623.33333333333;57.2222222222222
04126;2023;35;11;24;31.4285714285714;68.5714285714286;120412.085714286;2314.85714285714;53.1142857142857
04127;2023;1;1;0;100;0;278500;2932;95
04130;2023;4;4;0;100;0;148723.75;2273.75;59.5
04132;2023;3;3;0;100;0;208483.333333333;3860.66666666667;61.3333333333333
04133;2023;2;2;0;100;0;145585;1482.5;106.5
04134;2023;7;6;1;85.7142857142857;14.2857142857143;141064.285714286;2045.14285714286;73.1428571428571
04135;2023;11;9;2;81.8181818181818;18.1818181818182;247781.818181818;2456.54545454545;89
04136;2023;6;6;0;100;0;162316.666666667;2105.83333333333;75.1666666666667
04138;2023;2;2;0;100;0;140000;1653.5;82
04139;2023;6;5;1;83.3333333333333;16.6666666666667;167527.833333333;1838.5;94.5
04140;2023;2;2;0;100;0;123756;1412;82
04141;2023;2;1;1;50;50;510390;5669.5;82.5
04142;2023;1;1;0;100;0;45000;562;80
04143;2023;78;60;18;76.9230769230769;23.0769230769231;244501.230769231;2839.35897435897;88.7179487179487
04144;2023;2;2;0;100;0;149000;2312;64
04145;2023;10;9;1;90;10;228680;2749.2;86.8
04148;2023;12;11;1;91.6666666666667;8.33333333333333;135912.5;1934.33333333333;73.9166666666667
04149;2023;28;27;1;96.4285714285714;3.57142857142857;241673.214285714;2695.67857142857;90.1071428571429
04150;2023;5;3;2;60;40;190775;2454.4;80.2
04151;2023;6;6;0;100;0;199100;2580.33333333333;79.8333333333333
04152;2023;54;52;2;96.2962962962963;3.7037037037037;317786.055555556;2865.2962962963;111.296296296296
04155;2023;5;5;0;100;0;180214;2806.6;63
04156;2023;4;4;0;100;0;139200;1531;85.75
04157;2023;13;12;1;92.3076923076923;7.69230769230769;160473.307692308;1880.23076923077;94.6153846153846
04158;2023;14;12;2;85.7142857142857;14.2857142857143;146020.857142857;2076.14285714286;71
04159;2023;2;2;0;100;0;187100;1360.5;146
04160;2023;20;19;1;95;5;294957.45;3527.25;95.4
04161;2023;12;11;1;91.6666666666667;8.33333333333333;233554.166666667;2794.33333333333;90
04162;2023;4;3;1;75;25;159637.5;2451.75;67
04163;2023;8;8;0;100;0;157775;2739.125;63.875
04166;2023;16;11;5;68.75;31.25;129226.25;1502.1875;86.3125
04167;2023;1;1;0;100;0;360900;2406;150
04169;2023;3;3;0;100;0;195000;3521.66666666667;55.3333333333333
04170;2023;1;1;0;100;0;80000;1333;60
04171;2023;2;2;0;100;0;89500;1612.5;50
04172;2023;6;5;1;83.3333333333333;16.6666666666667;211100;1915.16666666667;106
04173;2023;11;6;5;54.5454545454545;45.4545454545455;140050;2030.09090909091;67.8181818181818
04174;2023;4;4;0;100;0;119125;2297.75;47.5
04175;2023;1;1;0;100;0;90000;1200;75
04176;2023;8;2;6;25;75;131472.5;2789.75;49.625
04178;2023;27;21;6;77.7777777777778;22.2222222222222;170767.962962963;2412.74074074074;72.1111111111111
04179;2023;4;4;0;100;0;199200;3672.25;62
04180;2023;1;1;0;100;0;295000;2757;107
04181;2023;1;1;0;100;0;229855;1869;123
04182;2023;3;3;0;100;0;142333.333333333;1710.66666666667;63.6666666666667
04183;2023;2;2;0;100;0;224875;2678.5;83.5
04184;2023;2;2;0;100;0;247500;2829.5;72.5
04188;2023;13;11;2;84.6153846153846;15.3846153846154;267238.461538462;3145.92307692308;90.4615384615385
04189;2023;8;8;0;100;0;194996;2820.375;62.125
04192;2023;13;12;1;92.3076923076923;7.69230769230769;219731.538461538;3160.92307692308;73.8461538461538
04193;2023;7;6;1;85.7142857142857;14.2857142857143;130334.285714286;2547;56.7142857142857
04194;2023;3;3;0;100;0;158333.333333333;2301.66666666667;62.3333333333333
04195;2023;11;5;6;45.4545454545455;54.5454545454545;203167.272727273;3010.90909090909;72.5454545454545
04197;2023;25;19;6;76;24;189916;2881.96;65.48
04199;2023;5;4;1;80;20;248236;2373.4;104
04200;2023;7;7;0;100;0;338178.571428571;3301.57142857143;103.714285714286
04201;2023;4;4;0;100;0;185947.5;2704.5;69.25
04202;2023;3;1;2;33.3333333333333;66.6666666666667;59933.3333333333;1597;41.3333333333333
04203;2023;25;7;18;28;72;88009.6;2176.32;36.88
04205;2023;49;20;29;40.8163265306122;59.1836734693878;116504.510204082;1948.69387755102;60.8163265306122
04206;2023;6;6;0;100;0;212000;2327.16666666667;92.3333333333333
04207;2023;1;1;0;100;0;45000;1000;45
04208;2023;8;7;1;87.5;12.5;600377.5;4330.125;133.125
04209;2023;97;55;42;56.701030927835;43.298969072165;169623.329896907;2231.84536082474;78.9587628865979
04210;2023;3;2;1;66.6666666666667;33.3333333333333;43333.3333333333;1087.66666666667;38.6666666666667
04211;2023;1;0;1;0;100;53000;1325;40
04216;2023;4;4;0;100;0;166750;1690.5;100.75
04217;2023;10;8;2;80;20;182045;2080.1;87.5
04218;2023;8;8;0;100;0;140339.625;1791.875;82.75
04219;2023;10;8;2;80;20;132781;1734.7;78.3
04220;2023;3;3;0;100;0;306858.333333333;2180.33333333333;145
04222;2023;6;4;2;66.6666666666667;33.3333333333333;123058;1841.83333333333;66.5
04224;2023;3;3;0;100;0;100856.666666667;1677.33333333333;52
04226;2023;135;8;127;5.92592592592593;94.0740740740741;118835.318518519;3003.71111111111;37.2962962962963
04227;2023;11;11;0;100;0;219960.454545455;2216.36363636364;117.363636363636
04228;2023;1;1;0;100;0;42500;559;76
04229;2023;6;5;1;83.3333333333333;16.6666666666667;172971.333333333;1826.33333333333;96.3333333333333
04230;2023;49;45;4;91.8367346938776;8.16326530612245;180672.163265306;2576.61224489796;70.9183673469388
04234;2023;1;1;0;100;0;377940;2423;156
04235;2023;1;1;0;100;0;160000;1778;90
04236;2023;4;4;0;100;0;77762.5;1566.25;49
04237;2023;7;2;5;28.5714285714286;71.4285714285714;91954.5714285714;1691.57142857143;46.4285714285714
04240;2023;8;4;4;50;50;131718.75;1937.625;71.25
04241;2023;2;1;1;50;50;210900;1735;127
04242;2023;39;37;2;94.8717948717949;5.12820512820513;283819.743589744;2911.10256410256;99
04244;2023;31;24;7;77.4193548387097;22.5806451612903;155848.387096774;2032.83870967742;75.3225806451613
04245;2023;37;25;12;67.5675675675676;32.4324324324324;248353.135135135;2996.75675675676;80.945945945946
05001;2023;22;4;18;18.1818181818182;81.8181818181818;134537.181818182;2553.90909090909;49.3181818181818
05003;2023;19;5;14;26.3157894736842;73.6842105263158;111410.157894737;1997.47368421053;57
05004;2023;57;16;41;28.0701754385965;71.9298245614035;161178.684210526;3138.82456140351;53.0175438596491
05006;2023;18;9;9;50;50;217934;2786.94444444444;75.3888888888889
05007;2023;4;0;4;0;100;114958.75;2495.25;48.5
05008;2023;10;10;0;100;0;145398;1945.8;75.5
05009;2023;3;3;0;100;0;142450;2400.66666666667;65
05010;2023;19;18;1;94.7368421052632;5.26315789473684;176007.368421053;1716.15789473684;94.5263157894737
05011;2023;1;0;1;0;100;80000;1053;76
05012;2023;11;2;9;18.1818181818182;81.8181818181818;210090.909090909;3647.18181818182;58
05013;2023;2;2;0;100;0;388135;2719;141.5
05014;2023;6;6;0;100;0;298568.333333333;2116.16666666667;140.333333333333
05016;2023;3;3;0;100;0;140500;1998.33333333333;70.6666666666667
05017;2023;18;11;7;61.1111111111111;38.8888888888889;268126.111111111;3141.77777777778;86.1666666666667
05018;2023;2;2;0;100;0;437325;3476;125.5
05019;2023;2;2;0;100;0;87000;886;84
05022;2023;3;3;0;100;0;163000;1439.33333333333;96
05023;2023;244;27;217;11.0655737704918;88.9344262295082;177726.676229508;2929.09016393443;60.1147540983607
05024;2023;2;2;0;100;0;150600;1480.5;102
05025;2023;1;1;0;100;0;315000;3500;90
05026;2023;16;4;12;25;75;218157.5;3257.75;68.0625
05027;2023;8;3;5;37.5;62.5;96792.75;2185.375;47.25
05028;2023;1;1;0;100;0;3,00E+05;2913;103
05029;2023;13;11;2;84.6153846153846;15.3846153846154;197570;2767.84615384615;73.7692307692308
05031;2023;6;5;1;83.3333333333333;16.6666666666667;214530;2693.16666666667;79
05032;2023;1;1;0;100;0;318000;3180;100
05033;2023;2;2;0;100;0;210500;2833.5;70
05036;2023;11;10;1;90.9090909090909;9.09090909090909;322570.272727273;3381.90909090909;96.9090909090909
05037;2023;1;1;0;100;0;495000;3000;165
05038;2023;7;5;2;71.4285714285714;28.5714285714286;362520;4720.85714285714;86.4285714285714
05039;2023;7;5;2;71.4285714285714;28.5714285714286;149428.571428571;1570.14285714286;89.2857142857143
05040;2023;31;20;11;64.5161290322581;35.4838709677419;262118.387096774;3614.1935483871;76.9032258064516
05044;2023;1;0;1;0;100;111140;3175;35
05045;2023;15;14;1;93.3333333333333;6.66666666666667;332027.333333333;3243.6;102.6
05046;2023;125;29;96;23.2;76.8;204684.592;3385.368;61.632
05047;2023;2;2;0;100;0;139750;1816.5;95.5
05048;2023;3;3;0;100;0;159026.666666667;1501.66666666667;103
05049;2023;1;1;0;100;0;75000;1786;42
05050;2023;3;1;2;33.3333333333333;66.6666666666667;131000;2829.66666666667;44.3333333333333
05052;2023;4;3;1;75;25;217500;2600;88
05053;2023;8;6;2;75;25;271737.5;2559.625;106.625
05054;2023;3;2;1;66.6666666666667;33.3333333333333;179333.333333333;2761;68.6666666666667
05055;2023;6;5;1;83.3333333333333;16.6666666666667;103413.333333333;1631;60
05057;2023;2;2;0;100;0;305750;3371;110
05058;2023;2;2;0;100;0;334000;2665.5;122
05059;2023;6;6;0;100;0;276151.666666667;2757.5;120
05060;2023;1;1;0;100;0;373500;2490;150
05061;2023;525;106;419;20.1904761904762;79.8095238095238;188028.16952381;2549.3580952381;74.1619047619048
05062;2023;3;2;1;66.6666666666667;33.3333333333333;139056.666666667;1821.66666666667;98
05063;2023;17;9;8;52.9411764705882;47.0588235294118;179167.176470588;4538.17647058824;61.6470588235294
05064;2023;1;1;0;100;0;158000;3511;45
05065;2023;41;9;32;21.9512195121951;78.0487804878049;200385.634146341;2723.75609756098;73.1707317073171
05068;2023;7;6;1;85.7142857142857;14.2857142857143;212192.857142857;2114.57142857143;99.2857142857143
05070;2023;40;21;19;52.5;47.5;175003.5;1912.975;86.175
05071;2023;2;2;0;100;0;430500;3255.5;132
05072;2023;20;4;16;20;80;133309.75;3195.2;39.1
05073;2023;2;2;0;100;0;130000;2092.5;62.5
05074;2023;2;2;0;100;0;397500;4217.5;97.5
05075;2023;6;6;0;100;0;296699.166666667;3031.5;98.6666666666667
05076;2023;2;1;1;50;50;137815;2149;68
05077;2023;15;1;14;6.66666666666667;93.3333333333333;117060;2371.93333333333;48.4
05078;2023;2;1;1;50;50;134500;1899;66.5
05079;2023;47;9;38;19.1489361702128;80.8510638297872;380009.595744681;5227.23404255319;67.063829787234
05081;2023;1;1;0;100;0;220300;3018;73
05082;2023;4;1;3;25;75;181440;2420;78.5
05084;2023;2;2;0;100;0;274600;2071.5;147.5
05085;2023;80;5;75;6.25;93.75;199761.675;4581.725;39.825
05086;2023;1;1;0;100;0;130000;3714;35
05087;2023;4;3;1;75;25;157252.5;2611.75;89.5
05090;2023;3;3;0;100;0;208640;3002.33333333333;88
05092;2023;9;9;0;100;0;350312.222222222;3182.33333333333;109.111111111111
05093;2023;11;6;5;54.5454545454545;45.4545454545455;210272.727272727;3418.45454545455;72.4545454545455
05095;2023;7;7;0;100;0;181550;2225.57142857143;81.8571428571429
05096;2023;114;7;107;6.14035087719298;93.859649122807;102812.692982456;2456.12280701754;40.9824561403509
05097;2023;4;4;0;100;0;226797.5;2337.25;94
05098;2023;97;6;91;6.18556701030928;93.8144329896907;140644.618556701;3445.65979381443;37.3711340206186
05099;2023;1;1;0;100;0;218520;1175;186
05100;2023;3;3;0;100;0;366166.666666667;2999.66666666667;122
05101;2023;46;13;33;28.2608695652174;71.7391304347826;177074.586956522;2922.30434782609;58.4347826086956
05102;2023;4;4;0;100;0;132656;1811.75;71
05103;2023;2;2;0;100;0;132210;1512.5;88.5
05104;2023;6;6;0;100;0;265543.333333333;2970.66666666667;86
05106;2023;11;6;5;54.5454545454545;45.4545454545455;249520;2959.72727272727;82.9090909090909
05107;2023;3;3;0;100;0;313333.333333333;4823.33333333333;101.666666666667
05108;2023;1;1;0;100;0;317500;5121;62
05109;2023;7;4;3;57.1428571428571;42.8571428571429;192135.714285714;4012.57142857143;53.1428571428571
05110;2023;91;4;87;4.3956043956044;95.6043956043956;82396.0659340659;2505.53846153846;30.4945054945055
05111;2023;7;7;0;100;0;418171.142857143;4039.85714285714;105.571428571429
05112;2023;1;1;0;100;0;180000;2118;85
05113;2023;2;2;0;100;0;358786.5;3685;98
05114;2023;20;3;17;15;85;114484.1;2967.35;37.85
05115;2023;7;2;5;28.5714285714286;71.4285714285714;183081.428571429;2159.57142857143;77
05116;2023;3;3;0;100;0;262666.666666667;4005.66666666667;62.6666666666667
05118;2023;19;17;2;89.4736842105263;10.5263157894737;186261.315789474;2384.68421052632;81
05119;2023;106;9;97;8.49056603773585;91.5094339622642;125315.254716981;3759.35849056604;32.4056603773585
05121;2023;4;4;0;100;0;150316.75;1403.25;99.25
05122;2023;6;5;1;83.3333333333333;16.6666666666667;319360;2590.16666666667;116.666666666667
05123;2023;15;13;2;86.6666666666667;13.3333333333333;252856;2817.93333333333;94.4
05124;2023;3;3;0;100;0;322783.333333333;2660;120.666666666667
05126;2023;6;5;1;83.3333333333333;16.6666666666667;87445.8333333333;1253.66666666667;68.8333333333333
05127;2023;5;1;4;20;80;153180;2062;75
05128;2023;8;8;0;100;0;244996.875;2991.75;78.75
05130;2023;2;2;0;100;0;936395;5911.5;167
05131;2023;1;1;0;100;0;40300;840;48
05132;2023;39;12;27;30.7692307692308;69.2307692307692;134172.025641026;2212.64102564103;66.7692307692308
05133;2023;70;9;61;12.8571428571429;87.1428571428571;224439.271428571;4028.22857142857;51.2714285714286
05134;2023;3;3;0;100;0;144333.333333333;2301;61.6666666666667
05135;2023;2;2;0;100;0;232042.5;2680.5;86.5
05136;2023;10;9;1;90;10;196116.4;1925.6;101.7
05139;2023;172;16;156;9.30232558139535;90.6976744186046;113583.081395349;2899.63953488372;35.5290697674419
05140;2023;4;4;0;100;0;227050;2439;97
05142;2023;12;8;4;66.6666666666667;33.3333333333333;162430.416666667;2336.33333333333;74.6666666666667
05144;2023;1;1;0;100;0;122000;2068;59
05145;2023;11;5;6;45.4545454545455;54.5454545454545;168330.727272727;2327.90909090909;67.2727272727273
05146;2023;4;4;0;100;0;138471.25;1328.75;108.75
05147;2023;2;1;1;50;50;121250;1323;91.5
05148;2023;7;7;0;100;0;183916.571428571;2098;90
05149;2023;34;3;31;8.82352941176471;91.1764705882353;83078.8823529412;2240.02941176471;37.5294117647059
05151;2023;14;9;5;64.2857142857143;35.7142857142857;240926.428571429;3126.14285714286;86.8571428571429
05152;2023;2;2;0;100;0;150000;2756.5;56
05153;2023;24;7;17;29.1666666666667;70.8333333333333;114099.583333333;2710.91666666667;40.375
05154;2023;3;3;0;100;0;143583.333333333;1904.33333333333;68
05156;2023;2;1;1;50;50;443650;3618;109.5
05157;2023;5;2;3;40;60;344500;4093.8;111.8
05158;2023;1;1;0;100;0;153180;1256;122
05159;2023;1;1;0;100;0;120000;960;125
05161;2023;76;8;68;10.5263157894737;89.4736842105263;235841.828947368;4991.47368421053;44.7894736842105
05162;2023;8;7;1;87.5;12.5;192268.75;2470.375;87.625
05163;2023;5;3;2;60;40;232000;3698.8;66
05164;2023;25;9;16;36;64;251811.36;3521.32;69.28
05165;2023;2;2;0;100;0;129750;3425.5;38
05166;2023;14;6;8;42.8571428571429;57.1428571428571;154059.285714286;1995.92857142857;71.5714285714286
05167;2023;1;1;0;100;0;50000;532;94
05168;2023;9;5;4;55.5555555555556;44.4444444444444;418717.333333333;5511.77777777778;84.8888888888889
05169;2023;1;1;0;100;0;132930;831;160
05170;2023;23;14;9;60.8695652173913;39.1304347826087;176484.347826087;2279.60869565217;80.1304347826087
05171;2023;2;2;0;100;0;327530;5234;65
05172;2023;5;5;0;100;0;167400;2268.2;72.2
05173;2023;4;4;0;100;0;253762.5;2628.25;96
05174;2023;10;7;3;70;30;247710.5;3376.9;70.6
05176;2023;9;7;2;77.7777777777778;22.2222222222222;156372.222222222;2375.55555555556;70.6666666666667
05177;2023;125;8;117;6.4;93.6;166150.312;3975.208;38.648
05178;2023;8;8;0;100;0;195928.75;2196;86.25
05179;2023;52;20;32;38.4615384615385;61.5384615384615;112345.576923077;1625.92307692308;71.1730769230769
05180;2023;7;6;1;85.7142857142857;14.2857142857143;197652.142857143;2587.85714285714;94.2857142857143
05181;2023;4;3;1;75;25;221180;3220;67
05183;2023;12;10;2;83.3333333333333;16.6666666666667;260128.333333333;3469.33333333333;75.9166666666667
06001;2023;1;1;0;100;0;120000;2400;50
06003;2023;21;6;15;28.5714285714286;71.4285714285714;118300.19047619;2015.7619047619;58.4285714285714
06004;2023;2101;175;1926;8.32936696811042;91.6706330318896;356341.903855307;5479.69871489767;61.5330794859591
06005;2023;2;2;0;100;0;80000;1442;55.5
06006;2023;12;9;3;75;25;436000;4809.33333333333;92.1666666666667
06007;2023;38;26;12;68.4210526315789;31.5789473684211;450951.026315789;5265.86842105263;84.1315789473684
06008;2023;1;1;0;100;0;35000;583;60
06010;2023;40;25;15;62.5;37.5;366323.575;3719.8;94.975
06011;2023;105;5;100;4.76190476190476;95.2380952380952;576221.114285714;8520.52380952381;66
06012;2023;309;12;297;3.88349514563107;96.1165048543689;392807.69579288;7013.03883495146;55.0161812297735
06013;2023;19;6;13;31.5789473684211;68.4210526315789;91073.6842105263;1822;48.9473684210526
06014;2023;9;6;3;66.6666666666667;33.3333333333333;293333.333333333;3581.55555555556;79.3333333333333
06015;2023;21;15;6;71.4285714285714;28.5714285714286;319021.428571429;3631.90476190476;94.6190476190476
06016;2023;26;10;16;38.4615384615385;61.5384615384615;170488.269230769;3975.23076923077;42.9615384615385
06017;2023;5;5;0;100;0;437800;3557.6;102.4
06018;2023;141;72;69;51.063829787234;48.936170212766;475597.539007092;5774.17021276596;78.2624113475177
06019;2023;16;8;8;50;50;361331.25;4199.875;88.8125
06020;2023;19;10;9;52.6315789473684;47.3684210526316;152787.368421053;2423.15789473684;66.6842105263158
06021;2023;12;8;4;66.6666666666667;33.3333333333333;163416.666666667;2843.33333333333;57.5833333333333
06022;2023;12;11;1;91.6666666666667;8.33333333333333;209725;2679.16666666667;77.6666666666667
06023;2023;49;21;28;42.8571428571429;57.1428571428571;99588.4285714286;1881.0612244898;53.1020408163265
06024;2023;4;3;1;75;25;179615;1782.75;94.75
06025;2023;7;3;4;42.8571428571429;57.1428571428571;246550;3244.85714285714;78
06026;2023;34;24;10;70.5882352941177;29.4117647058824;488473;4207.58823529412;113.911764705882
06027;2023;1022;130;892;12.720156555773;87.279843444227;290223.678082192;4856.14677103718;59.5958904109589
06028;2023;25;20;5;80;20;214277.8;2696.28;81.92
06029;2023;2608;101;2507;3.87269938650307;96.1273006134969;386083.947852761;6176.31288343558;59.4543711656442
06030;2023;1067;97;970;9.09090909090909;90.9090909090909;279081.004686036;4291.85941893158;61.9090909090909
06031;2023;14;12;2;85.7142857142857;14.2857142857143;381736.142857143;3590.35714285714;107.714285714286
06032;2023;84;5;79;5.95238095238095;94.0476190476191;425845.297619048;7945.84523809524;53.5476190476191
06033;2023;113;32;81;28.3185840707965;71.6814159292035;304170.884955752;4186.21238938053;74.1504424778761
06034;2023;12;10;2;83.3333333333333;16.6666666666667;489008.333333333;4662.75;103.333333333333
06035;2023;15;7;8;46.6666666666667;53.3333333333333;298466.666666667;4539.73333333333;68.1333333333333
06036;2023;6;3;3;50;50;288791.666666667;3556;74.3333333333333
06037;2023;8;7;1;87.5;12.5;240100;3806.625;70.375
06038;2023;51;37;14;72.5490196078431;27.4509803921569;843881.862745098;6228.72549019608;132.960784313725
06039;2023;8;8;0;100;0;527500;4932.25;111.5
06041;2023;11;8;3;72.7272727272727;27.2727272727273;174869.090909091;2188.81818181818;75
06042;2023;8;6;2;75;25;118518.75;1655.375;65.375
06043;2023;5;2;3;40;60;207700;5213.6;60.8
06044;2023;104;73;31;70.1923076923077;29.8076923076923;585485.105769231;5719.94230769231;99.9326923076923
06045;2023;2;2;0;100;0;85500;1477.5;63.5
06046;2023;30;26;4;86.6666666666667;13.3333333333333;499306.666666667;4826.73333333333;106.233333333333
06047;2023;5;4;1;80;20;122600;2133.6;50.6
06048;2023;67;35;32;52.2388059701493;47.7611940298507;285074.731343284;3596.0447761194;81.8805970149254
06050;2023;5;4;1;80;20;163500;3367.8;49.6
06051;2023;1;0;1;0;100;30000;1500;20
06052;2023;2;2;0;100;0;185000;1943;106
06053;2023;4;2;2;50;50;148500;1663;87.25
06054;2023;39;18;21;46.1538461538462;53.8461538461538;305230.461538462;3718.66666666667;82.3589743589744
06055;2023;1;0;1;0;100;135000;2077;65
06056;2023;3;2;1;66.6666666666667;33.3333333333333;183760;2151.33333333333;69.6666666666667
06057;2023;18;1;17;5.55555555555556;94.4444444444444;161972.222222222;2536.16666666667;66
06058;2023;9;7;2;77.7777777777778;22.2222222222222;231394.888888889;3369.22222222222;73.6666666666667
06059;2023;56;24;32;42.8571428571429;57.1428571428571;939160.75;9693.91071428571;95.2678571428571
06060;2023;12;11;1;91.6666666666667;8.33333333333333;805177.583333333;7241.66666666667;126.5
06061;2023;2;2;0;100;0;62750;1308;59
06062;2023;5;1;4;20;80;37000;857.8;43
06063;2023;2;2;0;100;0;87500;2227.5;37
06064;2023;31;28;3;90.3225806451613;9.67741935483871;434957.419354839;4778.29032258064;88.258064516129
06065;2023;49;40;9;81.6326530612245;18.3673469387755;493661;5151.73469387755;99.6938775510204
06066;2023;18;10;8;55.5555555555556;44.4444444444444;204100;3413.38888888889;60.5555555555556
06067;2023;14;9;5;64.2857142857143;35.7142857142857;278503.857142857;4850.07142857143;59.2857142857143
06068;2023;5;4;1;80;20;178400;3685.6;48.8
06069;2023;799;184;615;23.0287859824781;76.9712140175219;252406.209011264;3409.42302878598;69.6357947434293
06070;2023;43;8;35;18.6046511627907;81.3953488372093;85282.5581395349;1869.62790697674;45.8837209302326
06071;2023;26;6;20;23.0769230769231;76.9230769230769;165437.5;3689.03846153846;49.5
06072;2023;3;3;0;100;0;68666.6666666667;1128;64.6666666666667
06073;2023;110;3;107;2.72727272727273;97.2727272727273;156885.7;4632.26363636364;34.1727272727273
06074;2023;26;16;10;61.5384615384615;38.4615384615385;155413.038461538;2616.42307692308;67.4230769230769
06075;2023;54;40;14;74.0740740740741;25.9259259259259;362605.814814815;4252;87.3518518518518
06077;2023;15;6;9;40;60;134976.666666667;2346.53333333333;57.6666666666667
06078;2023;5;3;2;60;40;169746.4;3191.4;52.2
06079;2023;863;103;760;11.9351100811124;88.0648899188876;326325.39165701;5191.78331402086;59.6048667439166
06080;2023;1;1;0;100;0;95000;2639;36
06081;2023;9;7;2;77.7777777777778;22.2222222222222;140311.111111111;2151.44444444444;65
06082;2023;4;3;1;75;25;93750;1701.25;46.75
06083;2023;951;39;912;4.10094637223975;95.8990536277603;272286.941114616;5040.97896950578;53.9421661409043
06084;2023;113;68;45;60.1769911504425;39.8230088495575;685025.849557522;5599.40707964602;108.87610619469
06085;2023;322;159;163;49.3788819875776;50.6211180124224;755925.97515528;6349.12422360248;103.934782608696
06086;2023;11;6;5;54.5454545454545;45.4545454545455;152781.818181818;2745.36363636364;60.6363636363636
06088;2023;7455;225;7230;3.01810865191147;96.9818913480885;288199.822669349;5014.19114688129;56.7765258215962
06089;2023;21;18;3;85.7142857142857;14.2857142857143;1008671.42857143;7662.61904761905;133.857142857143
06090;2023;101;48;53;47.5247524752475;52.4752475247525;354715.96039604;4719.27722772277;76.2871287128713
06091;2023;24;12;12;50;50;277762.5;4273.70833333333;64.7083333333333
06092;2023;12;8;4;66.6666666666667;33.3333333333333;232685.583333333;3397.5;63.3333333333333
06093;2023;3;2;1;66.6666666666667;33.3333333333333;305253.333333333;2242.33333333333;120.666666666667
06094;2023;48;9;39;18.75;81.25;229588.833333333;4519.10416666667;51.0416666666667
06095;2023;159;90;69;56.6037735849057;43.3962264150943;354069.710691824;3974.68553459119;83.5408805031446
06096;2023;2;2;0;100;0;275000;2443;106.5
06097;2023;2;2;0;100;0;477800;5546.5;92
06099;2023;22;5;17;22.7272727272727;77.2727272727273;154045.454545455;1885.22727272727;71.5
06100;2023;2;2;0;100;0;225000;3027;74
06101;2023;3;2;1;66.6666666666667;33.3333333333333;103244;1877.66666666667;56.6666666666667
06102;2023;1;1;0;100;0;220000;1719;128
06103;2023;20;12;8;60;40;198334;2788.15;80.2
06104;2023;471;45;426;9.55414012738854;90.4458598726115;392506.751592357;6475.77707006369;55.9617834394904
06105;2023;85;76;9;89.4117647058824;10.5882352941176;948821.741176471;6299.25882352941;147.835294117647
06106;2023;10;9;1;90;10;280646.5;2786.3;89
06107;2023;3;3;0;100;0;266666.666666667;2479.66666666667;101.333333333333
06108;2023;47;26;21;55.3191489361702;44.6808510638298;429101.553191489;4713.6170212766;91.8297872340426
06109;2023;13;9;4;69.2307692307692;30.7692307692308;310903.923076923;4207.76923076923;72.7692307692308
06110;2023;10;6;4;60;40;180051.5;2665.3;62.7
06111;2023;6;5;1;83.3333333333333;16.6666666666667;43750;1165.33333333333;39.1666666666667
06112;2023;48;36;12;75;25;633374.5;5565.85416666667;117.041666666667
06113;2023;19;9;10;47.3684210526316;52.6315789473684;302294.736842105;5425.26315789474;57.2631578947368
06114;2023;61;16;45;26.2295081967213;73.7704918032787;265209.672131148;4249.4262295082;61.0983606557377
06115;2023;1;1;0;100;0;43000;1536;28
06116;2023;7;5;2;71.4285714285714;28.5714285714286;119042.857142857;2041;71.1428571428571
06117;2023;9;7;2;77.7777777777778;22.2222222222222;381683.333333333;4554.33333333333;90.3333333333333
06118;2023;66;55;11;83.3333333333333;16.6666666666667;425304.287878788;4359.78787878788;94.9393939393939
06119;2023;1;0;1;0;100;110000;1048;105
06120;2023;117;9;108;7.69230769230769;92.3076923076923;276102.384615385;5714.41025641026;41.2478632478633
06121;2023;30;2;28;6.66666666666667;93.3333333333333;967133.333333333;11773.4333333333;78.2666666666667
06122;2023;38;29;9;76.3157894736842;23.6842105263158;410378.394736842;4268.5;97.5
06123;2023;564;60;504;10.6382978723404;89.3617021276596;303709.930851064;4770.34042553191;63.6524822695035
06124;2023;2;2;0;100;0;114500;1424;76.5
06125;2023;4;3;1;75;25;150302.5;2315.75;70.5
06126;2023;33;14;19;42.4242424242424;57.5757575757576;305597.727272727;4432.51515151515;68.5757575757576
06127;2023;73;30;43;41.0958904109589;58.9041095890411;171740.273972603;2815.06849315068;62.9315068493151
06128;2023;47;35;12;74.468085106383;25.531914893617;999482.106382979;7279.1914893617;137.021276595745
06129;2023;8;0;8;0;100;41790;1043.25;39.625
06130;2023;60;50;10;83.3333333333333;16.6666666666667;320309.833333333;4051.91666666667;82.2833333333333
06131;2023;1;1;0;100;0;144000;1756;82
06132;2023;11;3;8;27.2727272727273;72.7272727272727;59977.2727272727;1614.54545454545;42.1818181818182
06133;2023;2;2;0;100;0;70000;937;73.5
06134;2023;24;16;8;66.6666666666667;33.3333333333333;171106.25;2394.125;71.7916666666667
06135;2023;8;6;2;75;25;133990;1807.75;80.25
06136;2023;78;37;41;47.4358974358974;52.5641025641026;195270.512820513;3355.64102564103;62.3589743589744
06137;2023;23;21;2;91.304347826087;8.69565217391304;596512.652173913;4569.21739130435;126.565217391304
06138;2023;123;18;105;14.6341463414634;85.3658536585366;561909.886178862;7721.77235772358;66.1138211382114
06139;2023;1;1;0;100;0;120500;2410;50
06140;2023;42;41;1;97.6190476190476;2.38095238095238;589928.238095238;5016.57142857143;119.761904761905
06141;2023;8;4;4;50;50;93563;1959;47
06142;2023;5;0;5;0;100;94310;2894.4;34.8
06143;2023;12;9;3;75;25;164916.666666667;2179.75;74.1666666666667
06144;2023;7;5;2;71.4285714285714;28.5714285714286;113718.571428571;1616.71428571429;74.4285714285714
06145;2023;3;1;2;33.3333333333333;66.6666666666667;178300;3075.33333333333;60.6666666666667
06146;2023;1;1;0;100;0;570000;8261;69
06147;2023;35;25;10;71.4285714285714;28.5714285714286;334652;4708.28571428571;73.8571428571429
06148;2023;68;54;14;79.4117647058823;20.5882352941176;661879.632352941;5100.26470588235;125.352941176471
06149;2023;94;23;71;24.468085106383;75.531914893617;240296.382978723;3429.62765957447;72.1382978723404
06150;2023;52;24;28;46.1538461538462;53.8461538461538;488499.038461538;5758.63461538462;82.1538461538462
06151;2023;14;9;5;64.2857142857143;35.7142857142857;155710.714285714;2235.42857142857;65.5714285714286
06152;2023;162;64;98;39.5061728395062;60.4938271604938;440356.555555556;5287.0987654321;78.5246913580247
06153;2023;41;17;24;41.4634146341463;58.5365853658537;168458.536585366;2589.0487804878;62.219512195122
06154;2023;14;11;3;78.5714285714286;21.4285714285714;221514.285714286;2714;76.1428571428571
06155;2023;690;99;591;14.3478260869565;85.6521739130435;299373.723188406;4838.55362318841;56.6695652173913
06156;2023;2;1;1;50;50;132500;2320;57
06157;2023;352;111;241;31.5340909090909;68.4659090909091;392825.991477273;4628.65056818182;77.9119318181818
06158;2023;14;8;6;57.1428571428571;42.8571428571429;165511.071428571;2809.85714285714;57.5
06159;2023;157;25;132;15.9235668789809;84.0764331210191;714308.267515924;8659.16560509554;75.7197452229299
06160;2023;1;1;0;100;0;62000;564;110
06161;2023;423;70;353;16.548463356974;83.451536643026;368321.04964539;6157.08510638298;58.565011820331
06162;2023;21;11;10;52.3809523809524;47.6190476190476;77987.7619047619;1286.38095238095;60.2857142857143
06163;2023;58;20;38;34.4827586206897;65.5172413793103;87998.2413793103;1491.1724137931;59.3965517241379
07001;2023;5;5;0;100;0;244740;2627.8;85
07002;2023;3;3;0;100;0;278333.333333333;2208.66666666667;136
07005;2023;11;10;1;90.9090909090909;9.09090909090909;232527.272727273;2183.27272727273;111.909090909091
07006;2023;2;2;0;100;0;90500;1320.5;64
07007;2023;18;18;0;100;0;195562.777777778;2135.83333333333;105.444444444444
07008;2023;4;4;0;100;0;262875;2567.25;109.5
07009;2023;10;10;0;100;0;132560;1537.9;82.5
07010;2023;212;71;141;33.4905660377358;66.5094339622642;127353.235849057;1489.27358490566;82.372641509434
07011;2023;7;5;2;71.4285714285714;28.5714285714286;166179.285714286;2135.42857142857;71.1428571428571
07012;2023;6;6;0;100;0;105500;1550.33333333333;74.8333333333333
07013;2023;12;12;0;100;0;195964.666666667;2143.75;103.166666666667
07014;2023;4;4;0;100;0;267450;2132.5;125.5
07015;2023;6;6;0;100;0;198333.333333333;2164.66666666667;94.6666666666667
07017;2023;10;10;0;100;0;303383;2957.4;98
07019;2023;171;50;121;29.2397660818713;70.7602339181287;134050.85380117;1854.94152046784;73.812865497076
07020;2023;4;4;0;100;0;181240;2703.75;65.5
07022;2023;15;15;0;100;0;207048.266666667;2059.2;101.466666666667
07023;2023;1;1;0;100;0;170000;2073;82
07024;2023;5;5;0;100;0;300986;3161.8;97
07025;2023;3;3;0;100;0;78500;1533.66666666667;53
07026;2023;9;9;0;100;0;153092.333333333;3306.66666666667;63.2222222222222
07027;2023;19;17;2;89.4736842105263;10.5263157894737;166281.052631579;2030.68421052632;87.8947368421053
07028;2023;6;6;0;100;0;181603.333333333;1942.66666666667;104.333333333333
07029;2023;2;2;0;100;0;259000;4026;61.5
07030;2023;2;2;0;100;0;285145;3900;97.5
07031;2023;10;10;0;100;0;186630;2303.7;84
07032;2023;4;4;0;100;0;163250;1677.5;93.5
07033;2023;3;3;0;100;0;613579;4224.33333333333;146.666666666667
07034;2023;5;5;0;100;0;283000;2318;121
07035;2023;7;7;0;100;0;141628.571428571;1355.42857142857;100.857142857143
07036;2023;4;4;0;100;0;244325;2421.25;96.25
07037;2023;3;3;0;100;0;63750;1662.66666666667;46
07039;2023;3;3;0;100;0;67000;956.333333333333;70
07040;2023;1;1;0;100;0;84000;1377;61
07041;2023;16;14;2;87.5;12.5;160875;2012.6875;81.1875
07042;2023;84;46;38;54.7619047619048;45.2380952380952;142440.892857143;1558.35714285714;90.1309523809524
07044;2023;7;7;0;100;0;254081.857142857;2667.85714285714;102.285714285714
07045;2023;12;9;3;75;25;129170.166666667;1932.75;73.5
07048;2023;7;6;1;85.7142857142857;14.2857142857143;68271.4285714286;1787.85714285714;49
07049;2023;2;2;0;100;0;167700;2527;64
07050;2023;11;10;1;90.9090909090909;9.09090909090909;258915.454545455;2933.18181818182;92.2727272727273
07051;2023;10;8;2;80;20;182975.1;2551.2;72.1
07052;2023;7;7;0;100;0;181221.428571429;1533.42857142857;104
07053;2023;6;6;0;100;0;249867;2545;102.333333333333
07054;2023;6;4;2;66.6666666666667;33.3333333333333;131686.666666667;2268.16666666667;59.6666666666667
07055;2023;28;27;1;96.4285714285714;3.57142857142857;320332.285714286;2949;108
07056;2023;5;5;0;100;0;248860;2496;103.4
07058;2023;14;14;0;100;0;212802.857142857;2423.71428571429;92.0714285714286
07059;2023;3;3;0;100;0;227216.666666667;2561.66666666667;86
07060;2023;5;5;0;100;0;246508;2847.2;103
07061;2023;11;11;0;100;0;200459.090909091;2989.54545454545;71.3636363636364
07062;2023;3;3;0;100;0;198050;5040.33333333333;64.6666666666667
07063;2023;2;2;0;100;0;168500;2927;71
07064;2023;35;25;10;71.4285714285714;28.5714285714286;122827.028571429;1390.51428571429;87.2857142857143
07065;2023;8;8;0;100;0;226802;2495.625;97.375
07066;2023;34;32;2;94.1176470588235;5.88235294117647;277295.735294118;2580.05882352941;105.088235294118
07067;2023;3;3;0;100;0;361516.666666667;3062.66666666667;116.333333333333
07068;2023;5;5;0;100;0;199920;2487.6;93.6
07069;2023;7;7;0;100;0;147871.428571429;1727.85714285714;91.5714285714286
07070;2023;24;22;2;91.6666666666667;8.33333333333333;218876.125;2440.20833333333;92.2916666666667
07071;2023;11;10;1;90.9090909090909;9.09090909090909;126934.545454545;1491.18181818182;89.6363636363636
07072;2023;10;10;0;100;0;212742;2376;88.3
07073;2023;10;10;0;100;0;121014.5;1627.3;68.2
07075;2023;1;1;0;100;0;455000;4789;95
07076;2023;33;29;4;87.8787878787879;12.1212121212121;189699.484848485;2040.21212121212;98
07077;2023;3;3;0;100;0;267620;3364.33333333333;80.6666666666667
07078;2023;23;14;9;60.8695652173913;39.1304347826087;175284.608695652;1913.82608695652;93.4782608695652
07079;2023;14;14;0;100;0;167753.214285714;2078.71428571429;91.7857142857143
07080;2023;4;4;0;100;0;114913.5;2350;86.75
07081;2023;4;4;0;100;0;226345;2632.25;119
07082;2023;3;3;0;100;0;59500;946;62
07083;2023;6;6;0;100;0;234233.333333333;2361.83333333333;88.8333333333333
07084;2023;16;16;0;100;0;188057.375;2101.125;91.125
07085;2023;5;5;0;100;0;218730.4;2313.8;88
07086;2023;7;7;0;100;0;243785.714285714;2060.14285714286;129.857142857143
07087;2023;5;5;0;100;0;151400;1875.2;77
07089;2023;7;7;0;100;0;233571.428571429;2406;96.5714285714286
07090;2023;17;14;3;82.3529411764706;17.6470588235294;150103.058823529;2025.52941176471;73.7647058823529
07093;2023;4;4;0;100;0;124250;1736.5;75
07095;2023;7;7;0;100;0;180055.571428571;1953.28571428571;97.4285714285714
07096;2023;9;9;0;100;0;214912.222222222;2295.66666666667;96.7777777777778
07097;2023;6;6;0;100;0;289980;2800;112.5
07098;2023;2;2;0;100;0;157050;2472.5;64
07099;2023;6;4;2;66.6666666666667;33.3333333333333;251055.166666667;2326.66666666667;112.833333333333
07100;2023;3;3;0;100;0;301833.333333333;3370;92
07101;2023;8;8;0;100;0;237500;2217;113
07102;2023;152;38;114;25;75;197117.940789474;2514.11184210526;77.2697368421053
07103;2023;7;6;1;85.7142857142857;14.2857142857143;115714.285714286;1222.71428571429;93
07104;2023;3;2;1;66.6666666666667;33.3333333333333;182290;2873.33333333333;62.3333333333333
07105;2023;3;3;0;100;0;484000;4465.66666666667;66.3333333333333
07106;2023;3;2;1;66.6666666666667;33.3333333333333;192366.666666667;1517.33333333333;131.666666666667
07107;2023;18;15;3;83.3333333333333;16.6666666666667;188874.333333333;2315.22222222222;86.7777777777778
07108;2023;4;4;0;100;0;96250;1509.75;62.5
07109;2023;4;4;0;100;0;140000;1551.5;88.25
07110;2023;32;21;11;65.625;34.375;181371.78125;2111.40625;89.28125
07111;2023;2;2;0;100;0;217900;2133.5;108.5
07112;2023;5;5;0;100;0;86900;1499.2;59.8
07113;2023;11;11;0;100;0;274664.090909091;2337;112.636363636364
07114;2023;2;2;0;100;0;155250;948;174
07115;2023;10;10;0;100;0;233185;2952.5;78.2
07116;2023;13;7;6;53.8461538461538;46.1538461538462;128443.076923077;1424.38461538462;93.3846153846154
07117;2023;18;17;1;94.4444444444444;5.55555555555556;254040;2800.5;91.6666666666667
07118;2023;5;5;0;100;0;169865;2586.6;63.8
07119;2023;4;4;0;100;0;114625;2487;51.25
07120;2023;3;3;0;100;0;114766.666666667;2386.66666666667;59
07121;2023;8;8;0;100;0;143585;1878.75;79.875
07122;2023;14;14;0;100;0;236086.071428571;2104.57142857143;109.857142857143
07123;2023;5;5;0;100;0;114600;1399;94.2
07126;2023;18;18;0;100;0;266896.666666667;2916.61111111111;93.1666666666667
07127;2023;13;10;3;76.9230769230769;23.0769230769231;154373.076923077;2023.61538461538;78.3846153846154
07128;2023;5;2;3;40;60;77382;1556.8;57.6
07129;2023;29;22;7;75.8620689655172;24.1379310344828;111861.206896552;1486.72413793103;78.2758620689655
07130;2023;6;6;0;100;0;76116.6666666667;1135.83333333333;73.5
07131;2023;5;4;1;80;20;168400;2994.2;61.2
07132;2023;14;11;3;78.5714285714286;21.4285714285714;167702.142857143;1802.07142857143;93.3571428571429
07133;2023;6;6;0;100;0;142925;2109.83333333333;68
07134;2023;12;12;0;100;0;224962.5;2129;104.833333333333
07136;2023;2;2;0;100;0;105750;930.5;114.5
07138;2023;24;23;1;95.8333333333333;4.16666666666667;203177.083333333;2216.5;90.5
07139;2023;5;5;0;100;0;133393;1746.8;77.6
07140;2023;7;7;0;100;0;305664.285714286;2278.42857142857;129
07141;2023;1;1;0;100;0;62000;838;74
07142;2023;2;1;1;50;50;125000;1562.5;80
07143;2023;17;17;0;100;0;186608.823529412;2239.76470588235;88.5294117647059
07144;2023;2;2;0;100;0;151800;1376;124
07145;2023;7;7;0;100;0;259025;2314.85714285714;114.428571428571
07146;2023;8;7;1;87.5;12.5;136750;1623.5;81.5
07147;2023;7;7;0;100;0;120012.142857143;2032.28571428571;72.7142857142857
07148;2023;6;6;0;100;0;145995;2228.33333333333;81.5
07149;2023;6;6;0;100;0;84916.6666666667;1372.66666666667;70.5
07150;2023;6;6;0;100;0;118710;1240.5;95.5
07151;2023;5;5;0;100;0;135640;1963.4;69.6
07152;2023;11;9;2;81.8181818181818;18.1818181818182;247517.363636364;2535.18181818182;102
07153;2023;7;6;1;85.7142857142857;14.2857142857143;170285.714285714;2009.28571428571;83.1428571428571
07154;2023;3;3;0;100;0;123400;2163.33333333333;62
07155;2023;12;12;0;100;0;323413.75;3057.91666666667;115
07156;2023;13;11;2;84.6153846153846;15.3846153846154;129270.307692308;1763;72.1538461538462
07157;2023;9;9;0;100;0;169324.444444444;1756.66666666667;93.3333333333333
07158;2023;5;5;0;100;0;129080;1651.2;76.4
07159;2023;4;4;0;100;0;268375;2236.25;120
07160;2023;1;1;0;100;0;185800;2654;70
07161;2023;15;12;3;80;20;125598.333333333;1804;76.0666666666667
07162;2023;9;9;0;100;0;201307.666666667;2384.22222222222;79.7777777777778
07165;2023;15;15;0;100;0;140726.666666667;2816.33333333333;55.9333333333333
07166;2023;5;5;0;100;0;101600;2398.6;63
07167;2023;15;13;2;86.6666666666667;13.3333333333333;251444;2366.46666666667;105.666666666667
07168;2023;9;9;0;100;0;261982.222222222;2587.77777777778;100.666666666667
07169;2023;4;4;0;100;0;301000;1980.5;150.75
07170;2023;2;2;0;100;0;114500;2077.5;74
07171;2023;7;7;0;100;0;218571.428571429;2754.57142857143;88.2857142857143
07172;2023;12;11;1;91.6666666666667;8.33333333333333;271256.583333333;2624.41666666667;99
07173;2023;4;4;0;100;0;87495;1381.75;71.25
07174;2023;5;5;0;100;0;230450;2474.8;91.6
07175;2023;1;1;0;100;0;108410;1971;55
07176;2023;2;2;0;100;0;205000;2266.5;92
07177;2023;8;8;0;100;0;139118.75;2002.625;72.625
07178;2023;4;3;1;75;25;99187.5;1368;73.5
07179;2023;1;1;0;100;0;215260;1888;114
07181;2023;38;25;13;65.7894736842105;34.2105263157895;196704.447368421;2251.65789473684;89.0789473684211
07182;2023;5;5;0;100;0;230120;2815;82.8
07183;2023;5;4;1;80;20;251344;2421.6;104.2
07184;2023;6;6;0;100;0;221581.666666667;2189;97.6666666666667
07185;2023;7;7;0;100;0;176452.857142857;1789.71428571429;95.5714285714286
07186;2023;94;38;56;40.4255319148936;59.5744680851064;131160.531914894;1824.24468085106;73.7553191489362
07187;2023;1;1;0;100;0;176000;1853;95
07188;2023;12;12;0;100;0;193779.166666667;2091.58333333333;93.1666666666667
07189;2023;1;1;0;100;0;252000;2598;97
07190;2023;5;5;0;100;0;170092;1591.4;101.6
07191;2023;17;14;3;82.3529411764706;17.6470588235294;181094.823529412;2060.88235294118;93
07192;2023;3;3;0;100;0;171143.333333333;2066.33333333333;80
07193;2023;1;1;0;100;0;185500;3312;56
07194;2023;6;5;1;83.3333333333333;16.6666666666667;169436.666666667;1776.83333333333;83.3333333333333
07195;2023;1;1;0;100;0;497250;4562;109
07196;2023;6;6;0;100;0;303078.333333333;2175.16666666667;147.666666666667
07197;2023;20;20;0;100;0;230925;2182.35;103.3
07198;2023;10;10;0;100;0;237050;2579.8;85.7
07199;2023;8;8;0;100;0;270766.25;2653.375;103.25
07201;2023;42;32;10;76.1904761904762;23.8095238095238;195918.976190476;2419.95238095238;79.9523809523809
07202;2023;3;3;0;100;0;246666.666666667;2801.66666666667;83.3333333333333
07203;2023;5;5;0;100;0;181964.2;2450;75.8
07204;2023;25;23;2;92;8;138852.84;1383.04;95.76
07205;2023;9;8;1;88.8888888888889;11.1111111111111;201168.888888889;2264.11111111111;89.1111111111111
07206;2023;2;2;0;100;0;34500;493.5;71.5
07207;2023;11;11;0;100;0;254386.363636364;2517.54545454545;101.454545454545
07208;2023;3;3;0;100;0;277333.333333333;2513.66666666667;112.666666666667
07210;2023;9;8;1;88.8888888888889;11.1111111111111;122677.777777778;1778.88888888889;67.2222222222222
07211;2023;7;7;0;100;0;225270;2293.71428571429;107.857142857143
07212;2023;6;6;0;100;0;171650;2008.33333333333;93.8333333333333
07213;2023;1;1;0;100;0;90000;1731;52
07214;2023;2;2;0;100;0;70250;1914;39
07215;2023;5;5;0;100;0;157921;2053.6;83.8
07216;2023;8;7;1;87.5;12.5;139436.75;1651.125;84.625
07217;2023;7;7;0;100;0;192468.142857143;2427.71428571429;78.8571428571429
07218;2023;4;4;0;100;0;100680;1636.25;59.25
07219;2023;2;2;0;100;0;313500;1470;187
07220;2023;2;2;0;100;0;56000;541.5;103.5
07221;2023;6;6;0;100;0;139806.666666667;2477.83333333333;55.8333333333333
07222;2023;2;2;0;100;0;122125;956;117
07223;2023;1;1;0;100;0;225000;1875;120
07224;2023;4;4;0;100;0;79075;1020.75;88
07225;2023;8;8;0;100;0;318902.5;2599.5;134.625
07226;2023;2;2;0;100;0;90460;1588;65.5
07227;2023;13;13;0;100;0;222217.692307692;2258.61538461538;99.9230769230769
07228;2023;6;5;1;83.3333333333333;16.6666666666667;141454.166666667;1687.33333333333;82.3333333333333
07229;2023;7;7;0;100;0;179682.571428571;1751.14285714286;101.714285714286
07230;2023;5;5;0;100;0;207600;3252;63.4
07231;2023;28;27;1;96.4285714285714;3.57142857142857;208369.464285714;2229.60714285714;95.7857142857143
07232;2023;3;3;0;100;0;136266.666666667;1607.33333333333;86.6666666666667
07233;2023;7;6;1;85.7142857142857;14.2857142857143;297014.285714286;2466.14285714286;106.714285714286
07234;2023;1;1;0;100;0;183200;1398;131
07235;2023;5;4;1;80;20;133522;1984.8;81.8
07236;2023;17;15;2;88.2352941176471;11.7647058823529;111354.294117647;1557.17647058824;72.8823529411765
07237;2023;7;6;1;85.7142857142857;14.2857142857143;204040;1627.85714285714;111.571428571429
07238;2023;3;3;0;100;0;260376.666666667;3067;83
07239;2023;3;3;0;100;0;125500;1410.66666666667;87.3333333333333
07240;2023;16;15;1;93.75;6.25;285560.625;2702.6875;108.1875
07241;2023;6;6;0;100;0;228491.666666667;2264.33333333333;98.3333333333333
07242;2023;2;2;0;100;0;146500;1722;85
07243;2023;2;2;0;100;0;188586.5;2187.5;83.5
07245;2023;24;19;5;79.1666666666667;20.8333333333333;191042.25;2141.20833333333;89.7083333333333
07247;2023;7;6;1;85.7142857142857;14.2857142857143;172664.285714286;2081.57142857143;81.4285714285714
07248;2023;4;4;0;100;0;260752.5;1635;158.5
07249;2023;3;3;0;100;0;103031.666666667;1763;65
07250;2023;4;4;0;100;0;170000;2129.5;71.25
07251;2023;5;5;0;100;0;212595;2529;82
07253;2023;4;4;0;100;0;141250;1816.5;78
07254;2023;7;7;0;100;0;223814.285714286;2927.42857142857;90
07255;2023;14;13;1;92.8571428571429;7.14285714285714;180426.785714286;2094.57142857143;83.7142857142857
07258;2023;8;8;0;100;0;163056.25;1502.875;115.5
07259;2023;17;17;0;100;0;222491.764705882;2127.17647058824;105.647058823529
07260;2023;7;6;1;85.7142857142857;14.2857142857143;228185.714285714;2444.14285714286;95
07261;2023;20;18;2;90;10;198742;2152.9;101.85
07262;2023;1;1;0;100;0;269400;2836;95
07263;2023;1;1;0;100;0;125000;2315;54
07264;2023;25;25;0;100;0;248812.48;2494.28;100.64
07265;2023;6;6;0;100;0;207891.666666667;2406.83333333333;84.1666666666667
07266;2023;4;4;0;100;0;86750;1419.5;60.5
07267;2023;9;8;1;88.8888888888889;11.1111111111111;102540.222222222;1388.77777777778;72.8888888888889
07268;2023;21;20;1;95.2380952380952;4.76190476190476;216043.904761905;2471.66666666667;93.1428571428571
07269;2023;13;12;1;92.3076923076923;7.69230769230769;93273.0769230769;1484.92307692308;61.4615384615385
07270;2023;5;5;0;100;0;189113.4;1600.2;101.4
07272;2023;2;2;0;100;0;277500;3409.5;103
07273;2023;3;2;1;66.6666666666667;33.3333333333333;218333.333333333;2659.66666666667;84
07274;2023;6;6;0;100;0;128816.666666667;1433.16666666667;88.3333333333333
07275;2023;2;2;0;100;0;228050;2299;97.5
07278;2023;12;12;0;100;0;193985;2504.16666666667;87
07279;2023;14;13;1;92.8571428571429;7.14285714285714;217510.928571429;2189.85714285714;98.7857142857143
07280;2023;17;17;0;100;0;218019.411764706;2567;90.0588235294118
07281;2023;82;66;16;80.4878048780488;19.5121951219512;350521.62195122;3127.78048780488;111.219512195122
07282;2023;2;1;1;50;50;104950;1733;65.5
07284;2023;2;2;0;100;0;497525;4604;127.5
07285;2023;1;1;0;100;0;170000;2125;80
07286;2023;6;5;1;83.3333333333333;16.6666666666667;51333.3333333333;825.166666666667;61.8333333333333
07288;2023;5;5;0;100;0;270231;2707.2;102.2
07289;2023;9;8;1;88.8888888888889;11.1111111111111;222716.666666667;2545;93.6666666666667
07290;2023;3;3;0;100;0;167971.666666667;2324.66666666667;75.6666666666667
07291;2023;9;9;0;100;0;218622.222222222;2926.11111111111;82.3333333333333
07292;2023;11;11;0;100;0;198940.909090909;2079;96.2727272727273
07293;2023;11;11;0;100;0;273330;2485.90909090909;113.636363636364
07294;2023;13;12;1;92.3076923076923;7.69230769230769;331344.230769231;3372.38461538462;95
07295;2023;12;11;1;91.6666666666667;8.33333333333333;190404.166666667;1923.75;104.583333333333
07296;2023;11;10;1;90.9090909090909;9.09090909090909;230078.909090909;2220.09090909091;101.090909090909
07297;2023;3;3;0;100;0;131633.333333333;1513;86.6666666666667
07298;2023;12;12;0;100;0;266787.5;2414.33333333333;114.25
07299;2023;1;1;0;100;0;391920;7395;53
07300;2023;3;3;0;100;0;303500;2589;97.3333333333333
07301;2023;10;10;0;100;0;204849;2041.7;96.2
07302;2023;3;2;1;66.6666666666667;33.3333333333333;428218.333333333;3185;113.666666666667
07303;2023;6;6;0;100;0;157728.333333333;2012;88.5
07304;2023;23;11;12;47.8260869565217;52.1739130434783;145656.913043478;2438.52173913043;59.6521739130435
07305;2023;7;6;1;85.7142857142857;14.2857142857143;316321.428571429;2882.57142857143;115.857142857143
07306;2023;3;3;0;100;0;265323.333333333;3156.33333333333;83.6666666666667
07307;2023;1;1;0;100;0;189000;3566;53
07308;2023;24;18;6;75;25;153592.083333333;1750.95833333333;87.7083333333333
07309;2023;23;21;2;91.304347826087;8.69565217391304;173071.130434783;1854.82608695652;90.695652173913
07310;2023;5;5;0;100;0;229616;2386.8;96.2
07312;2023;5;5;0;100;0;227420;2665;84.6
07313;2023;11;10;1;90.9090909090909;9.09090909090909;125368.181818182;1690.54545454545;80.7272727272727
07314;2023;7;7;0;100;0;195927.142857143;2247;91.7142857142857
07315;2023;7;7;0;100;0;109600;1676.85714285714;66.8571428571429
07316;2023;15;14;1;93.3333333333333;6.66666666666667;295624.533333333;2610.66666666667;111
07317;2023;4;4;0;100;0;255450;2178.75;118.25
07318;2023;4;4;0;100;0;245900;2866.5;83.25
07319;2023;117;70;47;59.8290598290598;40.1709401709402;134750;1645.84615384615;82.2991452991453
07321;2023;3;3;0;100;0;226733.333333333;2366;95.3333333333333
07322;2023;17;13;4;76.4705882352941;23.5294117647059;89294.7058823529;1410.94117647059;62.2352941176471
07323;2023;18;9;9;50;50;217004.222222222;2540.72222222222;89.5
07324;2023;160;47;113;29.375;70.625;161345.1125;2149.21875;72.65
07325;2023;20;13;7;65;35;217507.5;2210;101.1
07327;2023;6;5;1;83.3333333333333;16.6666666666667;262083.333333333;2203.16666666667;104.666666666667
07328;2023;5;5;0;100;0;174400;2590;79.8
07329;2023;11;11;0;100;0;181691.818181818;2358.45454545455;81.1818181818182
07330;2023;39;38;1;97.4358974358974;2.56410256410256;235526.282051282;2864.33333333333;86.8205128205128
07331;2023;59;18;41;30.5084745762712;69.4915254237288;133146.322033898;1848.59322033898;75.2203389830509
07332;2023;4;4;0;100;0;256750;2260.75;113.75
07333;2023;9;9;0;100;0;167781.333333333;1783.33333333333;89.8888888888889
07334;2023;38;29;9;76.3157894736842;23.6842105263158;271859.736842105;2914.02631578947;84.7894736842105
07335;2023;3;3;0;100;0;87221.6666666667;1574.33333333333;67.6666666666667
07336;2023;1;1;0;100;0;799070;8879;90
07337;2023;32;32;0;100;0;227227.71875;2369.25;96.375
07338;2023;15;13;2;86.6666666666667;13.3333333333333;191450.533333333;2087.73333333333;98.2
07339;2023;21;20;1;95.2380952380952;4.76190476190476;187144.285714286;2011.47619047619;93.0476190476191
07340;2023;16;16;0;100;0;239469.375;2352.3125;104.1875
07341;2023;26;25;1;96.1538461538462;3.84615384615385;156900;2075.23076923077;78.7307692307692
07342;2023;10;10;0;100;0;143594.8;1800.2;75.7
07343;2023;11;11;0;100;0;237801.818181818;2423.54545454545;99.4545454545455
07344;2023;6;6;0;100;0;275833.333333333;1764.16666666667;145.833333333333
07345;2023;4;4;0;100;0;199000;2244.5;93
07346;2023;24;17;7;70.8333333333333;29.1666666666667;181288.541666667;2009.54166666667;92
07347;2023;6;6;0;100;0;228150;2381.33333333333;94.5
07348;2023;10;6;4;60;40;187254.2;3615.4;63.3
07349;2023;55;38;17;69.0909090909091;30.9090909090909;158612.709090909;1849.18181818182;83.2181818181818
08001;2023;2;2;0;100;0;192725;1567;111
08003;2023;27;27;0;100;0;167962.962962963;1591.51851851852;107.740740740741
08004;2023;2;2;0;100;0;129950;1822.5;69.5
08006;2023;3;3;0;100;0;125000;1136.33333333333;116
08008;2023;9;9;0;100;0;105457.777777778;1097.22222222222;97.7777777777778
08010;2023;1;1;0;100;0;137100;1714;80
08011;2023;3;3;0;100;0;45000;758.666666666667;63.6666666666667
08013;2023;2;2;0;100;0;101000;1490.5;66.5
08016;2023;4;4;0;100;0;91650;784.75;123.5
08017;2023;1;1;0;100;0;210000;1567;134
08018;2023;3;3;0;100;0;120733.333333333;1332.66666666667;93
08019;2023;1;1;0;100;0;80000;702;114
08022;2023;3;3;0;100;0;199000;1562;123.666666666667
08024;2023;19;19;0;100;0;155378.947368421;1572.47368421053;100.315789473684
08025;2023;18;18;0;100;0;100050;985.388888888889;103.666666666667
08026;2023;2;2;0;100;0;195125;1790.5;108
08028;2023;15;15;0;100;0;138516.666666667;1332.2;105.533333333333
08031;2023;1;1;0;100;0;76000;950;80
08032;2023;2;2;0;100;0;230950;2017;117.5
08034;2023;5;5;0;100;0;110120;1369.6;94.4
08036;2023;2;2;0;100;0;62500;619.5;101.5
08037;2023;9;9;0;100;0;123701.666666667;1185;105.666666666667
08038;2023;1;1;0;100;0;2,00E+05;1220;164
08039;2023;3;3;0;100;0;95141.6666666667;1147.33333333333;86
08040;2023;9;9;0;100;0;194040.555555556;1869.11111111111;105.666666666667
08041;2023;1;1;0;100;0;87000;1088;80
08043;2023;19;14;5;73.6842105263158;26.3157894736842;131694.736842105;1312.52631578947;101.736842105263
08044;2023;4;4;0;100;0;125575;1221.25;100
08046;2023;2;2;0;100;0;112500;806.5;129
08047;2023;1;1;0;100;0;250000;801;312
08048;2023;1;1;0;100;0;4,00E+05;2667;150
08049;2023;1;1;0;100;0;60000;451;133
08052;2023;1;1;0;100;0;39000;488;80
08053;2023;22;21;1;95.4545454545455;4.54545454545455;139349.590909091;1458.95454545455;95.0909090909091
08055;2023;8;8;0;100;0;106062.5;1283.5;88.125
08057;2023;1;1;0;100;0;50000;694;72
08058;2023;4;4;0;100;0;175600;1617;109.5
08059;2023;1;1;0;100;0;120000;811;148
08060;2023;4;4;0;100;0;206175;2243.75;90.75
08062;2023;4;4;0;100;0;153750;1202.25;134.25
08064;2023;3;3;0;100;0;200350;2387.66666666667;86.3333333333333
08067;2023;18;16;2;88.8888888888889;11.1111111111111;104280.555555556;1090.44444444444;92.2222222222222
08069;2023;2;2;0;100;0;147500;2031;74
08070;2023;7;7;0;100;0;144657.142857143;1900.42857142857;76
08071;2023;2;2;0;100;0;65000;611.5;108
08073;2023;1;1;0;100;0;150000;1500;100
08075;2023;3;3;0;100;0;185333.333333333;1354.33333333333;133.333333333333
08076;2023;13;13;0;100;0;116619.769230769;1286.69230769231;95.6923076923077
08077;2023;1;1;0;100;0;126000;1400;90
08078;2023;15;15;0;100;0;110453.333333333;1256;89.8666666666667
08080;2023;1;1;0;100;0;48600;472;103
08081;2023;55;52;3;94.5454545454545;5.45454545454545;92970.3818181818;1037.94545454545;87.7090909090909
08082;2023;2;2;0;100;0;82500;862;95.5
08083;2023;6;6;0;100;0;145833.333333333;1353.5;116
08084;2023;4;4;0;100;0;204050;2442;112.5
08085;2023;5;5;0;100;0;107360;815.2;126.4
08086;2023;3;3;0;100;0;46666.6666666667;657.666666666667;74.6666666666667
08087;2023;3;3;0;100;0;263133.333333333;2919.66666666667;83.3333333333333
08089;2023;1;1;0;100;0;80000;1231;65
08090;2023;34;32;2;94.1176470588235;5.88235294117647;132175.294117647;1348.88235294118;101.941176470588
08092;2023;4;4;0;100;0;188625;1819.75;105.25
08095;2023;1;1;0;100;0;235000;1119;210
08096;2023;9;9;0;100;0;162561.111111111;1690.88888888889;98.1111111111111
08097;2023;2;2;0;100;0;109000;1292;85
08098;2023;3;3;0;100;0;91166.6666666667;825;106
08099;2023;4;4;0;100;0;157500;1403;120
08100;2023;3;3;0;100;0;106816.666666667;983.333333333333;106.666666666667
08101;2023;2;2;0;100;0;125000;1357.5;94
08103;2023;2;2;0;100;0;112500;1365.5;81.5
08105;2023;543;228;315;41.9889502762431;58.0110497237569;120247.071823204;1523.65009208103;78.7587476979742
08107;2023;7;7;0;100;0;125871.428571429;2156.28571428571;77
08109;2023;2;2;0;100;0;64500;1109.5;61
08110;2023;5;5;0;100;0;120195;1235.8;94.6
08111;2023;8;8;0;100;0;235118.75;2351.125;101.25
08115;2023;3;3;0;100;0;116333.333333333;987.333333333333;126.333333333333
08116;2023;10;10;0;100;0;151050;1219;127.3
08117;2023;2;2;0;100;0;95000;570.5;167
08119;2023;4;4;0;100;0;162325;1548;100
08120;2023;1;1;0;100;0;165000;917;180
08121;2023;2;2;0;100;0;115000;1174.5;96.5
08122;2023;15;15;0;100;0;160866.666666667;1546.6;106.8
08124;2023;2;2;0;100;0;122500;1767.5;69
08125;2023;3;3;0;100;0;232353.333333333;1924;125.333333333333
08126;2023;3;3;0;100;0;118800;1786;66
08130;2023;1;1;0;100;0;134000;1340;100
08131;2023;1;1;0;100;0;105000;1167;90
08132;2023;1;1;0;100;0;105000;1235;85
08133;2023;7;7;0;100;0;120037.428571429;1154.57142857143;98.5714285714286
08135;2023;2;2;0;100;0;64750;469.5;144
08136;2023;7;7;0;100;0;92157.1428571429;1266.85714285714;84.4285714285714
08137;2023;3;3;0;100;0;254000;1840.66666666667;141.333333333333
08138;2023;2;2;0;100;0;84000;850.5;100
08139;2023;9;8;1;88.8888888888889;11.1111111111111;70007.6666666667;1000.66666666667;71.1111111111111
08140;2023;13;11;2;84.6153846153846;15.3846153846154;114111.538461538;1243.46153846154;91.7692307692308
08141;2023;1;1;0;100;0;37000;578;64
08142;2023;13;10;3;76.9230769230769;23.0769230769231;106246.153846154;1248.92307692308;82.6153846153846
08144;2023;1;1;0;100;0;165000;1154;143
08145;2023;14;13;1;92.8571428571429;7.14285714285714;144964.285714286;1276.42857142857;112.214285714286
08147;2023;3;3;0;100;0;108333.333333333;1321.66666666667;84.6666666666667
08148;2023;1;1;0;100;0;209800;1720;122
08149;2023;4;4;0;100;0;135618.25;1057.25;125.5
08150;2023;4;4;0;100;0;121000;1262.75;99.75
08151;2023;2;2;0;100;0;71100;730.5;113
08153;2023;4;4;0;100;0;101475;1023.25;101
08156;2023;3;3;0;100;0;198491;1453.66666666667;135
08158;2023;2;2;0;100;0;203500;1945.5;105
08160;2023;1;1;0;100;0;316250;2027;156
08162;2023;3;3;0;100;0;283400;2572;109.333333333333
08164;2023;2;2;0;100;0;101300;1388.5;67.5
08165;2023;1;1;0;100;0;270000;1875;144
08166;2023;3;3;0;100;0;42666.6666666667;650.333333333333;65.6666666666667
08167;2023;2;2;0;100;0;87500;941.5;85.5
08168;2023;1;1;0;100;0;30000;469;64
08169;2023;1;1;0;100;0;1,00E+05;943;106
08170;2023;2;2;0;100;0;241500;1638.5;153
08171;2023;1;1;0;100;0;55000;696;79
08172;2023;1;1;0;100;0;2,00E+05;1439;139
08173;2023;16;16;0;100;0;135134.375;1616.8125;89.9375
08174;2023;24;24;0;100;0;171804.166666667;1423.79166666667;114.75
08175;2023;4;4;0;100;0;187000;1433.25;127.25
08179;2023;6;6;0;100;0;143897.5;940.666666666667;169.833333333333
08180;2023;19;17;2;89.4736842105263;10.5263157894737;140815.789473684;1764.84210526316;83.2631578947368
08182;2023;1;1;0;100;0;110000;1964;56
08183;2023;18;18;0;100;0;110592.555555556;1294.55555555556;83.4444444444444
08184;2023;2;2;0;100;0;77500;770;104.5
08185;2023;38;36;2;94.7368421052632;5.26315789473684;89030.2631578947;1110.92105263158;79.2105263157895
08187;2023;3;3;0;100;0;173866.666666667;1912;100.333333333333
08188;2023;11;11;0;100;0;98427.2727272727;1136.09090909091;84.4545454545455
08189;2023;2;2;0;100;0;366250;4516.5;97
08190;2023;48;40;8;83.3333333333333;16.6666666666667;129231.25;1334.27083333333;97.2916666666667
08191;2023;6;6;0;100;0;173416.666666667;1748.66666666667;98.1666666666667
08192;2023;1;1;0;100;0;156508;2174;72
08193;2023;4;4;0;100;0;89800;1119.5;87
08194;2023;11;11;0;100;0;182709.090909091;1507;121.363636363636
08195;2023;2;2;0;100;0;76500;1080.5;75
08197;2023;2;2;0;100;0;96130;727;126
08199;2023;12;12;0;100;0;177304.166666667;1881.91666666667;99.5
08200;2023;1;1;0;100;0;115000;1198;96
08201;2023;1;1;0;100;0;234045;2000;117
08202;2023;4;4;0;100;0;84000;1451;62.25
08203;2023;1;1;0;100;0;74000;692;107
08204;2023;1;1;0;100;0;90000;600;150
08206;2023;2;2;0;100;0;198300;1436.5;127.5
08207;2023;2;2;0;100;0;131500;1484.5;70.5
08208;2023;1;1;0;100;0;50000;417;120
08209;2023;5;5;0;100;0;153860;1728.2;85.6
08210;2023;2;2;0;100;0;118250;1236;89.5
08211;2023;6;6;0;100;0;168416.666666667;1453;98.5
08212;2023;2;2;0;100;0;224500;2210.5;101.5
08214;2023;11;11;0;100;0;101881.818181818;1287.18181818182;92.0909090909091
08215;2023;3;3;0;100;0;163440.666666667;1143.33333333333;108
08216;2023;3;3;0;100;0;166900;1551.33333333333;111.666666666667
08217;2023;1;1;0;100;0;109450;4560;24
08218;2023;15;15;0;100;0;88693.3333333333;1119.06666666667;85.0666666666667
08219;2023;4;4;0;100;0;89625;1084.5;87
08220;2023;5;5;0;100;0;180480;1580.6;118
08222;2023;22;21;1;95.4545454545455;4.54545454545455;114975.227272727;1264.77272727273;93.2272727272727
08223;2023;1;1;0;100;0;227350;2842;80
08225;2023;4;4;0;100;0;127712.5;1256.25;98.75
08226;2023;2;2;0;100;0;134500;962;140.5
08228;2023;3;3;0;100;0;224100;1764.66666666667;127.666666666667
08229;2023;2;2;0;100;0;297500;1870.5;157.5
08230;2023;3;3;0;100;0;255000;1665.66666666667;183
08232;2023;7;7;0;100;0;116111.714285714;1239.57142857143;90.4285714285714
08233;2023;1;1;0;100;0;75000;528;142
08234;2023;2;2;0;100;0;163300;2425.5;75
08235;2023;2;2;0;100;0;252375;2066;125
08236;2023;3;3;0;100;0;157520;1756.66666666667;102.333333333333
08237;2023;5;5;0;100;0;89100;888.2;103.6
08239;2023;11;11;0;100;0;174977.272727273;1731.81818181818;103.636363636364
08242;2023;3;3;0;100;0;118666.666666667;885.333333333333;122.333333333333
08243;2023;2;2;0;100;0;50000;616;76
08246;2023;3;3;0;100;0;103333.333333333;654;145.666666666667
08247;2023;1;1;0;100;0;3,00E+05;1796;167
08248;2023;9;9;0;100;0;167476.111111111;1424.55555555556;125.777777777778
08249;2023;2;2;0;100;0;227500;2191;157.5
08251;2023;1;1;0;100;0;46000;511;90
08252;2023;3;3;0;100;0;1,00E+05;983.666666666667;109.333333333333
08254;2023;4;4;0;100;0;135000;1294.75;106
08255;2023;3;3;0;100;0;111666.666666667;1159;93.3333333333333
08256;2023;1;1;0;100;0;90000;1154;78
08257;2023;2;2;0;100;0;77400;1028.5;64
08259;2023;3;3;0;100;0;75666.6666666667;667;113.666666666667
08260;2023;9;9;0;100;0;173311.111111111;1463.11111111111;117.222222222222
08262;2023;5;5;0;100;0;115651.4;1613;83.4
08263;2023;7;7;0;100;0;171271.428571429;1879.57142857143;95.5714285714286
08264;2023;5;5;0;100;0;124220;1174;101.8
08271;2023;1;1;0;100;0;70000;833;84
08272;2023;1;1;0;100;0;1,00E+05;1000;100
08275;2023;2;2;0;100;0;101700;1240.5;82.5
08276;2023;12;12;0;100;0;192616.666666667;2492.5;99.9166666666667
08278;2023;1;1;0;100;0;202500;1558;130
08279;2023;1;1;0;100;0;35000;530;66
08281;2023;3;3;0;100;0;174350;1701;102
08282;2023;9;8;1;88.8888888888889;11.1111111111111;136366.666666667;1402;98.3333333333333
08283;2023;3;3;0;100;0;128333.333333333;825;150
08284;2023;14;14;0;100;0;117357.142857143;1292.78571428571;98.8571428571429
08289;2023;5;5;0;100;0;110200;1357;95.6
08293;2023;1;1;0;100;0;80000;762;105
08294;2023;1;1;0;100;0;50000;1000;50
08295;2023;1;1;0;100;0;175000;1094;160
08296;2023;2;2;0;100;0;90000;975;105
08297;2023;3;3;0;100;0;227000;1912.66666666667;116
08298;2023;19;13;6;68.4210526315789;31.5789473684211;133051.631578947;1680.21052631579;72.9473684210526
08302;2023;25;24;1;96;4;89032;1055.52;87.2
08303;2023;3;3;0;100;0;127333.333333333;1500.66666666667;105.666666666667
08304;2023;1;1;0;100;0;95000;1056;90
08306;2023;1;1;0;100;0;32000;582;55
08310;2023;3;3;0;100;0;86666.6666666667;986;94.6666666666667
08311;2023;30;29;1;96.6666666666667;3.33333333333333;91281;1054.33333333333;87.6333333333333
08312;2023;1;1;0;100;0;1,00E+05;1449;69
08313;2023;2;2;0;100;0;121000;1595;75
08314;2023;13;13;0;100;0;204035.692307692;1861.15384615385;110.538461538462
08315;2023;1;1;0;100;0;51000;680;75
08316;2023;19;19;0;100;0;92642.1052631579;959.105263157895;98.6315789473684
08317;2023;2;2;0;100;0;173000;1224.5;155
08318;2023;6;6;0;100;0;146916.666666667;1581.16666666667;100.5
08320;2023;5;5;0;100;0;169200;1500;111.2
08322;2023;2;2;0;100;0;130000;1811;76
08325;2023;1;1;0;100;0;53000;616;86
08326;2023;1;1;0;100;0;130000;823;158
08327;2023;6;6;0;100;0;196766.666666667;1961.83333333333;102.666666666667
08328;2023;62;53;9;85.4838709677419;14.5161290322581;99368.1612903226;1163.53225806452;84.6612903225806
08330;2023;8;8;0;100;0;180578.75;1563.25;129.25
08331;2023;11;11;0;100;0;118718.181818182;1352.18181818182;88.4545454545455
08333;2023;4;4;0;100;0;73250;840.75;84
08335;2023;1;1;0;100;0;187600;2181;86
08336;2023;1;1;0;100;0;80000;678;118
08338;2023;2;2;0;100;0;105000;820.5;135
08339;2023;2;2;0;100;0;201858.5;1746.5;114
08340;2023;1;1;0;100;0;55000;500;110
08341;2023;12;12;0;100;0;157670;1583.66666666667;100.583333333333
08342;2023;3;3;0;100;0;137333.333333333;1546;91.6666666666667
08343;2023;13;11;2;84.6153846153846;15.3846153846154;136198.461538462;1401.92307692308;101.230769230769
08344;2023;4;4;0;100;0;165500;1120.5;144.5
08346;2023;23;23;0;100;0;236069.565217391;1998.39130434783;128.173913043478
08347;2023;3;3;0;100;0;91333.3333333333;951.666666666667;86.3333333333333
08348;2023;1;1;0;100;0;180000;1000;180
08349;2023;14;14;0;100;0;95553.5714285714;1143.42857142857;82.8571428571429
08350;2023;1;1;0;100;0;75000;424;177
08352;2023;2;2;0;100;0;147200;1468;99
08353;2023;8;7;1;87.5;12.5;194125;1966.5;98.625
08354;2023;11;9;2;81.8181818181818;18.1818181818182;98545.4545454545;1059.36363636364;93.1818181818182
08355;2023;1;1;0;100;0;355000;2219;160
08356;2023;1;1;0;100;0;190000;1462;130
08357;2023;13;13;0;100;0;110153.846153846;1340;94.6153846153846
08358;2023;3;3;0;100;0;169666.666666667;1309.33333333333;128.333333333333
08361;2023;21;21;0;100;0;139653.238095238;1336.95238095238;107.571428571429
08362;2023;70;51;19;72.8571428571428;27.1428571428571;151304.314285714;1740.02857142857;88.0285714285714
08363;2023;65;60;5;92.3076923076923;7.69230769230769;100723.784615385;1198.75384615385;87.2153846153846
08365;2023;16;16;0;100;0;139204.375;1469.5625;96.875
08366;2023;10;10;0;100;0;119510;1104.9;107
08367;2023;16;15;1;93.75;6.25;140562.5;1364.375;101.8125
08368;2023;5;5;0;100;0;155900;1827.2;88.8
08370;2023;6;6;0;100;0;141616.666666667;1598;100.833333333333
08374;2023;1;1;0;100;0;157000;1635;96
08376;2023;6;6;0;100;0;83500;1234.16666666667;75.8333333333333
08377;2023;1;1;0;100;0;322700;1306;247
08379;2023;4;4;0;100;0;245250;1476.75;161.25
08381;2023;6;6;0;100;0;145166.666666667;1606.66666666667;92
08383;2023;2;2;0;100;0;215000;1995.5;110
08384;2023;4;4;0;100;0;100750;951.75;108
08385;2023;10;10;0;100;0;164740;1541.1;109.1
08386;2023;3;3;0;100;0;182666.666666667;1978.66666666667;92.3333333333333
08388;2023;5;5;0;100;0;276000;1996;142.2
08389;2023;3;3;0;100;0;89100;1126.66666666667;76
08390;2023;1;1;0;100;0;108000;422;256
08391;2023;14;14;0;100;0;100028.571428571;1104.5;94.4285714285714
08392;2023;4;3;1;75;25;111131.25;855.5;133.75
08395;2023;1;1;0;100;0;182000;1273;143
08396;2023;1;1;0;100;0;126600;1161;109
08399;2023;6;6;0;100;0;122850.166666667;893.333333333333;128.666666666667
08400;2023;5;5;0;100;0;109836;1066.8;100.2
08402;2023;7;7;0;100;0;131457.142857143;1098.85714285714;129.857142857143
08403;2023;18;18;0;100;0;168386.111111111;1805.44444444444;96.8333333333333
08404;2023;2;2;0;100;0;223075;1864;117.5
08405;2023;3;3;0;100;0;62500;1093;60
08406;2023;6;6;0;100;0;119950;1214.83333333333;102
08408;2023;11;11;0;100;0;146240.909090909;1554.45454545455;99.1818181818182
08409;2023;175;69;106;39.4285714285714;60.5714285714286;91057.7142857143;1145.90857142857;78.84
08410;2023;2;2;0;100;0;128500;737;148.5
08413;2023;3;3;0;100;0;92066.6666666667;883.333333333333;105.666666666667
08415;2023;1;1;0;100;0;75000;773;97
08416;2023;3;3;0;100;0;175980;1681.66666666667;101.333333333333
08418;2023;2;2;0;100;0;84995;814.5;105.5
08419;2023;8;8;0;100;0;128250;1104.75;114.125
08420;2023;9;9;0;100;0;175344.111111111;2062.55555555556;93.5555555555556
08421;2023;1;1;0;100;0;55000;1310;42
08422;2023;3;3;0;100;0;156666.666666667;1080.66666666667;140
08424;2023;1;1;0;100;0;80000;1000;80
08427;2023;2;2;0;100;0;126500;872.5;154
08428;2023;1;1;0;100;0;2,00E+05;1504;133
08429;2023;4;4;0;100;0;153575;2018.5;98.25
08430;2023;1;1;0;100;0;150000;1500;100
08431;2023;2;2;0;100;0;84500;816.5;102.5
08433;2023;1;1;0;100;0;65200;767;85
08434;2023;3;3;0;100;0;145000;1302;103.666666666667
08435;2023;5;5;0;100;0;163700;1644;100.2
08436;2023;6;6;0;100;0;169298.833333333;1411;121.666666666667
08437;2023;2;2;0;100;0;87500;699.5;131.5
08439;2023;2;2;0;100;0;93000;1309.5;77
08444;2023;1;1;0;100;0;80000;503;159
08445;2023;6;6;0;100;0;147133.333333333;1143;130
08446;2023;1;1;0;100;0;70000;479;146
08448;2023;20;20;0;100;0;108625;1110.95;101.7
08449;2023;6;6;0;100;0;93500;876.666666666667;101.166666666667
08450;2023;1;1;0;100;0;115240;1280;90
08451;2023;5;5;0;100;0;150100;1445.8;104.2
08452;2023;1;1;0;100;0;185000;1005;184
08453;2023;3;3;0;100;0;73333.3333333333;941.333333333333;78
08456;2023;1;1;0;100;0;207300;1491;139
08457;2023;4;3;1;75;25;157425;1280.25;122.5
08458;2023;2;2;0;100;0;138000;1154;119.5
08459;2023;3;3;0;100;0;71666.6666666667;883.333333333333;75.6666666666667
08460;2023;4;4;0;100;0;198000;1496.25;165.25
08461;2023;5;5;0;100;0;61000;1022.2;56.6
08462;2023;4;4;0;100;0;72400;1264.75;68.5
08464;2023;1;1;0;100;0;154000;1305;118
08465;2023;1;1;0;100;0;56000;1400;40
08466;2023;2;2;0;100;0;65000;511;127.5
08468;2023;3;3;0;100;0;112933.333333333;929.666666666667;119.333333333333
08469;2023;8;8;0;100;0;185313.875;1172.375;156.25
08470;2023;1;1;0;100;0;38500;592;65
08472;2023;2;2;0;100;0;174500;1090;164.5
08473;2023;4;4;0;100;0;187875;1695.75;111.75
08476;2023;2;2;0;100;0;219800;1633;134
08477;2023;1;1;0;100;0;130000;802;162
08478;2023;3;3;0;100;0;153238.333333333;1198;125
08479;2023;4;4;0;100;0;145850;1062.25;132
08480;2023;31;29;2;93.5483870967742;6.45161290322581;161250.322580645;1616.54838709677;107.967741935484
08481;2023;2;1;1;50;50;204800;1633;123
08483;2023;4;4;0;100;0;107487.5;1146.75;94
08484;2023;2;2;0;100;0;73800;975.5;78
08485;2023;2;2;0;100;0;147400;1249;118
08486;2023;21;20;1;95.2380952380952;4.76190476190476;116073.333333333;1143.85714285714;98.8095238095238
08487;2023;20;20;0;100;0;126928;1399.25;90.1
08488;2023;34;33;1;97.0588235294118;2.94117647058824;162138.235294118;1465.55882352941;113.058823529412
08490;2023;34;29;5;85.2941176470588;14.7058823529412;108102.735294118;1135.02941176471;96.9705882352941
08491;2023;24;22;2;91.6666666666667;8.33333333333333;137031.208333333;1552.875;90.6666666666667
08492;2023;2;2;0;100;0;174250;1433.5;123
08494;2023;10;10;0;100;0;123310.6;1213.3;103.3
08496;2023;1;1;0;100;0;210000;1944;108
08497;2023;15;14;1;93.3333333333333;6.66666666666667;149630;1642.46666666667;93.3333333333333
08498;2023;3;3;0;100;0;171666.666666667;1505.66666666667;113.666666666667
09001;2023;1;1;0;100;0;95000;1092;87
09002;2023;5;5;0;100;0;163400;1781.6;92.4
09003;2023;7;7;0;100;0;108119.285714286;1326.42857142857;82.1428571428571
09004;2023;2;2;0;100;0;57250;510.5;109
09005;2023;7;7;0;100;0;135478.571428571;1659.28571428571;93.7142857142857
09006;2023;1;1;0;100;0;73000;497;147
09008;2023;7;7;0;100;0;142402.857142857;2483.28571428571;57
09009;2023;2;2;0;100;0;91230;1107;95.5
09011;2023;1;1;0;100;0;181890;2362;77
09012;2023;1;1;0;100;0;60000;1714;35
09014;2023;4;4;0;100;0;127695;2473.5;55
09015;2023;4;4;0;100;0;187500;1863.25;96.25
09016;2023;2;2;0;100;0;71250;1030;75
09017;2023;1;1;0;100;0;70000;1207;58
09018;2023;3;3;0;100;0;77666.6666666667;1382.33333333333;50.3333333333333
09019;2023;10;10;0;100;0;115200;1205.7;91.5
09021;2023;2;2;0;100;0;249900;1798.5;137.5
09022;2023;6;6;0;100;0;159166.666666667;1498.5;110.333333333333
09023;2023;4;4;0;100;0;83280;1572.75;62
09024;2023;4;4;0;100;0;191750;1589;121.75
09025;2023;2;2;0;100;0;164750;1891.5;83.5
09026;2023;3;3;0;100;0;75000;1339.33333333333;70
09027;2023;3;3;0;100;0;116323.333333333;2561;55.6666666666667
09029;2023;8;2;6;25;75;56006.25;1142.5;51.75
09030;2023;6;6;0;100;0;78287.3333333333;1196.66666666667;75.8333333333333
09032;2023;94;20;74;21.2765957446809;78.7234042553192;121185.14893617;2551.06382978723;53.0531914893617
09033;2023;2;2;0;100;0;78500;1238;56.5
09034;2023;2;2;0;100;0;97500;1427;75
09035;2023;4;4;0;100;0;54745;1049;56.25
09038;2023;10;10;0;100;0;118355.1;1228;98.6
09039;2023;2;2;0;100;0;93500;793;128
09040;2023;3;3;0;100;0;110000;1564.33333333333;73.3333333333333
09041;2023;7;7;0;100;0;115571.428571429;1431.14285714286;97.1428571428571
09042;2023;12;12;0;100;0;180192.5;1517.25;120.416666666667
09043;2023;12;12;0;100;0;144912.5;1337.58333333333;117
09044;2023;1;1;0;100;0;106000;1104;96
09045;2023;3;3;0;100;0;115000;1380;92.6666666666667
09046;2023;1;1;0;100;0;238000;1983;120
09047;2023;23;22;1;95.6521739130435;4.34782608695652;141711.739130435;1411.47826086957;104.304347826087
09048;2023;1;1;0;100;0;122000;1220;100
09049;2023;1;1;0;100;0;87000;2071;42
09050;2023;5;5;0;100;0;207900;1965.2;107
09051;2023;3;3;0;100;0;104848.333333333;725;145.666666666667
09052;2023;1;1;0;100;0;68000;971;70
09054;2023;3;3;0;100;0;171666.666666667;1765;117.333333333333
09055;2023;2;2;0;100;0;95835;1647.5;58.5
09056;2023;1;1;0;100;0;90000;900;100
09057;2023;14;14;0;100;0;113264.714285714;2086.85714285714;54.2142857142857
09058;2023;6;6;0;100;0;216431.666666667;2046.66666666667;102.166666666667
09059;2023;6;6;0;100;0;82718.3333333333;1218;63.1666666666667
09060;2023;17;17;0;100;0;149886.470588235;1436.82352941176;104
09061;2023;10;10;0;100;0;59418;950.9;65.1
09062;2023;7;7;0;100;0;129285.714285714;1601.28571428571;78.8571428571429
09063;2023;4;4;0;100;0;64975;912;72
09064;2023;1;1;0;100;0;220700;2164;102
09065;2023;11;11;0;100;0;108039.545454545;1924;59.2727272727273
09066;2023;10;10;0;100;0;202178;1852;101.9
09067;2023;2;2;0;100;0;137000;1766;83
09069;2023;1;1;0;100;0;18000;720;25
09070;2023;10;10;0;100;0;146621;1512.1;105.1
09071;2023;1;1;0;100;0;129000;1290;100
09074;2023;5;5;0;100;0;102000;1396.2;73.4
09075;2023;8;8;0;100;0;87193.75;1864.75;80.875
09076;2023;2;2;0;100;0;135950;2117.5;81
09077;2023;2;2;0;100;0;84977.5;1392;63
09078;2023;2;1;1;50;50;92545;1169.5;76.5
09079;2023;11;11;0;100;0;295413.636363636;1899.90909090909;153.181818181818
09080;2023;3;3;0;100;0;227748.333333333;2708.66666666667;87.3333333333333
09081;2023;2;2;0;100;0;160000;1449;112
09082;2023;11;11;0;100;0;171954.545454545;2040.81818181818;88.5454545454545
09083;2023;1;1;0;100;0;40000;727;55
09084;2023;1;1;0;100;0;150000;811;185
09085;2023;4;3;1;75;25;84334;1605;63.25
09086;2023;3;3;0;100;0;76133.3333333333;780.333333333333;100.666666666667
09087;2023;2;2;0;100;0;93025;1567;57.5
09089;2023;1;1;0;100;0;134450;1511;89
09091;2023;2;2;0;100;0;140432.5;1059.5;116
09092;2023;1;1;0;100;0;113000;1614;70
09093;2023;1;1;0;100;0;40000;667;60
09094;2023;6;6;0;100;0;208911.666666667;2347.83333333333;98.6666666666667
09095;2023;4;4;0;100;0;112787.5;1656.5;68.25
09096;2023;4;2;2;50;50;99345;1206.25;89.25
09097;2023;2;2;0;100;0;81000;878;93.5
09099;2023;4;4;0;100;0;251000;1860.5;139
09100;2023;10;4;6;40;60;56737.5;874.7;72
09101;2023;4;4;0;100;0;235425;1629;144.75
09103;2023;4;4;0;100;0;287987.5;2247.25;126.25
09104;2023;7;7;0;100;0;166655.714285714;1990.71428571429;85.5714285714286
09105;2023;27;26;1;96.2962962962963;3.7037037037037;113112.962962963;1463.22222222222;80.0740740740741
09106;2023;4;4;0;100;0;80805;795.75;96.5
09107;2023;10;10;0;100;0;125700;1518.5;93.4
09108;2023;2;2;0;100;0;40000;641.5;66
09110;2023;1;1;0;100;0;95652;2733;35
09111;2023;3;3;0;100;0;106333.333333333;1741.33333333333;59.6666666666667
09113;2023;10;10;0;100;0;117269.5;2417.7;57.6
09114;2023;4;4;0;100;0;182750;2150.5;83.25
09116;2023;2;2;0;100;0;138500;1183;114
09117;2023;2;2;0;100;0;90000;966;114.5
09118;2023;1;1;0;100;0;110000;917;120
09119;2023;6;6;0;100;0;92416.6666666667;1403.5;74
09120;2023;1;1;0;100;0;123050;1099;112
09121;2023;11;11;0;100;0;179625.636363636;1970.18181818182;92.9090909090909
09122;2023;168;84;84;50;50;126037.041666667;1648.85119047619;78.9285714285714
09124;2023;15;14;1;93.3333333333333;6.66666666666667;127556.666666667;1544.46666666667;81.3333333333333
09125;2023;8;8;0;100;0;91243.75;1562.375;59
09126;2023;2;2;0;100;0;128397;1902;78.5
09127;2023;2;2;0;100;0;331579.5;2841.5;127
09128;2023;5;5;0;100;0;234952.8;2374;99.4
09129;2023;7;7;0;100;0;195400;2045.85714285714;93.2857142857143
09130;2023;9;9;0;100;0;160791.111111111;1329.77777777778;120.111111111111
09131;2023;3;3;0;100;0;168000;1781.33333333333;102
09132;2023;2;2;0;100;0;198500;2012;102
09134;2023;2;2;0;100;0;90500;1629.5;56
09136;2023;2;2;0;100;0;139905;1836;74
09137;2023;1;1;0;100;0;222000;3639;61
09138;2023;3;3;0;100;0;129516.666666667;1479.33333333333;76.6666666666667
09139;2023;4;1;3;25;75;114127.5;1781.25;77.75
09140;2023;2;2;0;100;0;248530;2539.5;84.5
09141;2023;1;1;0;100;0;86896;1738;50
09142;2023;2;2;0;100;0;181200;1692;109.5
09143;2023;1;1;0;100;0;192035;2743;70
09145;2023;5;5;0;100;0;189926;1619.6;122.8
09146;2023;1;1;0;100;0;235000;2080;113
09147;2023;4;4;0;100;0;215977.5;2216.25;99
09148;2023;3;3;0;100;0;146333.333333333;1725;80
09149;2023;5;5;0;100;0;133892;1648.6;112.4
09150;2023;5;5;0;100;0;158268;2002.2;77.8
09151;2023;2;2;0;100;0;157000;1400;120
09152;2023;4;4;0;100;0;98320;1563.25;68
09157;2023;31;30;1;96.7741935483871;3.2258064516129;124361.483870968;1235.93548387097;99.1935483870968
09158;2023;9;9;0;100;0;147052.222222222;2045;86.6666666666667
09159;2023;2;2;0;100;0;117340;1365.5;84.5
09160;2023;89;80;9;89.8876404494382;10.1123595505618;98989.3146067416;1068.12359550562;91.7865168539326
09161;2023;10;9;1;90;10;145323.7;1684.8;89.9
09164;2023;5;5;0;100;0;120244;946.4;126
09165;2023;5;5;0;100;0;82600;1080.8;77
09166;2023;1;1;0;100;0;237500;4025;59
09167;2023;27;27;0;100;0;183426.666666667;1898.66666666667;96.6666666666667
09168;2023;3;3;0;100;0;91166.6666666667;1298.33333333333;79.6666666666667
09169;2023;1;1;0;100;0;88000;978;90
09170;2023;4;4;0;100;0;104437.5;1242.5;85
09173;2023;2;2;0;100;0;103440;1797;57
09174;2023;6;6;0;100;0;232549;2162.16666666667;109.166666666667
09175;2023;2;2;0;100;0;296250;1933.5;155.5
09176;2023;6;6;0;100;0;153422.5;1751.16666666667;93.6666666666667
09177;2023;5;5;0;100;0;127498.4;1367.6;101.2
09178;2023;1;1;0;100;0;190000;1418;134
09179;2023;2;2;0;100;0;159500;1613;99
09180;2023;2;2;0;100;0;152500;1224.5;116.5
09181;2023;10;9;1;90;10;109800;1325.3;83.8
09182;2023;21;20;1;95.2380952380952;4.76190476190476;100630.238095238;1444.61904761905;77.4285714285714
09183;2023;2;2;0;100;0;45762.5;865.5;59
09185;2023;65;61;4;93.8461538461538;6.15384615384615;162023.4;1781.04615384615;95.4
09186;2023;1;1;0;100;0;136000;2267;60
09187;2023;3;3;0;100;0;201833.333333333;2274.33333333333;86.6666666666667
09188;2023;17;17;0;100;0;152000;1535.64705882353;96.8235294117647
09189;2023;3;3;0;100;0;173333.333333333;1378;100.333333333333
09190;2023;7;7;0;100;0;141571.428571429;1443.28571428571;98.2857142857143
09192;2023;4;4;0;100;0;97317.5;1769.5;57.5
09194;2023;58;45;13;77.5862068965517;22.4137931034483;188529.862068966;1992.25862068966;91.8448275862069
09195;2023;1;1;0;100;0;115000;1597;72
09197;2023;1;1;0;100;0;144100;4803;30
09198;2023;4;4;0;100;0;137500;1635;86.5
09199;2023;5;5;0;100;0;69600;1015.8;75
09200;2023;5;5;0;100;0;329630;3448;119.2
09202;2023;2;2;0;100;0;93225;1313;74.5
09203;2023;1;1;0;100;0;35000;673;52
09204;2023;1;1;0;100;0;250000;1812;138
09205;2023;1;1;0;100;0;1,00E+05;1562;64
09206;2023;31;13;18;41.9354838709677;58.0645161290323;70047.9032258065;1773.61290322581;47.1290322580645
09207;2023;12;11;1;91.6666666666667;8.33333333333333;167625;1779.5;92.9166666666667
09208;2023;2;2;0;100;0;154000;1839;92.5
09209;2023;6;6;0;100;0;196750;1644.83333333333;121.166666666667
09210;2023;8;8;0;100;0;139431.25;1907.625;71.625
09211;2023;5;5;0;100;0;108800;1403.8;72.8
09212;2023;3;3;0;100;0;143440;1495.33333333333;88.6666666666667
09213;2023;2;2;0;100;0;195500;1281;183.5
09214;2023;18;18;0;100;0;160221.277777778;2098.33333333333;86.4444444444444
09216;2023;1;1;0;100;0;118613;1031;115
09217;2023;5;4;1;80;20;124020;1350.8;90.6
09218;2023;2;2;0;100;0;185500;3032.5;61
09219;2023;3;3;0;100;0;89273.3333333333;1745.33333333333;48.6666666666667
09220;2023;2;2;0;100;0;131090;1449;85.5
09221;2023;5;4;1;80;20;72000;999.2;74.6
09222;2023;1;1;0;100;0;285000;2280;125
09223;2023;10;10;0;100;0;96095;1308;77
09224;2023;11;11;0;100;0;121999.545454545;1316;104
09225;2023;212;143;69;67.4528301886792;32.5471698113208;134217.688679245;1655.32547169811;83.938679245283
09226;2023;1;1;0;100;0;168000;2667;63
09227;2023;1;1;0;100;0;140000;1186;118
09228;2023;3;3;0;100;0;176706.666666667;1762.66666666667;106.666666666667
09229;2023;2;2;0;100;0;85000;937.5;100
09230;2023;3;3;0;100;0;77333.3333333333;855;105.666666666667
09231;2023;11;11;0;100;0;90573.6363636364;2425.36363636364;56.2727272727273
09232;2023;5;5;0;100;0;75480;889;87.8
09235;2023;13;13;0;100;0;309291.538461538;1881;115.769230769231
09236;2023;4;4;0;100;0;138125;1639;83.75
09237;2023;1;1;0;100;0;218670;2302;95
09238;2023;2;2;0;100;0;177500;1870;93.5
09239;2023;5;5;0;100;0;130600;1704.6;71.8
09240;2023;3;2;1;66.6666666666667;33.3333333333333;121166.666666667;1223.66666666667;112.666666666667
09241;2023;9;9;0;100;0;159271.111111111;1702;90.6666666666667
09244;2023;12;11;1;91.6666666666667;8.33333333333333;210808.333333333;1772.58333333333;108
09245;2023;11;11;0;100;0;194901.363636364;2009.09090909091;99.8181818181818
09246;2023;5;5;0;100;0;188370;1705.8;93.2
09247;2023;8;8;0;100;0;86156.25;1339.25;70.875
09250;2023;4;4;0;100;0;135375;1129.5;119.25
09251;2023;2;2;0;100;0;125000;1108;98.5
09252;2023;2;2;0;100;0;110000;1470;72.5
09253;2023;4;4;0;100;0;81775;859.75;88.5
09254;2023;2;2;0;100;0;219975;2224;85
09256;2023;1;1;0;100;0;530950;3540;150
09257;2023;10;10;0;100;0;185814;1980.1;117
09258;2023;3;3;0;100;0;152666.666666667;1870;90
09261;2023;99;59;40;59.5959595959596;40.4040404040404;115048.161616162;1434.40404040404;81.5353535353535
09262;2023;2;2;0;100;0;109380;945;122.5
09264;2023;11;11;0;100;0;191909.090909091;1933.81818181818;98.2727272727273
09265;2023;25;17;8;68;32;152043.08;1859.52;80.16
09267;2023;7;7;0;100;0;92318.5714285714;1249.85714285714;76.1428571428571
09268;2023;13;13;0;100;0;166784.615384615;1630.69230769231;108.923076923077
09269;2023;1;1;0;100;0;237000;1743;136
09270;2023;4;4;0;100;0;141000;1332.75;103
09272;2023;16;16;0;100;0;196263.125;1847.375;102.125
09273;2023;10;10;0;100;0;148160.7;1556.9;89
09274;2023;4;4;0;100;0;142966.75;1308.5;109.5
09275;2023;1;1;0;100;0;185000;1652;112
09276;2023;1;1;0;100;0;2,00E+05;1399;143
09277;2023;13;13;0;100;0;162023.846153846;1503.61538461538;110.538461538462
09280;2023;22;22;0;100;0;150621.636363636;1633.59090909091;99.6363636363636
09281;2023;2;2;0;100;0;152500;1822.5;89.5
09282;2023;42;37;5;88.0952380952381;11.9047619047619;188248.595238095;1717;114.380952380952
09283;2023;5;3;2;60;40;143040;1870.8;81.6
09285;2023;17;17;0;100;0;96361.7647058823;1316.94117647059;71.4705882352941
09289;2023;13;12;1;92.3076923076923;7.69230769230769;140882.384615385;1777.61538461538;88.1538461538462
09290;2023;7;7;0;100;0;112148.714285714;1973.71428571429;58.2857142857143
09291;2023;6;6;0;100;0;85448.3333333333;1794.66666666667;49.5
09292;2023;2;2;0;100;0;203450;2873;90
09293;2023;12;12;0;100;0;147208.333333333;1503;101.083333333333
09294;2023;1;1;0;100;0;225000;1125;200
09295;2023;1;1;0;100;0;60000;1714;35
09296;2023;1;1;0;100;0;177650;1794;99
09298;2023;2;2;0;100;0;125125;1855.5;67
09299;2023;8;8;0;100;0;157162.5;2089.25;75.875
09300;2023;1;1;0;100;0;150000;1667;90
09301;2023;9;9;0;100;0;101690;1386;74.1111111111111
09303;2023;4;4;0;100;0;303760;2133.25;143.75
09305;2023;3;3;0;100;0;129533.333333333;1746.33333333333;71.3333333333333
09306;2023;34;26;8;76.4705882352941;23.5294117647059;119666.323529412;1418.23529411765;86.6764705882353
09307;2023;2;2;0;100;0;46400;577;80
09308;2023;2;2;0;100;0;119750;1878.5;67.5
09309;2023;2;2;0;100;0;164000;1083;119.5
09311;2023;1;1;0;100;0;112910;1152;98
09312;2023;36;35;1;97.2222222222222;2.77777777777778;201619.444444444;2003.36111111111;104.583333333333
09313;2023;2;2;0;100;0;178750;1489.5;120
09314;2023;4;2;2;50;50;131087.5;1735.25;76.75
09315;2023;1;1;0;100;0;145000;906;160
09316;2023;2;2;0;100;0;75000;1346;71.5
09318;2023;3;3;0;100;0;194723.333333333;3060;62.6666666666667
09319;2023;1;1;0;100;0;360200;1615;223
09321;2023;2;1;1;50;50;65500;1330;47.5
09322;2023;52;25;27;48.0769230769231;51.9230769230769;84041.8269230769;1833.78846153846;48.7884615384615
09323;2023;1;1;0;100;0;205000;1934;106
09324;2023;41;41;0;100;0;155085.390243902;1821.0243902439;86.5853658536585
09326;2023;2;2;0;100;0;124435;2406;74
09327;2023;2;2;0;100;0;176201.5;1163.5;141
09328;2023;1;1;0;100;0;108000;2038;53
09329;2023;10;10;0;100;0;186420.5;1710.7;106.5
09331;2023;7;7;0;100;0;213315.428571429;1680.42857142857;123.571428571429
09332;2023;27;27;0;100;0;201272.666666667;1911.37037037037;103.62962962963
09334;2023;13;12;1;92.3076923076923;7.69230769230769;83253.4615384615;1440.38461538462;64
09336;2023;10;10;0;100;0;110243;1135.7;104.7
09339;2023;4;4;0;100;0;155925;1545.5;102
09340;2023;1;1;0;100;0;225000;1731;130
09341;2023;3;3;0;100;0;161006.666666667;1627.33333333333;98.6666666666667
09342;2023;1;1;0;100;0;130000;1733;75
10002;2023;1;1;0;100;0;117000;3900;30
10003;2023;45;45;0;100;0;134525.111111111;1366.35555555556;102.888888888889
10004;2023;2;2;0;100;0;113500;1486;74.5
10005;2023;2;2;0;100;0;92500;1165;79.5
10006;2023;30;21;9;70;30;93668.3333333333;1160.86666666667;79.7666666666667
10008;2023;2;2;0;100;0;117500;1019.5;135.5
10010;2023;1;1;0;100;0;80000;635;126
10011;2023;1;1;0;100;0;135000;1116;121
10012;2023;5;5;0;100;0;114781.2;1027.2;114.4
10014;2023;2;2;0;100;0;158000;1764.5;89.5
10015;2023;6;6;0;100;0;197858.333333333;1664.5;135.333333333333
10018;2023;5;5;0;100;0;119200;945.6;115
10019;2023;5;5;0;100;0;128230;964.4;143
10020;2023;4;4;0;100;0;215250;1978;111
10022;2023;4;4;0;100;0;62125;834;74
10023;2023;2;2;0;100;0;126875;1070;104
10024;2023;2;2;0;100;0;119500;1210.5;98
10028;2023;1;1;0;100;0;91850;1021;90
10029;2023;2;2;0;100;0;85000;1226;71
10030;2023;9;9;0;100;0;224710.111111111;2245.66666666667;99.7777777777778
10031;2023;6;6;0;100;0;186700;1473.83333333333;131.833333333333
10032;2023;1;1;0;100;0;175000;1733;101
10033;2023;37;30;7;81.0810810810811;18.9189189189189;89618.3783783784;1054.91891891892;84.1621621621622
10034;2023;20;11;9;55;45;91697.85;1052.55;82.05
10035;2023;7;7;0;100;0;97057.1428571429;836.285714285714;109.571428571429
10037;2023;5;5;0;100;0;169474;1706.6;101.2
10038;2023;3;3;0;100;0;107300;1221;86
10039;2023;1;1;0;100;0;32000;471;68
10040;2023;4;4;0;100;0;66100;703.5;91.5
10041;2023;1;1;0;100;0;120000;741;162
10042;2023;3;3;0;100;0;70333.3333333333;800.666666666667;85.6666666666667
10043;2023;1;1;0;100;0;62400;1248;50
10049;2023;3;3;0;100;0;231000;1995.66666666667;123.666666666667
10050;2023;1;1;0;100;0;188000;1435;131
10051;2023;8;8;0;100;0;205462.5;1947.125;105.75
10052;2023;3;3;0;100;0;167133.333333333;1375.66666666667;117
10053;2023;3;3;0;100;0;243666.666666667;1901;141.666666666667
10054;2023;2;2;0;100;0;121000;1512.5;80
10055;2023;1;1;0;100;0;125000;1250;100
10056;2023;3;3;0;100;0;115770.666666667;1144.33333333333;99
10058;2023;2;2;0;100;0;85500;1093.5;80
10059;2023;1;1;0;100;0;35000;673;52
10060;2023;39;33;6;84.6153846153846;15.3846153846154;241027.435897436;2174.25641025641;109.564102564103
10061;2023;5;5;0;100;0;197722;1684;115.6
10062;2023;2;2;0;100;0;75418;1011.5;76.5
10063;2023;7;7;0;100;0;137892.857142857;1321.28571428571;104.571428571429
10064;2023;21;21;0;100;0;131936.238095238;1365.28571428571;96.7142857142857
10065;2023;1;1;0;100;0;120000;1579;76
10066;2023;6;6;0;100;0;169011.666666667;1769.83333333333;98.5
10067;2023;14;12;2;85.7142857142857;14.2857142857143;222882.142857143;1996.64285714286;111.5
10068;2023;1;1;0;100;0;149000;1242;120
10069;2023;2;2;0;100;0;169500;1290;129
10070;2023;6;6;0;100;0;174000;1817.16666666667;96
10073;2023;1;1;0;100;0;50000;549;91
10074;2023;7;7;0;100;0;177035.714285714;1466.57142857143;114.142857142857
10075;2023;2;2;0;100;0;51687.5;625;74
10076;2023;3;3;0;100;0;127766.666666667;1025.66666666667;140
10079;2023;2;2;0;100;0;68500;614.5;99
10080;2023;6;6;0;100;0;192166.666666667;1227.66666666667;142
10081;2023;98;53;45;54.0816326530612;45.9183673469388;137084.275510204;1671.22448979592;79.5714285714286
10082;2023;2;2;0;100;0;170000;1461;120.5
10083;2023;5;5;0;100;0;153000;1414.8;93
10084;2023;12;12;0;100;0;211125.833333333;1966.08333333333;109.166666666667
10087;2023;2;2;0;100;0;117500;1054.5;111.5
10089;2023;6;6;0;100;0;172416.666666667;1342.5;124.833333333333
10090;2023;1;1;0;100;0;129000;1843;70
10092;2023;1;1;0;100;0;215000;2363;91
10093;2023;1;1;0;100;0;205500;1727;119
10094;2023;7;7;0;100;0;75071.4285714286;878.571428571429;87.5714285714286
10095;2023;6;6;0;100;0;139858.333333333;1188.83333333333;120.666666666667
10096;2023;6;6;0;100;0;157736.666666667;1393;110.5
10097;2023;1;1;0;100;0;155000;1076;144
10098;2023;4;4;0;100;0;110875;1280.5;101.5
10099;2023;5;5;0;100;0;192350;1266.4;152
10100;2023;15;15;0;100;0;233398.466666667;2011.66666666667;119.666666666667
10101;2023;2;2;0;100;0;139325;1284.5;107.5
10102;2023;3;3;0;100;0;112666.666666667;906.333333333333;117
10103;2023;3;3;0;100;0;169666.666666667;1789;96
10104;2023;3;3;0;100;0;403653.333333333;1827;183.666666666667
10106;2023;2;2;0;100;0;135000;1687.5;80
10108;2023;3;3;0;100;0;77000;1027.33333333333;80.3333333333333
10109;2023;3;3;0;100;0;107500;1058;94.3333333333333
10110;2023;4;4;0;100;0;172250;2328.25;81.5
10111;2023;3;3;0;100;0;98666.6666666667;1112;94
10112;2023;5;5;0;100;0;121680;1397.8;98.2
10113;2023;4;4;0;100;0;86894.5;1013.25;83.25
10114;2023;12;12;0;100;0;98083.3333333333;1147.33333333333;95.25
10115;2023;13;12;1;92.3076923076923;7.69230769230769;230173.076923077;2005.92307692308;112.384615384615
10119;2023;1;1;0;100;0;287750;3509;82
10120;2023;3;3;0;100;0;193833.333333333;1363.66666666667;134.666666666667
10121;2023;4;4;0;100;0;80750;813.75;97.25
10122;2023;3;3;0;100;0;95333.3333333333;929.666666666667;101.333333333333
10123;2023;14;10;4;71.4285714285714;28.5714285714286;127117.142857143;1847.64285714286;74.7857142857143
10124;2023;4;4;0;100;0;139375;1250.5;123.25
10125;2023;4;4;0;100;0;186750;1451.75;101.5
10126;2023;1;1;0;100;0;80000;800;100
10129;2023;1;1;0;100;0;80000;1000;80
10130;2023;2;2;0;100;0;87350;728;120
10132;2023;4;4;0;100;0;104672.5;1340.5;82.75
10133;2023;4;4;0;100;0;99125;1157;81.75
10136;2023;1;1;0;100;0;27500;561;49
10138;2023;2;2;0;100;0;29975;1000;37
10139;2023;1;1;0;100;0;117212;1056;111
10140;2023;11;11;0;100;0;91636.3636363636;959.454545454545;100.181818181818
10141;2023;5;5;0;100;0;57435;810;70
10142;2023;20;20;0;100;0;99522.5;1231.05;82.15
10143;2023;2;2;0;100;0;104250;985;107
10144;2023;2;2;0;100;0;111500;1281.5;78
10145;2023;2;2;0;100;0;131750;1208.5;108.5
10146;2023;1;1;0;100;0;57000;877;65
10148;2023;3;3;0;100;0;143333.333333333;1670.33333333333;86
10149;2023;3;3;0;100;0;230316.666666667;1781.33333333333;131
10150;2023;2;2;0;100;0;341000;2537;141.5
10151;2023;11;10;1;90.9090909090909;9.09090909090909;167045.454545455;1808.90909090909;92.7272727272727
10153;2023;2;2;0;100;0;225304;1613;138.5
10154;2023;1;1;0;100;0;55000;1279;43
10155;2023;2;2;0;100;0;237325;1458;161
10156;2023;8;8;0;100;0;196125;1742.125;115.875
10157;2023;2;2;0;100;0;132400;2231.5;62.5
10158;2023;5;5;0;100;0;178219;1886;99
10164;2023;11;11;0;100;0;130409.090909091;1300.54545454545;105.727272727273
10165;2023;4;4;0;100;0;188375;2041.75;118
10166;2023;5;5;0;100;0;129330;1456.2;95.8
10167;2023;1;1;0;100;0;162000;726;223
10168;2023;1;1;0;100;0;90000;1286;70
10169;2023;5;5;0;100;0;129940.4;1274.2;105.4
10170;2023;5;5;0;100;0;125760;1368;99.2
10171;2023;1;1;0;100;0;86000;628;137
10173;2023;5;5;0;100;0;222000;1940.6;112.6
10175;2023;2;2;0;100;0;134500;1455;93
10176;2023;2;2;0;100;0;69250;1021;71
10177;2023;4;4;0;100;0;99000;888.75;113.75
10178;2023;1;1;0;100;0;140710;1303;108
10179;2023;6;6;0;100;0;162465.333333333;1568.16666666667;100.166666666667
10180;2023;1;1;0;100;0;227000;1621;140
10184;2023;1;1;0;100;0;90000;938;96
10185;2023;2;2;0;100;0;180500;1213.5;137.5
10186;2023;1;1;0;100;0;210000;1750;120
10187;2023;3;3;0;100;0;70000;753.333333333333;97
10188;2023;1;1;0;100;0;115000;1438;80
10189;2023;2;2;0;100;0;28000;658.5;49
10190;2023;2;2;0;100;0;143000;1505.5;95
10191;2023;5;3;2;60;40;193240;1613.8;129.6
10192;2023;1;1;0;100;0;86000;632;136
10193;2023;4;4;0;100;0;147942.5;1244.75;122
10194;2023;2;2;0;100;0;135000;899.5;152
10195;2023;2;2;0;100;0;73750;671.5;110.5
10198;2023;1;1;0;100;0;112000;2333;48
10199;2023;8;8;0;100;0;154250;1125.25;129.5
10202;2023;3;3;0;100;0;124983.333333333;1301.33333333333;100.333333333333
10203;2023;3;3;0;100;0;64946.6666666667;901.333333333333;88
10205;2023;1;1;0;100;0;123000;769;160
10206;2023;1;1;0;100;0;108000;1080;100
10207;2023;3;3;0;100;0;116000;1204.33333333333;94.6666666666667
10208;2023;4;4;0;100;0;173000;1733;103.5
10209;2023;21;19;2;90.4761904761905;9.52380952380952;212337;2076.71428571429;102.904761904762
10210;2023;4;4;0;100;0;193081.25;1755;114.75
10211;2023;10;9;1;90;10;237250;2111.3;114.7
10212;2023;1;1;0;100;0;40000;500;80
10213;2023;2;2;0;100;0;91066;689.5;137.5
10215;2023;1;1;0;100;0;217250;2050;106
10216;2023;9;9;0;100;0;99446.8888888889;1077.66666666667;93.5555555555556
10218;2023;4;4;0;100;0;137337.5;1324.25;110.75
10220;2023;15;15;0;100;0;145433.333333333;1610.26666666667;88.4
10222;2023;4;4;0;100;0;134250;1093;124.5
10223;2023;8;8;0;100;0;92745.875;1020.375;96.875
10224;2023;14;14;0;100;0;113142.857142857;1338.5;90.5
10225;2023;2;2;0;100;0;175500;1223;150
10226;2023;1;1;0;100;0;96000;727;132
10227;2023;3;3;0;100;0;105633.333333333;1021.33333333333;97.6666666666667
10228;2023;3;3;0;100;0;101833.333333333;945.666666666667;108.333333333333
10229;2023;2;2;0;100;0;96500;1135.5;82.5
10230;2023;3;3;0;100;0;127500;1306.66666666667;99
10231;2023;9;9;0;100;0;136888.888888889;1594;86.8888888888889
10232;2023;8;8;0;100;0;145175;1317.375;106
10233;2023;20;17;3;85;15;126700;1466.4;85.75
10234;2023;4;4;0;100;0;128750;1358.75;95.25
10236;2023;1;1;0;100;0;156500;1630;96
10237;2023;6;6;0;100;0;150000;1466.16666666667;99.8333333333333
10238;2023;9;8;1;88.8888888888889;11.1111111111111;188958.555555556;1427.22222222222;132.111111111111
10239;2023;1;1;0;100;0;170000;1308;130
10240;2023;4;4;0;100;0;296597.5;2071.25;149
10242;2023;2;2;0;100;0;152500;1624;84.5
10245;2023;4;4;0;100;0;159750;1429.75;109.75
10246;2023;2;2;0;100;0;134000;1460.5;90.5
10247;2023;1;1;0;100;0;1,00E+05;2128;47
10248;2023;3;3;0;100;0;260026.666666667;1859.66666666667;129.666666666667
10249;2023;6;6;0;100;0;149408.333333333;1148.16666666667;135.666666666667
10250;2023;5;5;0;100;0;144800;1130.4;123.4
10251;2023;4;4;0;100;0;120030;1536.25;76.25
10253;2023;2;2;0;100;0;142199.5;997.5;137
10254;2023;3;3;0;100;0;180833.333333333;1368.33333333333;146.333333333333
10255;2023;1;1;0;100;0;265000;2208;120
10256;2023;4;4;0;100;0;186250;1748;113.75
10258;2023;2;2;0;100;0;155000;1509.5;102.5
10259;2023;5;5;0;100;0;185800;2429.6;85.8
10260;2023;6;6;0;100;0;319241.666666667;2351.33333333333;125.666666666667
10261;2023;6;6;0;100;0;88608.3333333333;1043.83333333333;85.5
10262;2023;4;4;0;100;0;52250;594.75;90
10263;2023;2;2;0;100;0;147700;1859;79.5
10264;2023;2;2;0;100;0;60000;750;75
10265;2023;28;20;8;71.4285714285714;28.5714285714286;190732.535714286;2286.46428571429;85.25
10266;2023;2;2;0;100;0;197150;1674.5;117.5
10267;2023;2;2;0;100;0;96750;979;103
10268;2023;56;46;10;82.1428571428571;17.8571428571429;147777.785714286;1759.67857142857;87.4107142857143
10269;2023;1;1;0;100;0;130000;1250;104
10270;2023;3;3;0;100;0;158466.666666667;1353.66666666667;132.666666666667
10271;2023;6;6;0;100;0;121648.5;1104.66666666667;110.166666666667
10272;2023;1;1;0;100;0;155000;1115;139
10274;2023;5;5;0;100;0;132820;1245.8;102.8
10275;2023;5;5;0;100;0;178000;1251.2;147
10276;2023;3;3;0;100;0;207266.666666667;1694.66666666667;121.333333333333
10278;2023;1;1;0;100;0;149000;1211;123
10279;2023;1;1;0;100;0;108000;1227;88
10280;2023;14;14;0;100;0;121787.357142857;1269.35714285714;98.4285714285714
10282;2023;13;13;0;100;0;174426.923076923;1711.92307692308;96.4615384615385
10283;2023;1;1;0;100;0;1,00E+05;1190;84
10284;2023;2;2;0;100;0;128500;1240;119.5
10287;2023;10;10;0;100;0;138550;1359.5;102.2
10288;2023;1;1;0;100;0;84000;988;85
10289;2023;15;15;0;100;0;111366.666666667;965.733333333333;118.466666666667
10291;2023;3;3;0;100;0;180666.666666667;1774;101
10293;2023;1;1;0;100;0;107000;594;180
10294;2023;1;1;0;100;0;40000;690;58
10295;2023;1;1;0;100;0;82000;863;95
10296;2023;1;1;0;100;0;140000;1400;100
10297;2023;38;26;12;68.4210526315789;31.5789473684211;179830.5;2094.68421052632;86.6842105263158
10298;2023;14;14;0;100;0;119439.714285714;1173.42857142857;103.142857142857
10299;2023;3;3;0;100;0;126910;1598.66666666667;98
10300;2023;6;6;0;100;0;121983.333333333;1195.16666666667;99.3333333333333
10301;2023;4;4;0;100;0;152340;1261.75;113.5
10302;2023;2;2;0;100;0;220000;1597;152
10304;2023;1;1;0;100;0;89100;928;96
10306;2023;3;3;0;100;0;79333.3333333333;848.666666666667;96
10307;2023;2;2;0;100;0;220300;2439;92
10308;2023;1;1;0;100;0;95000;841;113
10309;2023;1;1;0;100;0;197750;1213;163
10310;2023;1;1;0;100;0;135500;1506;90
10312;2023;1;1;0;100;0;105000;1615;65
10313;2023;5;5;0;100;0;117700;1053.8;110.2
10314;2023;3;3;0;100;0;55000;987.666666666667;61.3333333333333
10315;2023;1;1;0;100;0;111000;1181;94
10317;2023;11;11;0;100;0;121256.363636364;1132.18181818182;118.636363636364
10319;2023;5;5;0;100;0;80400;630.4;118.2
10320;2023;2;2;0;100;0;218000;1775;122
10321;2023;39;39;0;100;0;241910.256410256;2238.82051282051;110.358974358974
10323;2023;170;139;31;81.7647058823529;18.2352941176471;103657;1261.54705882353;83.0705882352941
10324;2023;4;4;0;100;0;302862.5;2557;125.75
10325;2023;28;23;5;82.1428571428571;17.8571428571429;221062.5;2332.60714285714;94.9285714285714
10326;2023;2;2;0;100;0;65000;1027.5;61.5
10327;2023;1;1;0;100;0;160000;1481;108
10328;2023;5;4;1;80;20;202600;2315.8;108
10329;2023;5;5;0;100;0;198867.6;2387.2;82.8
10330;2023;1;1;0;100;0;190000;1338;142
10331;2023;5;5;0;100;0;186450;1638.8;112
10332;2023;4;4;0;100;0;271500;2341.75;117.75
10333;2023;198;89;109;44.9494949494949;55.0505050505051;154110.606060606;1916.88888888889;79.4343434343434
10334;2023;4;4;0;100;0;163469;1387.5;108.25
10335;2023;1;1;0;100;0;108000;2160;50
10336;2023;3;3;0;100;0;151000;1936;81.3333333333333
10338;2023;3;3;0;100;0;132333.333333333;1418.33333333333;92
10339;2023;2;2;0;100;0;354164.5;2167.5;165
10340;2023;33;29;4;87.8787878787879;12.1212121212121;191607.878787879;1962.9696969697;99.6666666666667
10341;2023;3;3;0;100;0;148200;1162.66666666667;147
10342;2023;3;3;0;100;0;207666.666666667;1846.33333333333;113.666666666667
10343;2023;82;52;30;63.4146341463415;36.5853658536585;158340.646341463;1966.29268292683;82.6707317073171
10344;2023;2;2;0;100;0;276000;2542;111
10345;2023;5;5;0;100;0;80266;978.2;80.8
10347;2023;2;2;0;100;0;147000;1204;122.5
10348;2023;4;4;0;100;0;105500;1028.5;99.5
10349;2023;23;23;0;100;0;228941.52173913;1936.08695652174;127.478260869565
10350;2023;7;7;0;100;0;138285.714285714;1136.71428571429;117.714285714286
10351;2023;5;5;0;100;0;155820;1385;115.4
10352;2023;24;24;0;100;0;255391.666666667;2275;112.458333333333
10353;2023;9;9;0;100;0;147204.888888889;1752.88888888889;83.6666666666667
10354;2023;2;2;0;100;0;73000;1043;70.5
10355;2023;3;3;0;100;0;250000;1852.66666666667;134.666666666667
10356;2023;2;2;0;100;0;96500;887.5;108.5
10357;2023;25;23;2;92;8;168415.2;1945.76;87.64
10358;2023;8;7;1;87.5;12.5;160881.25;1453;116.25
10359;2023;10;10;0;100;0;151480.2;1410.8;105.2
10360;2023;9;9;0;100;0;295266.666666667;2450.33333333333;123
10361;2023;1;1;0;100;0;165000;1650;100
10362;2023;176;81;95;46.0227272727273;53.9772727272727;152093.039772727;2130.30113636364;70.9602272727273
10363;2023;1;1;0;100;0;160000;2162;74
10365;2023;2;2;0;100;0;97400;1012;98.5
10366;2023;1;1;0;100;0;170000;1382;123
10367;2023;9;9;0;100;0;120944.444444444;1565.77777777778;85.8888888888889
10368;2023;10;10;0;100;0;166900;1995.9;89
10369;2023;1;1;0;100;0;45000;652;69
10370;2023;4;4;0;100;0;117075;988;105.25
10371;2023;3;3;0;100;0;107356.666666667;1435;75.3333333333333
10372;2023;2;2;0;100;0;147250;1217.5;121
10373;2023;5;5;0;100;0;258554;1670.6;172.6
10374;2023;1;1;0;100;0;85000;1076;79
10375;2023;2;2;0;100;0;172300;1914.5;87.5
10378;2023;1;1;0;100;0;50800;591;86
10379;2023;5;5;0;100;0;152319;1400;121
10381;2023;7;7;0;100;0;273771.428571429;2171.28571428571;133.857142857143
10382;2023;9;9;0;100;0;142441;1483.33333333333;98.8888888888889
10383;2023;3;3;0;100;0;170000;1942;154.333333333333
10386;2023;2;2;0;100;0;78000;835.5;95
10387;2023;1040;202;838;19.4230769230769;80.5769230769231;121757.193269231;1877.075;65.7086538461539
10389;2023;2;2;0;100;0;104000;845;117
10390;2023;1;1;0;100;0;67800;770;88
10391;2023;4;4;0;100;0;165730;1688.5;99.75
10392;2023;4;4;0;100;0;122500;1571.5;79
10393;2023;1;1;0;100;0;122000;1099;111
10394;2023;1;1;0;100;0;105000;1050;100
10395;2023;4;4;0;100;0;83750;593.25;131.25
10396;2023;6;6;0;100;0;178221.666666667;1247.16666666667;136.666666666667
10397;2023;1;1;0;100;0;106210;966;110
10398;2023;1;1;0;100;0;90000;1200;75
10399;2023;5;5;0;100;0;205843;1693.2;121.4
10400;2023;1;1;0;100;0;115000;1402;82
10401;2023;23;21;2;91.304347826087;8.69565217391304;122271.739130435;1195.78260869565;101.130434782609
10402;2023;4;4;0;100;0;212625;1641.5;128.75
10405;2023;2;2;0;100;0;158000;1680.5;94
10406;2023;17;17;0;100;0;200370.588235294;2075.76470588235;97.6470588235294
10409;2023;5;5;0;100;0;268200;2350;111.6
10410;2023;2;2;0;100;0;91500;933;97.5
10411;2023;1;1;0;100;0;50000;595;84
10412;2023;6;6;0;100;0;193889.666666667;2088.66666666667;104.5
10414;2023;2;2;0;100;0;329800;2060.5;164.5
10416;2023;4;4;0;100;0;222507.5;1919.25;114
10417;2023;3;3;0;100;0;196000;1571.66666666667;135
10418;2023;1;1;0;100;0;40000;625;64
10419;2023;4;4;0;100;0;135000;1311.75;96.75
10420;2023;28;27;1;96.4285714285714;3.57142857142857;127480.821428571;1541.32142857143;85.0357142857143
10421;2023;1;1;0;100;0;68000;850;80
10422;2023;3;3;0;100;0;80000;711.666666666667;102.666666666667
10423;2023;4;4;0;100;0;133750;1121.25;110.5
10424;2023;2;2;0;100;0;70174.5;802.5;88
10425;2023;4;4;0;100;0;196250;1498.5;134.75
10426;2023;6;5;1;83.3333333333333;16.6666666666667;70083.3333333333;851.166666666667;81.8333333333333
10427;2023;2;2;0;100;0;71765;1407.5;53
10428;2023;1;1;0;100;0;70000;588;119
10429;2023;2;2;0;100;0;149000;1646.5;90.5
10430;2023;1;1;0;100;0;260000;1256;207
10431;2023;3;3;0;100;0;119416.666666667;1299;103.666666666667
10433;2023;1;1;0;100;0;35000;897;39
10434;2023;1;1;0;100;0;299000;3987;75
10435;2023;1;1;0;100;0;130000;1625;80
10436;2023;2;2;0;100;0;144800;1556;94
10437;2023;4;4;0;100;0;94757.5;1454.25;70.75
10438;2023;2;2;0;100;0;38500;523.5;72.5
10441;2023;2;2;0;100;0;143500;1182.5;133
10442;2023;5;5;0;100;0;121400;1128;115
10443;2023;1;1;0;100;0;65000;867;75
10444;2023;2;2;0;100;0;147750;1172.5;125.5
11001;2023;13;13;0;100;0;123273.076923077;1068.38461538462;119.461538461538
11002;2023;2;2;0;100;0;132850;1644.5;81
11003;2023;2;2;0;100;0;163000;1466.5;120
11004;2023;6;6;0;100;0;156833.333333333;1422;111.833333333333
11005;2023;15;15;0;100;0;218251.266666667;1971.73333333333;110.4
11006;2023;1;1;0;100;0;237750;3835;62
11007;2023;3;3;0;100;0;122283.333333333;1255.33333333333;85
11008;2023;11;11;0;100;0;226374.545454545;1358.72727272727;164.545454545455
11009;2023;22;15;7;68.1818181818182;31.8181818181818;128281.363636364;1314.31818181818;101.090909090909
11010;2023;5;5;0;100;0;114464;1029.2;119.2
11011;2023;7;6;1;85.7142857142857;14.2857142857143;243242.857142857;3786.28571428571;70.4285714285714
11012;2023;39;39;0;100;0;211843.538461538;2086.53846153846;100.487179487179
11013;2023;5;5;0;100;0;168950;1785;90
11014;2023;12;12;0;100;0;206045.833333333;2309.75;91.0833333333333
11015;2023;5;5;0;100;0;134856;1293.4;102.4
11016;2023;4;4;0;100;0;45863.75;808.25;58.75
11017;2023;1;1;0;100;0;35000;422;83
11018;2023;12;12;0;100;0;113988.083333333;1047;117.333333333333
11019;2023;1;1;0;100;0;56165;598;94
11020;2023;2;2;0;100;0;304031.5;2227;125
11021;2023;14;13;1;92.8571428571429;7.14285714285714;96663.5714285714;1132.92857142857;94.0714285714286
11022;2023;28;21;7;75;25;99652.5714285714;1245.17857142857;86.8214285714286
11023;2023;13;12;1;92.3076923076923;7.69230769230769;199238.461538462;1795.46153846154;105.076923076923
11024;2023;14;14;0;100;0;265573.928571429;2623.92857142857;106.5
11025;2023;12;12;0;100;0;138758.333333333;1357;97.8333333333333
11027;2023;8;8;0;100;0;139333.75;1155.5;129.625
11028;2023;8;8;0;100;0;151762.5;1566.375;96.125
11029;2023;1;1;0;100;0;332000;3255;102
11031;2023;1;1;0;100;0;62850;1048;60
11032;2023;3;3;0;100;0;62373.3333333333;800.666666666667;78.3333333333333
11033;2023;17;17;0;100;0;138097.117647059;1507.35294117647;95.2941176470588
11034;2023;15;15;0;100;0;162810.466666667;1591.66666666667;102.2
11035;2023;4;4;0;100;0;193872;1616.5;120.5
11036;2023;4;4;0;100;0;76080;1112.5;70.5
11037;2023;7;3;4;42.8571428571429;57.1428571428571;97900;1453.57142857143;61.4285714285714
11038;2023;1;1;0;100;0;156200;1882;83
11040;2023;20;19;1;95;5;137681;1474.35;97.95
11041;2023;23;23;0;100;0;182381.739130435;2032.30434782609;93.2173913043478
11042;2023;4;4;0;100;0;124250;1661.25;82
11043;2023;4;4;0;100;0;45247.5;756;61
11044;2023;2;2;0;100;0;135855;1448;100
11045;2023;1;1;0;100;0;125000;1359;92
11046;2023;1;1;0;100;0;358510;1675;214
11047;2023;4;4;0;100;0;58285;805.25;73.75
11048;2023;16;16;0;100;0;144365.625;1420.625;94
11049;2023;41;36;5;87.8048780487805;12.1951219512195;158020.365853659;1429.12195121951;115.317073170732
11051;2023;3;3;0;100;0;266266.666666667;1756.33333333333;152.666666666667
11052;2023;5;5;0;100;0;191118.8;2051.8;96.4
11053;2023;7;7;0;100;0;230907.142857143;1937.71428571429;111.714285714286
11054;2023;2;2;0;100;0;94250;778.5;104.5
11055;2023;3;3;0;100;0;276333.333333333;1881.66666666667;103.666666666667
11056;2023;8;8;0;100;0;112156.25;1455.5;87.25
11058;2023;8;8;0;100;0;261186.25;2093.5;109.875
11059;2023;1;1;0;100;0;449900;2631;171
11060;2023;1;1;0;100;0;105000;1010;104
11061;2023;8;8;0;100;0;135300;1436.75;94.375
11063;2023;7;6;1;85.7142857142857;14.2857142857143;99488;1265.42857142857;79.1428571428571
11064;2023;13;13;0;100;0;134307.692307692;1274.92307692308;112.153846153846
11065;2023;2;2;0;100;0;82500;1121.5;77.5
11066;2023;8;8;0;100;0;146437.5;2082.75;83.75
11067;2023;29;29;0;100;0;208741.068965517;2074.51724137931;100.206896551724
11068;2023;19;18;1;94.7368421052632;5.26315789473684;127186.315789474;1306.36842105263;97.6315789473684
11069;2023;870;474;396;54.4827586206897;45.5172413793103;131881.974712644;1552.98390804598;82.2712643678161
11070;2023;10;10;0;100;0;174293;1600.9;103.4
11071;2023;8;8;0;100;0;161136.25;1605.375;99.25
11072;2023;3;3;0;100;0;139166.666666667;1181;119.666666666667
11074;2023;1;1;0;100;0;210876;2603;81
11075;2023;4;4;0;100;0;85521;1427.75;61.25
11076;2023;164;113;51;68.9024390243902;31.0975609756098;134119.804878049;1640.51219512195;84.2439024390244
11077;2023;13;13;0;100;0;152069.769230769;1217.23076923077;110.538461538462
11078;2023;4;4;0;100;0;171500;1777.5;94
11079;2023;3;2;1;66.6666666666667;33.3333333333333;107333.333333333;1268;66.3333333333333
11081;2023;21;20;1;95.2380952380952;4.76190476190476;119917.19047619;1420.7619047619;84.9047619047619
11084;2023;11;11;0;100;0;197495.454545455;1827.27272727273;107.090909090909
11085;2023;7;7;0;100;0;183232.857142857;2037.85714285714;88.5714285714286
11086;2023;8;7;1;87.5;12.5;199323.875;2411.5;79.5
11087;2023;1;1;0;100;0;155885;2834;55
11088;2023;17;17;0;100;0;153165.882352941;1485.23529411765;100.176470588235
11089;2023;5;5;0;100;0;141151.4;1229.8;108
11090;2023;3;3;0;100;0;189833.333333333;1833.66666666667;106
11091;2023;17;12;5;70.5882352941177;29.4117647058824;113780.588235294;1379.88235294118;82.7058823529412
11092;2023;1;1;0;100;0;30000;469;64
11093;2023;1;1;0;100;0;37500;872;43
11094;2023;3;3;0;100;0;228000;1489;143.333333333333
11095;2023;3;3;0;100;0;172293.333333333;1321.33333333333;129.333333333333
11096;2023;4;4;0;100;0;81687.5;921.75;87.25
11098;2023;18;18;0;100;0;167304.388888889;1732.55555555556;91.6111111111111
11099;2023;40;39;1;97.5;2.5;167905.3;1652.3;98
11101;2023;1;1;0;100;0;138614;2390;58
11102;2023;5;5;0;100;0;144362;1232.4;109.4
11103;2023;22;21;1;95.4545454545455;4.54545454545455;119263.636363636;1039.27272727273;110.590909090909
11104;2023;2;2;0;100;0;46370;765;56
11105;2023;5;5;0;100;0;155580;1896.8;79.6
11106;2023;107;94;13;87.8504672897196;12.1495327102804;150673.691588785;1837.28037383178;83.2523364485981
11110;2023;4;4;0;100;0;90725;1573;50.25
11111;2023;6;6;0;100;0;256413.333333333;2370.5;111.333333333333
11112;2023;3;3;0;100;0;118000;1419.66666666667;73.6666666666667
11113;2023;3;3;0;100;0;120000;1678;55.6666666666667
11115;2023;14;13;1;92.8571428571429;7.14285714285714;156968.928571429;1766.85714285714;96.3571428571429
11116;2023;98;54;44;55.1020408163265;44.8979591836735;115103.602040816;1863.05102040816;65.3163265306122
11117;2023;4;4;0;100;0;129675;1583.5;82.25
11119;2023;3;3;0;100;0;180000;1315.33333333333;116
11120;2023;3;3;0;100;0;120993.333333333;1176.66666666667;101.333333333333
11121;2023;2;2;0;100;0;205300;1200.5;168
11122;2023;14;14;0;100;0;120944.285714286;1426.57142857143;82.4285714285714
11123;2023;1;1;0;100;0;71600;1085;66
11124;2023;9;7;2;77.7777777777778;22.2222222222222;169883.333333333;2092.33333333333;82.4444444444444
11125;2023;5;5;0;100;0;169524;1960.6;93.8
11126;2023;5;5;0;100;0;161530.4;1633.4;97.2
11127;2023;4;4;0;100;0;118500;1972;81.25
11128;2023;1;1;0;100;0;310000;2214;140
11129;2023;35;32;3;91.4285714285714;8.57142857142857;91431.1714285714;1114.14285714286;86.9428571428571
11130;2023;7;7;0;100;0;125285.714285714;1401.42857142857;88.8571428571429
11131;2023;8;8;0;100;0;101941.625;825.625;120.25
11132;2023;24;23;1;95.8333333333333;4.16666666666667;166609.208333333;1735.95833333333;81.7083333333333
11133;2023;1;1;0;100;0;265000;5761;46
11135;2023;2;2;0;100;0;72566;697.5;105.5
11136;2023;5;5;0;100;0;161840;1441.4;123.8
11137;2023;1;1;0;100;0;232800;1164;200
11138;2023;10;9;1;90;10;222570;1827.3;120.8
11139;2023;2;2;0;100;0;321250;1376;213.5
11140;2023;21;21;0;100;0;154734.523809524;1647.04761904762;100.666666666667
11141;2023;2;2;0;100;0;69000;925.5;75.5
11142;2023;2;2;0;100;0;175750;1229;142
11144;2023;49;32;17;65.3061224489796;34.6938775510204;196572.816326531;2486.22448979592;79.5714285714286
11145;2023;332;173;159;52.1084337349398;47.8915662650602;143432.153614458;3631.29518072289;43.1777108433735
11146;2023;7;7;0;100;0;143331.428571429;1610;83.8571428571429
11147;2023;2;2;0;100;0;36000;1006;44
11148;2023;5;5;0;100;0;179000;1624;97.8
11150;2023;8;6;2;75;25;110418.5;1363.25;83.5
11151;2023;5;5;0;100;0;141410;1603.6;85.4
11152;2023;8;8;0;100;0;119887.5;1408.5;88.125
11153;2023;5;5;0;100;0;204080;1618;137
11154;2023;1;1;0;100;0;88400;1133;78
11156;2023;2;2;0;100;0;110000;1052;100
11157;2023;7;6;1;85.7142857142857;14.2857142857143;129472.571428571;1335.14285714286;114.428571428571
11158;2023;6;6;0;100;0;159168.333333333;1738.66666666667;81.6666666666667
11159;2023;1;1;0;100;0;99000;1238;80
11160;2023;2;2;0;100;0;96750;1414.5;79
11161;2023;2;2;0;100;0;259900;1753;148.5
11162;2023;1;1;0;100;0;75000;595;126
11163;2023;1;1;0;100;0;129000;1290;100
11164;2023;18;18;0;100;0;245961.055555556;2188.77777777778;110.222222222222
11165;2023;2;2;0;100;0;128039;1378;93
11168;2023;2;2;0;100;0;179940;1439.5;122.5
11169;2023;1;1;0;100;0;315000;1969;160
11170;2023;381;148;233;38.8451443569554;61.1548556430446;158181.540682415;4191.8530183727;37.9186351706037
11172;2023;24;21;3;87.5;12.5;124757.541666667;1795.75;72.8333333333333
11173;2023;2;2;0;100;0;245000;1771;135
11175;2023;4;4;0;100;0;247106.25;1776.75;144.25
11176;2023;3;3;0;100;0;206666.666666667;1457;119.333333333333
11177;2023;2;2;0;100;0;51320;720.5;73.5
11178;2023;14;14;0;100;0;170196.428571429;1960;95.2142857142857
11179;2023;2;2;0;100;0;97870.5;870;116
11180;2023;1;1;0;100;0;140000;1346;104
11181;2023;8;8;0;100;0;191645;1888.5;94.625
11182;2023;5;5;0;100;0;102786;1527.8;67.2
11183;2023;2;2;0;100;0;176360;1108.5;137.5
11184;2023;2;2;0;100;0;179734;1633.5;99.5
11185;2023;14;12;2;85.7142857142857;14.2857142857143;206537.857142857;2054.42857142857;105.571428571429
11186;2023;3;3;0;100;0;107266.666666667;965.333333333333;95.3333333333333
11187;2023;5;5;0;100;0;119287;1710.2;69.6
11188;2023;26;26;0;100;0;263478.846153846;2479.5;114.423076923077
11189;2023;3;3;0;100;0;99458.6666666667;1097.33333333333;79.3333333333333
11190;2023;25;23;2;92;8;144581.8;1452.6;95.44
11191;2023;1;1;0;100;0;61000;762;80
11192;2023;7;7;0;100;0;157983.571428571;1967;89.7142857142857
11193;2023;4;4;0;100;0;196221.25;1387.25;144
11194;2023;3;3;0;100;0;105880;1211;87.6666666666667
11195;2023;5;5;0;100;0;182970;1975;89.6
11196;2023;7;7;0;100;0;127905.714285714;1159;103
11197;2023;8;8;0;100;0;179431.25;1653;124.875
11198;2023;18;18;0;100;0;157445.555555556;1743.33333333333;91.2222222222222
11199;2023;14;14;0;100;0;214837.5;2071.78571428571;105
11200;2023;5;5;0;100;0;128904;2493.4;68.2
11201;2023;10;10;0;100;0;187643.5;1698.9;111.1
11202;2023;497;167;330;33.6016096579477;66.3983903420523;141951.800804829;3738.45472837022;36.9657947686117
11203;2023;154;111;43;72.0779220779221;27.9220779220779;153528.350649351;1741.11688311688;87.448051948052
11205;2023;4;4;0;100;0;112465.75;1387;87.75
11206;2023;135;111;24;82.2222222222222;17.7777777777778;149270.933333333;1639.35555555556;90.0740740740741
11207;2023;8;8;0;100;0;245434.375;1821.625;139.25
11209;2023;7;7;0;100;0;81842.8571428571;889;91.1428571428571
11210;2023;22;21;1;95.4545454545455;4.54545454545455;219328.954545455;2013.72727272727;106.363636363636
11211;2023;7;7;0;100;0;167743.571428571;1348.71428571429;135.571428571429
11212;2023;8;8;0;100;0;149967.5;1881.625;78.625
11214;2023;7;7;0;100;0;223775;1876;114.571428571429
11215;2023;9;9;0;100;0;235205.555555556;2005.88888888889;113.666666666667
11216;2023;11;10;1;90.9090909090909;9.09090909090909;211890.363636364;1836.90909090909;105.636363636364
11217;2023;19;18;1;94.7368421052632;5.26315789473684;185320.736842105;1934.15789473684;95.3157894736842
11218;2023;1;1;0;100;0;163500;1924;85
11219;2023;1;1;0;100;0;38000;884;43
11220;2023;8;8;0;100;0;161409.375;1440.25;121.375
11221;2023;5;5;0;100;0;118580;1231.4;98.4
11222;2023;6;6;0;100;0;98861.6666666667;1210.66666666667;69.1666666666667
11225;2023;14;13;1;92.8571428571429;7.14285714285714;165461.071428571;1687.28571428571;101.5
11226;2023;3;3;0;100;0;189713.333333333;1804.66666666667;108.333333333333
11228;2023;1;1;0;100;0;170000;1181;144
11229;2023;4;4;0;100;0;61250;715;86.25
11231;2023;1;1;0;100;0;25000;962;26
11233;2023;14;13;1;92.8571428571429;7.14285714285714;304637.142857143;2407.71428571429;121.357142857143
11234;2023;1;1;0;100;0;240000;1395;172
11235;2023;2;2;0;100;0;65000;670.5;102
11236;2023;3;3;0;100;0;173323.333333333;1606.33333333333;114
11238;2023;5;5;0;100;0;169230;1548.2;113
11240;2023;12;12;0;100;0;132921.666666667;1464.83333333333;95.6666666666667
11241;2023;7;7;0;100;0;170192.857142857;1620.85714285714;105.857142857143
11242;2023;2;2;0;100;0;238275;1932;120
11243;2023;7;7;0;100;0;218993.142857143;2667.42857142857;84.5714285714286
11244;2023;4;4;0;100;0;79250;1065.25;75
11245;2023;1;1;0;100;0;20000;625;32
11247;2023;1;1;0;100;0;230900;2309;100
11249;2023;3;3;0;100;0;71300;1004.33333333333;74
11251;2023;12;12;0;100;0;129680;1235.33333333333;110.75
11252;2023;6;6;0;100;0;194833.5;1768.83333333333;110.333333333333
11253;2023;11;11;0;100;0;176079.090909091;1670.09090909091;105.909090909091
11254;2023;27;25;2;92.5925925925926;7.40740740740741;158124.074074074;1718.14814814815;93.3703703703704
11255;2023;12;11;1;91.6666666666667;8.33333333333333;203509.333333333;2177.16666666667;95.5
11256;2023;9;9;0;100;0;186363.111111111;2100.88888888889;88.6666666666667
11257;2023;1;1;0;100;0;56000;571;98
11258;2023;30;29;1;96.6666666666667;3.33333333333333;209788.666666667;2274.86666666667;89.5333333333333
11259;2023;9;9;0;100;0;186635.111111111;1893.77777777778;101.666666666667
11260;2023;2;2;0;100;0;58230;591.5;88
11261;2023;6;5;1;83.3333333333333;16.6666666666667;141796.666666667;1576;81.6666666666667
11262;2023;1086;363;723;33.4254143646409;66.5745856353591;172423.484346225;2546.90883977901;68.2145488029466
11263;2023;5;5;0;100;0;130624;1898.8;73
11264;2023;18;18;0;100;0;214483.333333333;2073.83333333333;104.888888888889
11265;2023;2;2;0;100;0;102277.5;1141;92.5
11266;2023;217;87;130;40.0921658986175;59.9078341013825;132186.792626728;2729.10599078341;51.741935483871
11267;2023;22;20;2;90.9090909090909;9.09090909090909;212628.181818182;2056.54545454545;93.5909090909091
11268;2023;2;2;0;100;0;246210;1454.5;172
11269;2023;35;34;1;97.1428571428571;2.85714285714286;178597.2;1760;100.028571428571
11270;2023;2;2;0;100;0;34500;700.5;53.5
11271;2023;1;1;0;100;0;83580;1114;75
11272;2023;26;26;0;100;0;256728.846153846;2261.57692307692;112.153846153846
11273;2023;8;7;1;87.5;12.5;197925.625;2110.25;98
11274;2023;3;3;0;100;0;200175;1755;108.666666666667
11275;2023;1;1;0;100;0;155000;1314;118
11276;2023;12;12;0;100;0;88257.5;993.75;84.25
11277;2023;1;1;0;100;0;125000;2500;50
11278;2023;3;3;0;100;0;128925.666666667;1415.66666666667;92.3333333333333
11279;2023;44;43;1;97.7272727272727;2.27272727272727;184174.659090909;1807.70454545455;100.477272727273
11280;2023;23;23;0;100;0;149185.47826087;1650.73913043478;93.3478260869565
11281;2023;21;21;0;100;0;122285.714285714;1468.09523809524;81.6190476190476
11282;2023;2;2;0;100;0;88500;1041.5;88.5
11285;2023;25;25;0;100;0;326340.44;3407.84;97.64
11286;2023;16;16;0;100;0;125487.5;1428.5625;92
11288;2023;22;21;1;95.4545454545455;4.54545454545455;140959.090909091;1599.68181818182;86.0909090909091
11289;2023;22;22;0;100;0;148326.136363636;1518.95454545455;104.454545454545
11290;2023;1;1;0;100;0;89500;663;135
11292;2023;1;1;0;100;0;535000;1783;300
11293;2023;8;8;0;100;0;172926.25;1753.25;100.375
11295;2023;20;17;3;85;15;168132.2;1705.75;104.5
11296;2023;12;12;0;100;0;261662.5;2527;100.583333333333
11297;2023;5;5;0;100;0;135690;1618.2;96.6
11299;2023;10;10;0;100;0;106390;1251.5;81.6
11300;2023;2;2;0;100;0;232500;1573.5;148.5
11301;2023;15;14;1;93.3333333333333;6.66666666666667;159724.666666667;1606.26666666667;98.3333333333333
11302;2023;8;7;1;87.5;12.5;113375;1910.5;79.875
11303;2023;17;16;1;94.1176470588235;5.88235294117647;154601.764705882;1453.05882352941;110.117647058824
11304;2023;73;66;7;90.4109589041096;9.58904109589041;103736.726027397;1230.95890410959;86.027397260274
11307;2023;3;3;0;100;0;234333.333333333;2275.33333333333;102.666666666667
11308;2023;5;5;0;100;0;149860;1816.6;85.6
11310;2023;10;1;9;10;90;29792.1;1138.7;24.9
11311;2023;9;9;0;100;0;153592.222222222;1462.55555555556;106.555555555556
11312;2023;1;1;0;100;0;90000;652;138
11313;2023;5;5;0;100;0;201836;2427.6;81
11314;2023;3;3;0;100;0;113463.333333333;1573.33333333333;73
11315;2023;35;35;0;100;0;141342.285714286;1506.08571428571;95.8
11316;2023;3;3;0;100;0;72000;720;100
11317;2023;2;2;0;100;0;63785;891;78.5
11318;2023;1;1;0;100;0;329475;2441;135
11320;2023;4;4;0;100;0;57750;655.75;85.5
11321;2023;3;3;0;100;0;118291.666666667;1309;91.3333333333333
11322;2023;19;19;0;100;0;322563.842105263;2677.21052631579;109.368421052632
11323;2023;5;5;0;100;0;98190;1312.4;77.6
11324;2023;9;9;0;100;0;136433.222222222;1212.44444444444;125.111111111111
11325;2023;6;6;0;100;0;171083.333333333;1512.16666666667;100.666666666667
11327;2023;6;6;0;100;0;204701.666666667;1890.66666666667;111
11328;2023;4;4;0;100;0;130125;1135.25;114
11330;2023;6;6;0;100;0;167740.5;1618.16666666667;100.833333333333
11331;2023;1;1;0;100;0;50000;625;80
11332;2023;17;17;0;100;0;210326.470588235;2088.11764705882;97.1176470588235
11334;2023;1;1;0;100;0;142000;2536;56
11335;2023;2;2;0;100;0;54120;801.5;70
11336;2023;7;7;0;100;0;88223.5714285714;799.285714285714;114.571428571429
11337;2023;8;8;0;100;0;90556.25;1224;79
11338;2023;1;1;0;100;0;110000;917;120
11339;2023;9;9;0;100;0;182538.888888889;1466.22222222222;124.888888888889
11340;2023;3;3;0;100;0;229500;1734.33333333333;133
11341;2023;2;2;0;100;0;90820;1725.5;58.5
11342;2023;5;5;0;100;0;117500;1208.4;91.6
11343;2023;1;1;0;100;0;264412;2938;90
11344;2023;11;11;0;100;0;110337.272727273;1133.27272727273;97.9090909090909
11345;2023;4;4;0;100;0;209781.25;2657.75;75.25
11347;2023;2;2;0;100;0;92000;971;90.5
11348;2023;2;2;0;100;0;125500;1444;70
11350;2023;1;1;0;100;0;25761;1610;16
11351;2023;14;14;0;100;0;137570.714285714;1296.57142857143;100.142857142857
11353;2023;29;28;1;96.551724137931;3.44827586206897;172062.068965517;1887.44827586207;86.7586206896552
11354;2023;1;1;0;100;0;90000;1385;65
11355;2023;6;6;0;100;0;155958.333333333;1246.66666666667;114.166666666667
11356;2023;12;12;0;100;0;173687.5;1654.75;104.166666666667
11357;2023;1;1;0;100;0;114000;1086;105
11358;2023;2;2;0;100;0;35000;875;39
11359;2023;6;5;1;83.3333333333333;16.6666666666667;161191.666666667;2174.83333333333;81.5
11360;2023;32;30;2;93.75;6.25;222654.375;2257;98.90625
11361;2023;8;7;1;87.5;12.5;170232.5;1360.25;125
11362;2023;2;2;0;100;0;155000;1354;112
11363;2023;1;1;0;100;0;2,00E+05;1980;101
11364;2023;1;1;0;100;0;80000;1455;55
11366;2023;7;7;0;100;0;187723.571428571;2060.28571428571;91.4285714285714
11367;2023;15;15;0;100;0;98163.5333333333;1227.73333333333;79.4
11368;2023;4;4;0;100;0;130350;1522.75;88.25
11369;2023;33;33;0;100;0;233972.909090909;2399.84848484848;100.787878787879
11370;2023;63;59;4;93.6507936507936;6.34920634920635;223670.746031746;2416.14285714286;91.8571428571429
11371;2023;8;8;0;100;0;150974.5;1702.375;91
11372;2023;9;9;0;100;0;94938.8888888889;884.777777777778;103.444444444444
11373;2023;3;3;0;100;0;55416.6666666667;625;87
11374;2023;1;1;0;100;0;75000;987;76
11375;2023;1;1;0;100;0;140000;1077;130
11376;2023;2;2;0;100;0;237500;1712;143.5
11377;2023;1;1;0;100;0;64800;1178;55
11378;2023;5;5;0;100;0;116282.8;1006.4;128.8
11379;2023;103;88;15;85.4368932038835;14.5631067961165;179037.368932039;2072.20388349515;88.4174757281553
11381;2023;2;2;0;100;0;488850;3913.5;120
11382;2023;3;3;0;100;0;180833.333333333;2071.66666666667;87.6666666666667
11383;2023;2;2;0;100;0;217500;1948.5;111.5
11384;2023;2;2;0;100;0;70000;1417.5;52
11385;2023;1;1;0;100;0;79000;878;90
11386;2023;8;8;0;100;0;89631.25;1125.125;85.375
11387;2023;1;1;0;100;0;220000;3235;68
11388;2023;2;2;0;100;0;60000;1027;57.5
11389;2023;1;1;0;100;0;275000;2371;116
11390;2023;13;13;0;100;0;123761.384615385;1317.92307692308;100.538461538462
11392;2023;1;1;0;100;0;50000;556;90
11393;2023;8;8;0;100;0;150813.125;1672.75;93.875
11394;2023;3;3;0;100;0;260000;1840;141.666666666667
11396;2023;18;18;0;100;0;162653.555555556;1821.66666666667;97.6666666666667
11397;2023;69;64;5;92.7536231884058;7.2463768115942;144803.68115942;1525.66666666667;95.304347826087
11398;2023;2;2;0;100;0;142500;1336.5;105
11399;2023;3;3;0;100;0;116326.666666667;1394.66666666667;79.3333333333333
11400;2023;3;3;0;100;0;124833.333333333;1213.33333333333;106
11401;2023;16;15;1;93.75;6.25;96640;1308.4375;81.25
11402;2023;1;1;0;100;0;125000;1389;90
11404;2023;10;10;0;100;0;171595;1771.1;101
11405;2023;7;7;0;100;0;254251.428571429;2244;109.571428571429
11406;2023;1;1;0;100;0;250000;2381;105
11407;2023;4;4;0;100;0;135357.5;2570;85.25
11408;2023;7;7;0;100;0;131205.714285714;1362.28571428571;83.1428571428571
11409;2023;2;2;0;100;0;112750;1793;64
11410;2023;9;9;0;100;0;124154.111111111;1618;80.1111111111111
11411;2023;8;8;0;100;0;107680.25;1178.125;87.5
11412;2023;2;2;0;100;0;94910;838;120.5
11413;2023;3;3;0;100;0;103916.666666667;1087.33333333333;91
11416;2023;2;2;0;100;0;181850;2160.5;84.5
11417;2023;2;2;0;100;0;46500;1101;46.5
11418;2023;11;11;0;100;0;136177.272727273;1427.63636363636;99.1818181818182
11419;2023;1;1;0;100;0;178450;1767;101
11421;2023;6;6;0;100;0;190188.333333333;2611.5;75.5
11422;2023;3;3;0;100;0;284863.333333333;2358.33333333333;115
11423;2023;4;4;0;100;0;105250;1465.75;74.75
11424;2023;3;3;0;100;0;125333.333333333;1712;76.6666666666667
11425;2023;26;26;0;100;0;167434.423076923;1738.11538461538;94
11426;2023;22;21;1;95.4545454545455;4.54545454545455;148781.136363636;1727.90909090909;92
11427;2023;2;2;0;100;0;110140;1166.5;89.5
11428;2023;1;1;0;100;0;1,00E+05;926;108
11429;2023;68;63;5;92.6470588235294;7.35294117647059;231548.25;2059.26470588235;107.544117647059
11430;2023;10;10;0;100;0;197020.4;1638.2;119.1
11431;2023;5;5;0;100;0;90890;950.4;97
11432;2023;6;6;0;100;0;214516.166666667;1939.33333333333;105
11433;2023;13;13;0;100;0;135587.384615385;1479.61538461538;88.8461538461538
11434;2023;12;12;0;100;0;128591.666666667;1500.91666666667;88.75
11435;2023;6;6;0;100;0;130908.333333333;1096.5;115.833333333333
11436;2023;6;6;0;100;0;105463.333333333;1346.66666666667;75
11437;2023;10;10;0;100;0;154315;1803.7;85.4
11438;2023;4;4;0;100;0;181800;1980.25;91.5
11439;2023;7;7;0;100;0;102121.428571429;1309.14285714286;75.7142857142857
11441;2023;38;33;5;86.8421052631579;13.1578947368421;225477.842105263;2427.55263157895;94.5263157894737
12001;2023;9;9;0;100;0;256681.111111111;2821.88888888889;97.8888888888889
12002;2023;6;5;1;83.3333333333333;16.6666666666667;183191.666666667;2081.16666666667;93.1666666666667
12003;2023;5;5;0;100;0;88380.4;953;86.8
12006;2023;4;4;0;100;0;94553.25;1055;87.25
12008;2023;9;9;0;100;0;104583.333333333;1404.44444444444;66.6666666666667
12009;2023;2;2;0;100;0;61423.5;1070;58
12010;2023;2;2;0;100;0;108600;1068;101
12011;2023;11;11;0;100;0;118632.727272727;1696.18181818182;99.3636363636364
12012;2023;4;4;0;100;0;151250;1435.5;106.75
12013;2023;47;45;2;95.7446808510638;4.25531914893617;99564;1202.89361702128;85.9574468085106
12015;2023;1;1;0;100;0;110000;1100;100
12016;2023;14;13;1;92.8571428571429;7.14285714285714;116653.571428571;1431.71428571429;85.8571428571429
12017;2023;2;2;0;100;0;179360;2148.5;71
12018;2023;4;4;0;100;0;209000;2477.75;103
12021;2023;11;11;0;100;0;161522.363636364;2158.45454545455;87.0909090909091
12023;2023;1;1;0;100;0;80000;620;129
12024;2023;1;1;0;100;0;71400;1152;62
12025;2023;7;4;3;57.1428571428571;42.8571428571429;84900;1067.57142857143;78.7142857142857
12026;2023;10;10;0;100;0;157748;1689.8;97.8
12027;2023;1;1;0;100;0;132970;1847;72
12028;2023;5;3;2;60;40;93744.4;1018.8;91
12029;2023;3;3;0;100;0;74766.6666666667;1257.66666666667;64
12030;2023;6;6;0;100;0;119500;1247.33333333333;95.3333333333333
12031;2023;6;6;0;100;0;74341.6666666667;1078.5;69
12032;2023;5;5;0;100;0;92580;1081.6;85.8
12033;2023;21;17;4;80.9523809523809;19.047619047619;187217.428571429;2171.71428571429;101.619047619048
12034;2023;3;3;0;100;0;131833.333333333;948;135
12035;2023;3;3;0;100;0;87650;1289.66666666667;69.3333333333333
12036;2023;8;7;1;87.5;12.5;97625;1112.75;89.75
12037;2023;9;9;0;100;0;126869.444444444;2088.77777777778;74.7777777777778
12038;2023;5;5;0;100;0;146216;2022.2;88.8
12039;2023;8;8;0;100;0;58830.125;782.75;80.625
12041;2023;3;3;0;100;0;202108.333333333;1233.33333333333;145
12042;2023;1;1;0;100;0;60000;492;122
12043;2023;16;16;0;100;0;246880;2364.1875;102.1875
12044;2023;13;10;3;76.9230769230769;23.0769230769231;72741.5384615385;1238.61538461538;66.9230769230769
12045;2023;3;3;0;100;0;253050;1731;172.333333333333
12046;2023;2;2;0;100;0;219400;2063;104.5
12047;2023;8;7;1;87.5;12.5;117390;1452.875;97
12048;2023;4;4;0;100;0;137700;1453.25;108
12049;2023;6;6;0;100;0;135025;1267.5;102.5
12050;2023;5;5;0;100;0;104085;1118;89.4
12051;2023;7;7;0;100;0;136542.857142857;1120.28571428571;108.142857142857
12052;2023;67;63;4;94.0298507462687;5.97014925373134;128686.014925373;1466.46268656716;91.3134328358209
12053;2023;1;1;0;100;0;142340;2093;68
12054;2023;6;6;0;100;0;162849.166666667;1731.83333333333;94.5
12055;2023;1;1;0;100;0;226400;2058;110
12056;2023;31;21;10;67.741935483871;32.258064516129;159728.419354839;1912.45161290323;86.5806451612903
12057;2023;7;7;0;100;0;78242.8571428571;840.857142857143;90.7142857142857
12059;2023;4;4;0;100;0;234677.5;2606.25;108.25
12060;2023;2;2;0;100;0;136000;1453.5;88
12061;2023;5;4;1;80;20;125020;1533;76.4
12062;2023;2;2;0;100;0;81500;1052;79
12063;2023;12;8;4;66.6666666666667;33.3333333333333;139418.166666667;1734.75;73.25
12064;2023;2;2;0;100;0;128055;1269;105.5
12065;2023;6;6;0;100;0;136208.333333333;1140.5;129.5
12066;2023;12;12;0;100;0;157401.416666667;1625.41666666667;95.5
12067;2023;1;1;0;100;0;102930;1225;84
12068;2023;7;7;0;100;0;120950.714285714;1087.71428571429;128.857142857143
12069;2023;3;3;0;100;0;150583.333333333;1918.33333333333;79.6666666666667
12070;2023;3;1;2;33.3333333333333;66.6666666666667;144998.333333333;1866.66666666667;95
12071;2023;4;4;0;100;0;199675.25;1738;126.25
12072;2023;2;2;0;100;0;126000;3212;95
12073;2023;8;8;0;100;0;126447.5;1300.875;88.625
12074;2023;4;4;0;100;0;105750;1048.5;105.5
12075;2023;2;2;0;100;0;134500;2456;51
12076;2023;14;12;2;85.7142857142857;14.2857142857143;158417.142857143;2016.64285714286;85.5
12077;2023;10;10;0;100;0;188847;1836.1;105.4
12079;2023;2;2;0;100;0;60625;673;90.5
12080;2023;1;1;0;100;0;45000;562;80
12082;2023;1;0;1;0;100;110000;2200;50
12083;2023;24;18;6;75;25;97934.875;1232.125;82.125
12084;2023;16;16;0;100;0;208837.5;2143.625;103.5
12085;2023;2;2;0;100;0;163225;3477;54.5
12086;2023;6;6;0;100;0;211750;2398;92.5
12088;2023;2;2;0;100;0;90700;1538;65.5
12089;2023;59;42;17;71.1864406779661;28.8135593220339;100745.338983051;1073.37288135593;94.9152542372881
12090;2023;19;19;0;100;0;175938.684210526;1871;94.1052631578947
12091;2023;1;1;0;100;0;1,00E+05;1250;80
12092;2023;4;4;0;100;0;99581.25;1091.5;79.5
12093;2023;6;6;0;100;0;234944.166666667;1698.66666666667;128.666666666667
12094;2023;13;7;6;53.8461538461538;46.1538461538462;82612.6923076923;1050.38461538462;69.5384615384615
12095;2023;3;3;0;100;0;188000;1778;108
12096;2023;81;35;46;43.2098765432099;56.7901234567901;134224.024691358;1706.53086419753;82
12097;2023;7;7;0;100;0;73865.4285714286;1258.14285714286;58.8571428571429
12098;2023;12;8;4;66.6666666666667;33.3333333333333;147445.833333333;1837.91666666667;100.083333333333
12099;2023;5;4;1;80;20;65906;710.6;110.4
12100;2023;33;32;1;96.969696969697;3.03030303030303;122461.666666667;1335.27272727273;95.5454545454545
12101;2023;4;4;0;100;0;57812.5;679.5;83
12102;2023;26;25;1;96.1538461538462;3.84615384615385;190019.230769231;1890.76923076923;101.846153846154
12103;2023;3;3;0;100;0;96460;1248.66666666667;98.6666666666667
12104;2023;3;3;0;100;0;165833.333333333;1884;88
12105;2023;12;12;0;100;0;204832.916666667;2012.66666666667;103.166666666667
12106;2023;10;10;0;100;0;152570.5;1459;101.2
12107;2023;5;5;0;100;0;90000;1653.6;55.2
12108;2023;5;5;0;100;0;235376.4;2320.8;110
12110;2023;9;9;0;100;0;106805.555555556;1533.33333333333;80.3333333333333
12111;2023;7;7;0;100;0;147192.857142857;1409;98.8571428571429
12113;2023;5;4;1;80;20;194631;1698;117.2
12115;2023;4;4;0;100;0;210150;1959;108.75
12118;2023;10;9;1;90;10;100393.5;1372.3;79
12119;2023;19;11;8;57.8947368421053;42.1052631578947;142085.105263158;1752.36842105263;76.7368421052632
12120;2023;26;20;6;76.9230769230769;23.0769230769231;190529.615384615;2197.57692307692;94.5769230769231
12121;2023;2;2;0;100;0;214014;1977;100
12122;2023;1;1;0;100;0;60000;833;72
12124;2023;3;3;0;100;0;96333.3333333333;1267;72
12125;2023;8;8;0;100;0;103450;1256.5;82.875
12127;2023;12;12;0;100;0;98590;1346.5;75.5
12128;2023;2;2;0;100;0;93250;1035;80
12129;2023;2;2;0;100;0;132302.5;1580;89
12130;2023;21;21;0;100;0;142655.952380952;1425.09523809524;99.9523809523809
12131;2023;5;4;1;80;20;250086;2247;112.8
12133;2023;49;33;16;67.3469387755102;32.6530612244898;192518.081632653;2388.85714285714;80.3877551020408
12135;2023;4;4;0;100;0;129000;1367.5;97
12136;2023;5;5;0;100;0;151160;1339.6;101.4
12137;2023;7;7;0;100;0;207214.285714286;2361.28571428571;86.2857142857143
12138;2023;16;14;2;87.5;12.5;219818.75;2055.6875;108.75
12139;2023;1;1;0;100;0;148150;2469;60
12140;2023;11;11;0;100;0;177143.454545455;1634.09090909091;105.090909090909
12141;2023;2;2;0;100;0;59250;1103.5;63
12142;2023;4;4;0;100;0;214075;1766.75;126.5
12143;2023;1;1;0;100;0;75000;1071;70
12144;2023;2;2;0;100;0;122025;1293.5;96
12145;2023;302;102;200;33.7748344370861;66.2251655629139;152275.19205298;2049.80463576159;73.5827814569536
12146;2023;30;22;8;73.3333333333333;26.6666666666667;204108.2;2252.33333333333;88.9333333333333
12147;2023;1;1;0;100;0;91100;1898;48
12148;2023;20;16;4;80;20;126517.5;1675.25;78.5
12149;2023;2;2;0;100;0;73100;2036.5;60
12150;2023;7;7;0;100;0;137457.857142857;1376.14285714286;89.5714285714286
12151;2023;8;8;0;100;0;142996.25;1887.625;82.375
12152;2023;1;1;0;100;0;123500;714;173
12153;2023;9;9;0;100;0;128257.777777778;1302.77777777778;95.5555555555556
12154;2023;5;4;1;80;20;106720;1573.2;69.4
12155;2023;10;9;1;90;10;119995.5;1308.4;98
12156;2023;4;4;0;100;0;218874;1699;118.75
12157;2023;14;14;0;100;0;202501.428571429;2075.35714285714;103.928571428571
12158;2023;4;4;0;100;0;102200;1621.75;73.75
12159;2023;6;6;0;100;0;157500.833333333;1373.66666666667;116.833333333333
12160;2023;2;2;0;100;0;80000;836;95.5
12161;2023;2;2;0;100;0;199414.5;2420;77.5
12162;2023;6;6;0;100;0;197410;1634;119.833333333333
12163;2023;3;3;0;100;0;69633.3333333333;833.333333333333;74.3333333333333
12164;2023;10;10;0;100;0;218510;1477.4;154.1
12165;2023;2;2;0;100;0;47500;958.5;52
12166;2023;2;2;0;100;0;119750;1102.5;109
12167;2023;10;10;0;100;0;160687.6;1807.8;93
12168;2023;22;19;3;86.3636363636364;13.6363636363636;132081.818181818;1652.95454545455;77.5
12169;2023;25;24;1;96;4;174760;1657.68;112.36
12170;2023;4;4;0;100;0;128375;1022.75;114.75
12171;2023;2;2;0;100;0;120000;1370;88
12172;2023;7;7;0;100;0;144042.857142857;1191.57142857143;112.285714285714
12174;2023;42;32;10;76.1904761904762;23.8095238095238;173124.142857143;2130.80952380952;85.5238095238095
12176;2023;154;68;86;44.1558441558442;55.8441558441558;168834.668831169;2227.38311688312;77.4805194805195
12177;2023;8;8;0;100;0;116598.75;1571;79.125
12178;2023;3;3;0;100;0;267400;2220.66666666667;126.666666666667
12179;2023;2;2;0;100;0;85000;1433.5;70
12180;2023;2;2;0;100;0;155000;1896.5;66.5
12181;2023;2;2;0;100;0;169350;1404.5;110.5
12182;2023;2;2;0;100;0;58750;1399;43
12183;2023;2;2;0;100;0;106615;1791;56
12184;2023;2;2;0;100;0;218925;2680;81
12185;2023;13;11;2;84.6153846153846;15.3846153846154;154484.615384615;2059;87.2307692307692
12186;2023;3;3;0;100;0;145400;1732.33333333333;83.3333333333333
12187;2023;12;9;3;75;25;101258.5;1818.33333333333;57.5833333333333
12188;2023;3;3;0;100;0;168433.333333333;2064.33333333333;83.6666666666667
12189;2023;6;6;0;100;0;166841.666666667;1386.83333333333;131.833333333333
12190;2023;2;2;0;100;0;155200;2073.5;81
12191;2023;5;5;0;100;0;196050;1471.8;125.6
12192;2023;1;1;0;100;0;60000;652;92
12193;2023;3;3;0;100;0;87416.6666666667;912.333333333333;97.3333333333333
12194;2023;6;6;0;100;0;287121.666666667;2016.16666666667;146.5
12195;2023;2;2;0;100;0;88350;1198;81
12197;2023;31;31;0;100;0;114406.451612903;1292.41935483871;91.9354838709677
12198;2023;20;19;1;95;5;130349;1335.85;93.75
12199;2023;20;12;8;60;40;116755.45;1850.6;60.65
12200;2023;12;12;0;100;0;162070.666666667;1840.91666666667;83.8333333333333
12201;2023;7;7;0;100;0;141124.285714286;1318.71428571429;95.5714285714286
12202;2023;484;67;417;13.8429752066116;86.1570247933884;141074.710743802;2161.17975206612;66.6425619834711
12203;2023;5;5;0;100;0;133698.6;1717.6;94
12204;2023;4;4;0;100;0;147125;1465.75;97.25
12205;2023;10;10;0;100;0;138125;1298.4;107.2
12206;2023;6;6;0;100;0;230800;1685.33333333333;129.666666666667
12207;2023;2;2;0;100;0;147505;1542;107.5
12208;2023;102;64;38;62.7450980392157;37.2549019607843;139280.196078431;1668.25490196078;86.5
12209;2023;10;10;0;100;0;117980;1302.8;90
12210;2023;5;5;0;100;0;148027.4;1437.6;100.8
12211;2023;1;1;0;100;0;98000;2178;45
12212;2023;3;3;0;100;0;94498.3333333333;1550;59.3333333333333
12213;2023;12;10;2;83.3333333333333;16.6666666666667;138633.666666667;1806.08333333333;83.1666666666667
12214;2023;8;6;2;75;25;199917.5;1815.75;109.875
12215;2023;11;10;1;90.9090909090909;9.09090909090909;200204.545454545;2237.27272727273;89
12216;2023;9;9;0;100;0;125888.888888889;1156.33333333333;108.888888888889
12217;2023;8;8;0;100;0;139306.25;1390.375;98.25
12219;2023;10;10;0;100;0;90528;1256.2;75.8
12220;2023;6;4;2;66.6666666666667;33.3333333333333;71595;1659.66666666667;53.1666666666667
12221;2023;4;4;0;100;0;131550;1759;79.75
12222;2023;7;5;2;71.4285714285714;28.5714285714286;91564.2857142857;985.714285714286;100.142857142857
12223;2023;21;21;0;100;0;107888.80952381;1176.71428571429;94.4285714285714
12224;2023;53;24;29;45.2830188679245;54.7169811320755;77492.2075471698;1421;56.377358490566
12225;2023;13;11;2;84.6153846153846;15.3846153846154;156511.538461538;1650.15384615385;102.615384615385
12226;2023;6;6;0;100;0;127930;1316.66666666667;103.333333333333
12227;2023;4;4;0;100;0;147000;1522;95.75
12228;2023;9;9;0;100;0;155672.222222222;1181.88888888889;119.111111111111
12229;2023;2;2;0;100;0;148500;1424.5;102
12230;2023;2;2;0;100;0;92500;1000;99
12231;2023;12;10;2;83.3333333333333;16.6666666666667;98728.3333333333;1355.33333333333;70.25
12232;2023;9;9;0;100;0;129816.666666667;1372;95.4444444444444
12233;2023;1;1;0;100;0;60000;500;120
12234;2023;9;9;0;100;0;134000;1496.66666666667;86.8888888888889
12235;2023;1;1;0;100;0;320000;1103;290
12236;2023;1;1;0;100;0;123130;1368;90
12237;2023;6;6;0;100;0;98416.6666666667;1128.33333333333;89
12238;2023;3;3;0;100;0;221678.333333333;2104.66666666667;106
12239;2023;2;2;0;100;0;171450;1916.5;89.5
12240;2023;6;6;0;100;0;144883.333333333;1411.16666666667;105
12241;2023;15;15;0;100;0;290737.666666667;2426.13333333333;118.266666666667
12242;2023;4;4;0;100;0;155760;1741;86.5
12243;2023;18;17;1;94.4444444444444;5.55555555555556;121539.444444444;1682.5;77.7777777777778
12244;2023;8;6;2;75;25;94136.25;1287;73
12246;2023;5;5;0;100;0;118080;1342.8;84.4
12247;2023;4;4;0;100;0;63100;872;80.25
12248;2023;4;4;0;100;0;62462.5;736;83
12249;2023;4;4;0;100;0;102837.25;1097;102
12250;2023;2;2;0;100;0;90000;2487;73.5
12251;2023;1;1;0;100;0;43000;717;60
12252;2023;10;10;0;100;0;206449.5;2023.6;111
12253;2023;23;19;4;82.6086956521739;17.3913043478261;157619.260869565;1804.08695652174;87.1739130434783
12254;2023;17;17;0;100;0;228131.470588235;2338.82352941176;108.470588235294
12255;2023;6;6;0;100;0;109100;1167.33333333333;103
12256;2023;3;3;0;100;0;200666.666666667;2058.33333333333;96
12257;2023;7;7;0;100;0;187911.857142857;1599.85714285714;111.428571428571
12258;2023;23;22;1;95.6521739130435;4.34782608695652;155533.652173913;1637.47826086957;96.8260869565217
12259;2023;7;7;0;100;0;178983.571428571;1662.28571428571;101.428571428571
12260;2023;2;2;0;100;0;98457.5;1234.5;84
12261;2023;1;1;0;100;0;144000;4114;35
12262;2023;11;11;0;100;0;117513.636363636;1237.54545454545;92.9090909090909
12263;2023;6;6;0;100;0;158506.666666667;1630;100.166666666667
12264;2023;34;30;4;88.2352941176471;11.7647058823529;238301.764705882;2343;102.588235294118
12265;2023;3;3;0;100;0;135000;958;130.666666666667
12266;2023;3;3;0;100;0;133716.666666667;1033.66666666667;133.333333333333
12267;2023;5;5;0;100;0;85152;1125.8;79.8
12268;2023;4;4;0;100;0;58425;935;63
12269;2023;1;1;0;100;0;245400;1363;180
12270;2023;48;42;6;87.5;12.5;121013.645833333;1420.91666666667;85.75
12272;2023;2;2;0;100;0;176631;1603.5;105.5
12273;2023;4;4;0;100;0;163537.5;1755.5;100.5
12274;2023;1;1;0;100;0;35000;603;58
12277;2023;1;1;0;100;0;201400;2238;90
12278;2023;1;1;0;100;0;24000;500;48
12280;2023;6;6;0;100;0;102058.333333333;1180.16666666667;99.1666666666667
12281;2023;3;3;0;100;0;158266.666666667;1732.33333333333;92
12282;2023;6;6;0;100;0;118000;1438;79.5
12283;2023;3;3;0;100;0;143771.666666667;1742.33333333333;78
12284;2023;4;4;0;100;0;130287.5;1083;120
12286;2023;12;12;0;100;0;160888.666666667;1591.91666666667;105.083333333333
12287;2023;5;5;0;100;0;140710;1426.2;90.6
12288;2023;18;18;0;100;0;221712.777777778;1831.16666666667;120.333333333333
12289;2023;3;3;0;100;0;159400;1581.33333333333;102.333333333333
12290;2023;5;5;0;100;0;144740;1598.4;87
12291;2023;3;3;0;100;0;206136.666666667;2136.66666666667;96.3333333333333
12292;2023;2;2;0;100;0;1,00E+05;1353;71.5
12293;2023;3;2;1;66.6666666666667;33.3333333333333;82000;1022;79
12294;2023;3;3;0;100;0;66333.3333333333;1224.33333333333;69.3333333333333
12296;2023;10;10;0;100;0;100768.2;1193;89.8
12297;2023;6;6;0;100;0;154515.166666667;1581.5;84.6666666666667
12298;2023;3;3;0;100;0;97666.6666666667;673.666666666667;145
12299;2023;5;5;0;100;0;92467.6;1801.8;74.2
12300;2023;147;110;37;74.8299319727891;25.1700680272109;121889.170068027;1408.38095238095;87.6258503401361
12301;2023;19;19;0;100;0;194264.421052632;2216.42105263158;98
12303;2023;4;4;0;100;0;119462.5;1352;93.5
12305;2023;19;19;0;100;0;82350.2631578947;1008.84210526316;82.9473684210526
12307;2023;3;3;0;100;0;61666.6666666667;1082.66666666667;54
13001;2023;1957;313;1644;15.9938681655595;84.0061318344405;371189.438426162;5403.68932038835;66.2902401635156
13002;2023;192;120;72;62.5;37.5;375300.411458333;4774.00520833333;81.1927083333333
13003;2023;29;27;2;93.1034482758621;6.89655172413793;352505.068965517;3780.24137931034;96.3793103448276
13004;2023;619;350;269;56.5428109854604;43.4571890145396;225519.211631664;3037.65266558966;74.2132471728595
13005;2023;401;111;290;27.6807980049875;72.3192019950125;282362.428927681;3719.92518703242;73.8229426433915
13006;2023;14;13;1;92.8571428571429;7.14285714285714;332700.071428571;4447.21428571429;78.5
13007;2023;111;82;29;73.8738738738739;26.1261261261261;374299.234234234;4323.31531531532;86.5495495495496
13008;2023;2;2;0;100;0;500312.5;3707.5;152.5
13009;2023;10;10;0;100;0;380944;4464.3;91.7
13010;2023;40;34;6;85;15;342997.6;3400.875;103.725
13011;2023;8;4;4;50;50;1027772.5;8800.875;86.375
13012;2023;4;3;1;75;25;1098750;7026.25;152.75
13013;2023;18;17;1;94.4444444444444;5.55555555555556;543828;4720.88888888889;115.666666666667
13014;2023;79;43;36;54.4303797468354;45.5696202531646;249650.278481013;3199.16455696203;79.4936708860759
13015;2023;110;81;29;73.6363636363636;26.3636363636364;555473.972727273;5470.30909090909;98.7272727272727
13016;2023;36;27;9;75;25;354523.75;4642.30555555556;79.7222222222222
13017;2023;16;15;1;93.75;6.25;357135;3761.375;88.5625
13018;2023;39;38;1;97.4358974358974;2.56410256410256;298711.333333333;3035.84615384615;96.1282051282051
13019;2023;88;79;9;89.7727272727273;10.2272727272727;521763.636363636;5324.68181818182;99.5454545454545
13020;2023;14;13;1;92.8571428571429;7.14285714285714;366332.142857143;4754.64285714286;86
13021;2023;84;38;46;45.2380952380952;54.7619047619048;541909.428571429;6627.86904761905;82.7261904761905
13022;2023;114;23;91;20.1754385964912;79.8245614035088;571688.894736842;7561;74.5877192982456
13023;2023;44;36;8;81.8181818181818;18.1818181818182;561328.659090909;5331.38636363636;106.704545454545
13024;2023;27;20;7;74.0740740740741;25.9259259259259;290293.037037037;3358.59259259259;88.2962962962963
13025;2023;15;6;9;40;60;447437.666666667;5067.06666666667;90.2
13026;2023;178;109;69;61.2359550561798;38.7640449438202;299039.162921348;3947.52808988764;78.6292134831461
13027;2023;165;117;48;70.9090909090909;29.0909090909091;256762.787878788;3003.19393939394;83.1090909090909
13028;2023;669;125;544;18.6846038863976;81.3153961136024;333169.594917788;5569.79820627803;59.3273542600897
13029;2023;22;21;1;95.4545454545455;4.54545454545455;463317.090909091;4600.95454545455;101.272727272727
13030;2023;35;25;10;71.4285714285714;28.5714285714286;326557.142857143;4062.14285714286;80.8
13031;2023;32;20;12;62.5;37.5;331879.0625;4327.28125;75.5625
13032;2023;86;64;22;74.4186046511628;25.5813953488372;664036.790697674;5906.1976744186;106.988372093023
13033;2023;46;35;11;76.0869565217391;23.9130434782609;526297.5;6224.10869565217;83.304347826087
13034;2023;24;24;0;100;0;1428711.08333333;7751.33333333333;180.166666666667
13035;2023;88;68;20;77.2727272727273;22.7272727272727;288884.363636364;3934.67045454545;74
13036;2023;39;32;7;82.051282051282;17.9487179487179;347334.025641026;3770.53846153846;92.4102564102564
13037;2023;88;70;18;79.5454545454545;20.4545454545455;337951.761363636;4053.18181818182;83.625
13038;2023;39;33;6;84.6153846153846;15.3846153846154;362069.102564103;3975.84615384615;93.0512820512821
13039;2023;136;90;46;66.1764705882353;33.8235294117647;245360.522058824;3250.04411764706;75.6985294117647
13040;2023;100;72;28;72;28;413085.72;4730.19;89.56
13041;2023;214;89;125;41.588785046729;58.411214953271;285510.373831776;4087.23831775701;70.9439252336449
13042;2023;45;36;9;80;20;563810.911111111;5426.6;108.111111111111
13043;2023;93;72;21;77.4193548387097;22.5806451612903;379463.150537634;4189.17204301075;90.9569892473118
13044;2023;49;38;11;77.5510204081633;22.4489795918367;370392.469387755;3987.36734693878;93.4285714285714
13045;2023;41;34;7;82.9268292682927;17.0731707317073;316162.609756098;3416.43902439024;92.6829268292683
13046;2023;32;26;6;81.25;18.75;375185.65625;4711.8125;78.59375
13047;2023;454;256;198;56.3876651982379;43.6123348017621;258757.394273128;3338.78854625551;78.4955947136564
13048;2023;34;30;4;88.2352941176471;11.7647058823529;420803.911764706;3666.58823529412;108.647058823529
13049;2023;5;5;0;100;0;397126;3314.4;120.4
13050;2023;96;73;23;76.0416666666667;23.9583333333333;379163.447916667;4232.52083333333;92.1458333333333
13051;2023;93;78;15;83.8709677419355;16.1290322580645;348793.580645161;3884.58064516129;90.752688172043
13052;2023;35;29;6;82.8571428571429;17.1428571428571;364558.428571429;3592.48571428571;101.2
13053;2023;127;77;50;60.6299212598425;39.3700787401575;313787.62992126;3941.3937007874;78.5196850393701
13054;2023;386;135;251;34.9740932642487;65.0259067357513;232385.292746114;3301.87823834197;71.7305699481865
13055;2023;11216;1213;10003;10.814907275321;89.185092724679;232457.037892297;3585.38569900143;62.9509629101284
13056;2023;496;175;321;35.2822580645161;64.7177419354839;254368.653225806;3632.23185483871;72.8790322580645
13057;2023;4;4;0;100;0;840363.75;4930;153.75
13058;2023;35;30;5;85.7142857142857;14.2857142857143;787120.2;6479.48571428571;111.085714285714
13059;2023;25;12;13;48;52;299193.56;3486;82.12
13060;2023;62;42;20;67.741935483871;32.258064516129;514171.129032258;5429.77419354839;92.5483870967742
13061;2023;1;1;0;100;0;279185;2878;97
13062;2023;50;47;3;94;6;529162.46;5223.7;103.68
13063;2023;252;99;153;39.2857142857143;60.7142857142857;195513.531746032;2666.76587301587;74.0595238095238
13064;2023;19;17;2;89.4736842105263;10.5263157894737;407963.105263158;3922.84210526316;109
13065;2023;53;47;6;88.6792452830189;11.3207547169811;397182.245283019;3911.2641509434;94.5283018867924
13066;2023;50;34;16;68;32;264896.46;3181.82;86.7
13067;2023;29;28;1;96.551724137931;3.44827586206897;264042.068965517;2715.41379310345;97.4137931034483
13068;2023;38;36;2;94.7368421052632;5.26315789473684;655713.578947368;5342.6052631579;116.157894736842
13069;2023;133;94;39;70.6766917293233;29.3233082706767;368832.541353383;4169.75187969925;88.5112781954887
13070;2023;47;28;19;59.5744680851064;40.4255319148936;338234.446808511;4663.48936170213;73.468085106383
13071;2023;182;111;71;60.989010989011;39.010989010989;328774.417582418;4049.13736263736;81.1978021978022
13072;2023;36;24;12;66.6666666666667;33.3333333333333;342158.972222222;4159.66666666667;84.5277777777778
13073;2023;63;56;7;88.8888888888889;11.1111111111111;430094.301587302;5040.77777777778;89.6984126984127
13074;2023;47;34;13;72.3404255319149;27.6595744680851;326508.29787234;3881.93617021277;82.9787234042553
13075;2023;103;32;71;31.0679611650485;68.9320388349515;310955.029126214;4606.66990291262;69.8058252427184
13076;2023;36;31;5;86.1111111111111;13.8888888888889;335105.305555556;3183.38888888889;103.638888888889
13077;2023;153;72;81;47.0588235294118;52.9411764705882;191854.85620915;2641.17647058824;72.6928104575163
13078;2023;65;35;30;53.8461538461538;46.1538461538462;189188.153846154;2563.90769230769;74.2769230769231
13079;2023;13;11;2;84.6153846153846;15.3846153846154;425193.846153846;4230.53846153846;97.7692307692308
13080;2023;58;43;15;74.1379310344828;25.8620689655172;479747.206896552;4823.96551724138;99.3103448275862
13081;2023;137;97;40;70.8029197080292;29.1970802919708;346272.759124088;4010.8102189781;88.2554744525548
13082;2023;44;34;10;77.2727272727273;22.7272727272727;468239.318181818;4577.13636363636;99.0454545454545
13083;2023;36;34;2;94.4444444444444;5.55555555555556;346327.75;3256.33333333333;105.444444444444
13084;2023;48;34;14;70.8333333333333;29.1666666666667;310247.541666667;3427.95833333333;85.4791666666667
13085;2023;42;28;14;66.6666666666667;33.3333333333333;459728.928571429;5213.09523809524;87.3333333333333
13086;2023;50;28;22;56;44;359342.14;4490.4;80.24
13087;2023;48;25;23;52.0833333333333;47.9166666666667;332187.8125;4316.35416666667;78.2291666666667
13088;2023;42;33;9;78.5714285714286;21.4285714285714;399215.476190476;4746.38095238095;86.4285714285714
13089;2023;26;19;7;73.0769230769231;26.9230769230769;287498.269230769;3704.96153846154;81.8076923076923
13090;2023;1;1;0;100;0;265000;1142;232
13091;2023;65;50;15;76.9230769230769;23.0769230769231;494668.769230769;4781.76923076923;104.307692307692
13092;2023;103;50;53;48.5436893203884;51.4563106796116;259090.378640777;3245.72815533981;79.4563106796116
13093;2023;2;2;0;100;0;546240;3704;151.5
13094;2023;29;20;9;68.9655172413793;31.0344827586207;446705.965517241;5157.48275862069;97.6896551724138
13095;2023;10;10;0;100;0;1584557.2;8812.2;173.3
13096;2023;102;31;71;30.3921568627451;69.6078431372549;258691.5;5270.94117647059;52.0490196078431
13097;2023;135;104;31;77.037037037037;22.962962962963;316454.548148148;3367.31111111111;93.9333333333333
13098;2023;61;50;11;81.9672131147541;18.0327868852459;359221.885245902;4356.95081967213;83.9672131147541
13099;2023;7;4;3;57.1428571428571;42.8571428571429;239997.714285714;3178.57142857143;73
13100;2023;147;112;35;76.1904761904762;23.8095238095238;696171.646258503;6260.1156462585;105.394557823129
13101;2023;24;18;6;75;25;442068.583333333;4344.875;102.625
13102;2023;48;30;18;62.5;37.5;326181.4375;3963.33333333333;84.1041666666667
13103;2023;615;198;417;32.1951219512195;67.8048780487805;240184.598373984;3185.26829268293;74.2829268292683
13104;2023;111;57;54;51.3513513513513;48.6486486486487;448164.657657658;6935.26126126126;67.6396396396396
13105;2023;63;51;12;80.9523809523809;19.047619047619;298786.777777778;3516.15873015873;87.6666666666667
13106;2023;107;62;45;57.9439252336449;42.0560747663551;285231.364485981;3700.24299065421;77.803738317757
13107;2023;48;42;6;87.5;12.5;458548.854166667;4972.60416666667;94.8333333333333
13108;2023;133;68;65;51.1278195488722;48.8721804511278;202255.045112782;2211.87218045113;86.3233082706767
13109;2023;20;14;6;70;30;719492.3;6065.3;106.95
13110;2023;110;73;37;66.3636363636364;33.6363636363636;308709.309090909;3945;76.4272727272727
13111;2023;15;7;8;46.6666666666667;53.3333333333333;739349.533333333;6348.6;105.666666666667
13112;2023;72;64;8;88.8888888888889;11.1111111111111;452561.736111111;4528.83333333333;101.583333333333
13113;2023;83;52;31;62.6506024096386;37.3493975903614;511085.469879518;5363.6265060241;95.6746987951807
13114;2023;63;50;13;79.3650793650794;20.6349206349206;558445.126984127;4696.50793650794;113.492063492063
13115;2023;14;13;1;92.8571428571429;7.14285714285714;359097.142857143;3955.64285714286;88.3571428571429
13116;2023;2;2;0;100;0;228025;2125.5;97.5
13117;2023;310;143;167;46.1290322580645;53.8709677419355;273833.758064516;3643.81612903226;75.9870967741935
13118;2023;36;29;7;80.5555555555556;19.4444444444444;407915.194444444;4478.02777777778;90.0555555555556
13119;2023;68;34;34;50;50;403437.588235294;4630.89705882353;84.4705882352941
14001;2023;13;13;0;100;0;228426.923076923;2742.38461538462;81.8461538461538
14003;2023;5;5;0;100;0;268170;2331.4;127.4
14005;2023;13;13;0;100;0;235073.384615385;2156.38461538462;111.769230769231
14006;2023;8;8;0;100;0;331695;2364.625;140.75
14007;2023;4;3;1;75;25;216272.5;1842.5;119.5
14009;2023;11;10;1;90.9090909090909;9.09090909090909;338755.545454545;2645.90909090909;138.181818181818
14011;2023;26;26;0;100;0;198543.5;1828.57692307692;110.461538461538
14012;2023;1;1;0;100;0;272000;2776;98
14014;2023;10;10;0;100;0;325429.3;2878.5;112.3
14015;2023;12;12;0;100;0;447242.5;3274.58333333333;141.583333333333
14016;2023;7;7;0;100;0;237300;2569.57142857143;94
14020;2023;36;31;5;86.1111111111111;13.8888888888889;215061.111111111;2391.27777777778;92.2777777777778
14021;2023;8;4;4;50;50;190250;3738.75;52.875
14022;2023;23;19;4;82.6086956521739;17.3913043478261;198870.652173913;3512.21739130435;61.3478260869565
14024;2023;12;10;2;83.3333333333333;16.6666666666667;377580.583333333;3188.25;110.25
14025;2023;2;2;0;100;0;119500;1617;101.5
14026;2023;9;9;0;100;0;289100;2448.88888888889;120.555555555556
14027;2023;56;45;11;80.3571428571429;19.6428571428571;159135;1559.76785714286;102.339285714286
14030;2023;10;10;0;100;0;332656;2892.2;114.3
14032;2023;7;7;0;100;0;381677.142857143;4412.42857142857;92.7142857142857
14033;2023;3;3;0;100;0;194895;2429;73.3333333333333
14034;2023;5;5;0;100;0;198780;2404.8;84.8
14035;2023;17;17;0;100;0;152386.470588235;1486.41176470588;102.411764705882
14036;2023;4;4;0;100;0;327755;2598.25;128.5
14037;2023;5;5;0;100;0;288220;1832.8;148.2
14038;2023;5;5;0;100;0;244250;1989.8;123.4
14039;2023;6;6;0;100;0;233236;1792.5;124.666666666667
14040;2023;1;1;0;100;0;2,00E+05;3333;60
14041;2023;5;5;0;100;0;811560.4;4330.6;176.6
14042;2023;18;18;0;100;0;299906.666666667;2785.22222222222;109.888888888889
14043;2023;1;1;0;100;0;150000;1724;87
14044;2023;9;9;0;100;0;305755.555555556;2805.22222222222;110.222222222222
14045;2023;2;2;0;100;0;220100;2094;106
14046;2023;19;19;0;100;0;309859.631578947;2654.26315789474;122.789473684211
14047;2023;155;64;91;41.2903225806452;58.7096774193548;208149.187096774;2704.53548387097;75.9612903225807
14050;2023;3;3;0;100;0;406333.333333333;2433.66666666667;159
14053;2023;1;1;0;100;0;95000;2262;42
14054;2023;4;4;0;100;0;215150;1759.25;108.25
14055;2023;8;6;2;75;25;569718.75;4292.625;115.125
14057;2023;12;12;0;100;0;213006.416666667;2304.58333333333;92.75
14059;2023;35;9;26;25.7142857142857;74.2857142857143;407575.371428571;6117.51428571429;62.3142857142857
14060;2023;16;16;0;100;0;280189.8125;2685.0625;102.625
14061;2023;105;105;0;100;0;141642.19047619;1453.19047619048;99.4095238095238
14062;2023;1;1;0;100;0;50000;602;83
14063;2023;7;7;0;100;0;143005.714285714;1507.28571428571;97.7142857142857
14064;2023;1;1;0;100;0;141000;1396;101
14066;2023;70;51;19;72.8571428571428;27.1428571428571;244232.142857143;3560.35714285714;72.7714285714286
14068;2023;34;31;3;91.1764705882353;8.82352941176471;448420.970588235;3510.05882352941;131.205882352941
14069;2023;17;13;4;76.4705882352941;23.5294117647059;142585.294117647;1774.05882352941;78.5294117647059
14070;2023;4;4;0;100;0;341750;2536.5;126.75
14076;2023;45;26;19;57.7777777777778;42.2222222222222;225413.333333333;2653.33333333333;84.4
14077;2023;11;11;0;100;0;461578.181818182;3357.90909090909;110.727272727273
14078;2023;4;4;0;100;0;213525;1962.75;107
14079;2023;95;23;72;24.2105263157895;75.7894736842105;259724.705263158;4710.16842105263;53.5684210526316
14080;2023;2;2;0;100;0;85000;1015;70.5
14082;2023;3;3;0;100;0;231816.666666667;1893;125
14083;2023;11;11;0;100;0;161769.090909091;2683.54545454545;67.4545454545455
14084;2023;6;6;0;100;0;141940;1425.83333333333;92.6666666666667
14085;2023;12;12;0;100;0;290737.5;2295.08333333333;126.416666666667
14086;2023;2;2;0;100;0;345000;3916.5;87.5
14088;2023;1;1;0;100;0;95000;2065;46
14089;2023;3;3;0;100;0;247133.333333333;2800.66666666667;87.3333333333333
14090;2023;11;11;0;100;0;211670.454545455;1955.54545454545;106.090909090909
14091;2023;4;4;0;100;0;291250;3093.25;89.75
14092;2023;26;22;4;84.6153846153846;15.3846153846154;268834.615384615;2718.76923076923;98.8846153846154
14093;2023;3;3;0;100;0;486666.666666667;4369.66666666667;125.666666666667
14096;2023;1;1;0;100;0;186000;2044;91
14097;2023;2;2;0;100;0;195571;2434.5;80.5
14098;2023;68;66;2;97.0588235294118;2.94117647058824;242214.441176471;2476.01470588235;100.176470588235
14100;2023;21;21;0;100;0;230092.857142857;2435.57142857143;95.6666666666667
14101;2023;48;35;13;72.9166666666667;27.0833333333333;254680.666666667;3120.64583333333;83.0416666666667
14102;2023;13;13;0;100;0;304376.923076923;2759.15384615385;104.538461538462
14103;2023;10;10;0;100;0;220667;2470.1;88.2
14104;2023;2;2;0;100;0;426190.5;2906.5;125
14106;2023;5;5;0;100;0;254442;2936.6;95.4
14107;2023;1;1;0;100;0;88500;1639;54
14110;2023;3;3;0;100;0;419350;2142;181
14111;2023;8;8;0;100;0;272741.25;2094.5;134.875
14116;2023;4;4;0;100;0;223637.5;2055.75;109.25
14117;2023;348;51;297;14.6551724137931;85.3448275862069;234848.557471264;5389.72126436782;43.5172413793103
14118;2023;1954;301;1653;15.4042988741044;84.5957011258956;188137.940122825;3046.82446264074;62.5307062436029
14119;2023;31;29;2;93.5483870967742;6.45161290322581;183515.483870968;1862.41935483871;101.838709677419
14120;2023;14;14;0;100;0;150660;1602.35714285714;95
14121;2023;2;2;0;100;0;278725;1556;173.5
14122;2023;1;1;0;100;0;254400;1590;160
14123;2023;18;18;0;100;0;370625.166666667;2933.05555555556;128.944444444444
14124;2023;10;10;0;100;0;109097.5;1430.9;74.7
14125;2023;10;9;1;90;10;398288.5;3158.4;131.8
14126;2023;18;18;0;100;0;263343.333333333;2404.33333333333;108.833333333333
14127;2023;3;3;0;100;0;190700;1681.66666666667;115.333333333333
14130;2023;3;3;0;100;0;192041.666666667;2023;98.3333333333333
14131;2023;6;6;0;100;0;415766.666666667;3596.16666666667;125.666666666667
14134;2023;1;1;0;100;0;258662;2230;116
14135;2023;3;1;2;33.3333333333333;66.6666666666667;150337.666666667;1631.33333333333;96
14137;2023;28;21;7;75;25;224338.214285714;2981.71428571429;80.0357142857143
14138;2023;3;3;0;100;0;146333.333333333;1089.66666666667;136.666666666667
14140;2023;6;6;0;100;0;204530;1996.83333333333;103
14143;2023;35;34;1;97.1428571428571;2.85714285714286;133912.257142857;1426.62857142857;95.2285714285714
14145;2023;2;2;0;100;0;145000;1671;87
14146;2023;3;3;0;100;0;125000;1891;69.3333333333333
14147;2023;1;1;0;100;0;282000;1602;176
14149;2023;4;4;0;100;0;197000;1917;106.25
14150;2023;7;7;0;100;0;141921.714285714;1553.57142857143;95
14161;2023;4;4;0;100;0;508275;6040.75;89
14162;2023;24;24;0;100;0;181593.75;1662.375;108.458333333333
14163;2023;3;3;0;100;0;162900;2005;82.3333333333333
14165;2023;6;5;1;83.3333333333333;16.6666666666667;188541.666666667;2483.33333333333;76.8333333333333
14166;2023;37;35;2;94.5945945945946;5.40540540540541;270560.297297297;3188.62162162162;89.3783783783784
14167;2023;69;43;26;62.3188405797101;37.6811594202899;193745.449275362;2777.34782608696;72.7391304347826
14168;2023;3;3;0;100;0;128666.666666667;1686.66666666667;76.3333333333333
14169;2023;2;2;0;100;0;270000;1077;220
14171;2023;3;3;0;100;0;202463.333333333;1759.33333333333;114.666666666667
14172;2023;10;10;0;100;0;239523;2685.2;101.9
14173;2023;5;5;0;100;0;170900;1695.4;114.6
14174;2023;83;66;17;79.5180722891566;20.4819277108434;99258.1204819277;1153.13253012048;82.4819277108434
14175;2023;1;1;0;100;0;157000;1208;130
14177;2023;9;9;0;100;0;239944.444444444;2143.22222222222;110.777777777778
14179;2023;3;3;0;100;0;183333.333333333;1980;101.666666666667
14180;2023;1;1;0;100;0;190000;2111;90
14181;2023;51;34;17;66.6666666666667;33.3333333333333;216220.039215686;2484.05882352941;87.0392156862745
14182;2023;9;9;0;100;0;128044.444444444;1733.11111111111;77
14183;2023;3;3;0;100;0;125078;1084;120.333333333333
14184;2023;3;3;0;100;0;231500;1656.33333333333;141
14190;2023;1;1;0;100;0;58500;1300;45
14191;2023;227;57;170;25.1101321585903;74.8898678414097;169570.440528634;3500.99559471366;50.0088105726872
14193;2023;6;6;0;100;0;237447.5;2031.83333333333;112.666666666667
14194;2023;11;11;0;100;0;157952.272727273;1883.72727272727;88.4545454545455
14195;2023;4;4;0;100;0;203190;1584.75;126.25
14196;2023;3;3;0;100;0;212856.333333333;2137.33333333333;99.6666666666667
14197;2023;10;10;0;100;0;297763;2769.4;108.7
14198;2023;4;4;0;100;0;323425;2415;144
14200;2023;24;21;3;87.5;12.5;204257.5;2129.125;96.5833333333333
14202;2023;3;3;0;100;0;394208.333333333;4785.33333333333;97
14203;2023;5;5;0;100;0;330200;2860.2;111
14205;2023;4;4;0;100;0;259636.25;2655.75;98.25
14206;2023;5;5;0;100;0;180422.4;1335.4;134.2
14207;2023;8;8;0;100;0;225760;1858.875;121.25
14209;2023;3;3;0;100;0;162372.333333333;1700.33333333333;99.3333333333333
14211;2023;5;5;0;100;0;287400;2663;100.6
14214;2023;2;2;0;100;0;184975;2482;73.5
14215;2023;12;12;0;100;0;287642.083333333;2778.25;105.916666666667
14216;2023;1;1;0;100;0;253500;2668;95
14218;2023;5;5;0;100;0;235800;2769;76.6
14220;2023;276;54;222;19.5652173913043;80.4347826086957;448252.177536232;7011.11231884058;61.9166666666667
14221;2023;35;32;3;91.4285714285714;8.57142857142857;206631.714285714;2523.94285714286;84.6857142857143
14224;2023;1;1;0;100;0;320000;3404;94
14225;2023;102;65;37;63.7254901960784;36.2745098039216;243980.62745098;4277.02941176471;60.5392156862745
14226;2023;4;4;0;100;0;126321;1194.25;96.5
14227;2023;2;2;0;100;0;581964;3834;147.5
14228;2023;48;33;15;68.75;31.25;288638.208333333;3108.75;92.7708333333333
14229;2023;36;34;2;94.4444444444444;5.55555555555556;179009.638888889;2312.55555555556;82.2777777777778
14231;2023;7;7;0;100;0;209374.285714286;2880.85714285714;80.2857142857143
14232;2023;1;1;0;100;0;160000;3200;50
14236;2023;8;8;0;100;0;328328.625;2860.25;110.125
14237;2023;7;6;1;85.7142857142857;14.2857142857143;306500;2236.42857142857;139.142857142857
14238;2023;2;2;0;100;0;928300;6269;149.5
14239;2023;1;1;0;100;0;320000;2092;153
14240;2023;2;2;0;100;0;178000;1873.5;88
14241;2023;5;5;0;100;0;253030;1719.4;151.4
14242;2023;27;14;13;51.8518518518518;48.1481481481481;276202.111111111;3042.11111111111;92.2222222222222
14243;2023;17;8;9;47.0588235294118;52.9411764705882;290462.352941176;3090.17647058824;85.9411764705882
14244;2023;4;4;0;100;0;260200;1993;136.75
14245;2023;4;4;0;100;0;156250;1743.5;86.5
14246;2023;8;8;0;100;0;329787.375;2338;137.25
14248;2023;4;4;0;100;0;210775;2348;98
14249;2023;9;9;0;100;0;228822.222222222;2444.77777777778;97.2222222222222
14251;2023;9;9;0;100;0;164164.333333333;1275.66666666667;116.555555555556
14252;2023;4;4;0;100;0;216375;1754.25;124
14254;2023;14;14;0;100;0;263592.214285714;2803.28571428571;95
14256;2023;4;4;0;100;0;301750;2446.5;118.25
14257;2023;6;6;0;100;0;229465.333333333;2343.66666666667;95.3333333333333
14258;2023;123;74;49;60.1626016260163;39.8373983739837;151753.951219512;1908.06504065041;82.479674796748
14260;2023;2;2;0;100;0;412500;2608.5;174
14261;2023;4;4;0;100;0;438715;3273.75;146
14266;2023;15;15;0;100;0;252211.666666667;2811.46666666667;93.7333333333333
14269;2023;6;6;0;100;0;325416.666666667;2558.33333333333;125.666666666667
14270;2023;5;5;0;100;0;285950;2350.2;124
14271;2023;43;22;21;51.1627906976744;48.8372093023256;224867.279069767;3038.48837209302;77.6279069767442
14272;2023;3;3;0;100;0;108986.666666667;1016;102.333333333333
14273;2023;1;1;0;100;0;118000;1573;75
14274;2023;26;24;2;92.3076923076923;7.69230769230769;279533.153846154;2692.80769230769;109.115384615385
14275;2023;3;3;0;100;0;142666.666666667;2046;61.6666666666667
14276;2023;5;5;0;100;0;175339.4;1807.2;118.2
14277;2023;25;24;1;96;4;209166.6;2434.08;94.2
14278;2023;4;4;0;100;0;205750;2328;88.25
14280;2023;3;3;0;100;0;212000;2738.33333333333;79.6666666666667
14281;2023;8;8;0;100;0;228097.5;1763.25;128.75
14282;2023;2;2;0;100;0;199000;1613.5;123.5
14283;2023;3;3;0;100;0;112000;1409;80.6666666666667
14284;2023;2;2;0;100;0;183500;1568;120
14286;2023;2;2;0;100;0;358900;2763;128
14287;2023;16;16;0;100;0;211660.375;2672.125;81.0625
14288;2023;3;3;0;100;0;347700;2440;142.333333333333
14289;2023;6;6;0;100;0;198483.333333333;1843.16666666667;114
14290;2023;5;5;0;100;0;327777;2129.4;147.8
14291;2023;2;2;0;100;0;216850;1715.5;126
14293;2023;2;2;0;100;0;215560;1738.5;129.5
14297;2023;5;5;0;100;0;209470;2275.4;91.2
14298;2023;1;1;0;100;0;61900;1474;42
14299;2023;16;16;0;100;0;345543.125;3138.5;112.75
14301;2023;41;41;0;100;0;250258.390243902;2733.41463414634;94.3170731707317
14303;2023;9;9;0;100;0;167448.777777778;1868.33333333333;89.4444444444444
14304;2023;10;10;0;100;0;303292;2766;112.2
14305;2023;11;11;0;100;0;623348.454545455;4580.90909090909;135.909090909091
14306;2023;10;10;0;100;0;375678;2753.3;139.8
14308;2023;6;6;0;100;0;274288.666666667;2865.16666666667;98.6666666666667
14309;2023;11;9;2;81.8181818181818;18.1818181818182;158695.454545455;2057.72727272727;78.7272727272727
14310;2023;14;14;0;100;0;220724.571428571;2182.42857142857;114.928571428571
14311;2023;12;12;0;100;0;215469;2111.75;103.833333333333
14312;2023;76;41;35;53.9473684210526;46.0526315789474;149320.263157895;2363.69736842105;63.0921052631579
14316;2023;2;2;0;100;0;545081.5;5490.5;88
14318;2023;5;5;0;100;0;241580;2850;87.2
14319;2023;5;5;0;100;0;222770;3185.2;74.6
14320;2023;3;3;0;100;0;145666.666666667;1510.66666666667;93
14322;2023;4;4;0;100;0;331987.5;2623;123.75
14325;2023;57;50;7;87.719298245614;12.280701754386;252807.368421053;3084.14035087719;82.0526315789474
14326;2023;7;7;0;100;0;334128.571428571;2637.71428571429;128.142857142857
14327;2023;274;61;213;22.2627737226277;77.7372262773723;142376.200729927;2255.66058394161;63.3248175182482
14328;2023;10;10;0;100;0;290400.8;2926.8;102.5
14329;2023;1;1;0;100;0;492500;3518;140
14332;2023;5;5;0;100;0;177000;1623.8;105
14333;2023;149;60;89;40.2684563758389;59.7315436241611;286914.66442953;4037.25503355705;71.4630872483222
14334;2023;4;4;0;100;0;218000;2029.5;110.25
14335;2023;5;5;0;100;0;266995;2520.6;106.6
14336;2023;3;3;0;100;0;174134;1921.66666666667;90.6666666666667
14337;2023;1;1;0;100;0;1346929;5856;230
14338;2023;181;64;117;35.3591160220994;64.6408839779006;247501.348066298;4479.77900552486;57.1491712707182
14341;2023;142;74;68;52.112676056338;47.887323943662;213091.077464789;2538.09154929577;79.0915492957746
14342;2023;55;47;8;85.4545454545455;14.5454545454545;129247;1363.92727272727;100.581818181818
14344;2023;3;3;0;100;0;284000;2305.66666666667;119.666666666667
14345;2023;7;7;0;100;0;149200;1221.28571428571;113
14346;2023;7;7;0;100;0;238860;2094.71428571429;134.142857142857
14347;2023;9;9;0;100;0;179006.111111111;1750.33333333333;104.444444444444
14349;2023;16;16;0;100;0;227533.125;2148.25;106.125
14352;2023;8;8;0;100;0;108625;1079.25;96.375
14353;2023;5;5;0;100;0;230160;2478.4;126.8
14354;2023;35;25;10;71.4285714285714;28.5714285714286;248912.057142857;3573.02857142857;74.2
14355;2023;11;11;0;100;0;300266.636363636;2436.63636363636;125
14357;2023;10;10;0;100;0;141880;1465.3;93.3
14358;2023;3;3;0;100;0;715666.666666667;4777.66666666667;102.666666666667
14362;2023;3;3;0;100;0;230000;2929;84
14364;2023;5;5;0;100;0;253920;3101.6;77.8
14365;2023;27;17;10;62.962962962963;37.037037037037;269836.851851852;3778.03703703704;75
14366;2023;298;113;185;37.9194630872483;62.0805369127517;147776.083892617;1911.09731543624;75.989932885906
14367;2023;6;6;0;100;0;127396.666666667;1439.83333333333;88
14368;2023;4;4;0;100;0;128000;1420.25;79.5
14370;2023;26;26;0;100;0;187587.038461538;1877.53846153846;99.2692307692308
14371;2023;76;76;0;100;0;186876.960526316;1821.55263157895;106.039473684211
14375;2023;5;5;0;100;0;130484;1237;115
14377;2023;7;7;0;100;0;260518;2345.85714285714;114.285714285714
14378;2023;3;3;0;100;0;158280;1549.33333333333;102
14379;2023;3;3;0;100;0;190000;2146.66666666667;93.6666666666667
14380;2023;2;2;0;100;0;273800;1923.5;140
14383;2023;21;18;3;85.7142857142857;14.2857142857143;258707.761904762;3087.71428571429;86.6666666666667
14384;2023;52;33;19;63.4615384615385;36.5384615384615;256445.384615385;3824.15384615385;69.1923076923077
14389;2023;1;1;0;100;0;65000;1083;60
14390;2023;4;4;0;100;0;149000.5;2092;70.5
14391;2023;1;1;0;100;0;440750;3061;144
14393;2023;3;3;0;100;0;291433.333333333;2343.33333333333;123.666666666667
14394;2023;6;6;0;100;0;217189.833333333;1940.5;119.833333333333
14396;2023;2;2;0;100;0;453250;3500;147.5
14397;2023;3;3;0;100;0;161000;1619;96
14398;2023;3;3;0;100;0;282833.333333333;3249.33333333333;88
14399;2023;6;6;0;100;0;588405;4007.66666666667;127.333333333333
14400;2023;1;1;0;100;0;265500;2231;119
14401;2023;1;1;0;100;0;137143;2286;60
14402;2023;1;1;0;100;0;130000;2241;58
14403;2023;3;3;0;100;0;242843.333333333;2387.66666666667;106.666666666667
14404;2023;4;4;0;100;0;239722.5;1981.5;116.5
14405;2023;4;4;0;100;0;98250;1873.5;53
14406;2023;11;11;0;100;0;274790.909090909;2341.54545454545;124.636363636364
14407;2023;29;24;5;82.7586206896552;17.2413793103448;453741.724137931;3308.44827586207;131.689655172414
14408;2023;17;17;0;100;0;242178.823529412;2666.23529411765;94.6470588235294
14409;2023;77;39;38;50.6493506493506;49.3506493506493;270193.558441558;4239.92207792208;68.3246753246753
14410;2023;13;13;0;100;0;171978;1870.53846153846;99.1538461538462
14411;2023;2;2;0;100;0;301550;2031.5;151
14419;2023;4;4;0;100;0;255950;1915;129.5
14421;2023;8;8;0;100;0;206362.5;2182.875;95.875
14424;2023;4;4;0;100;0;108600;1220;91.25
14425;2023;3;3;0;100;0;203500;1838.66666666667;112.666666666667
14427;2023;4;4;0;100;0;150568.75;1755.25;89
14430;2023;2;2;0;100;0;201000;1302.5;156
14431;2023;106;103;3;97.1698113207547;2.83018867924528;190735.481132075;2007.16037735849;96.311320754717
14435;2023;1;1;0;100;0;211000;1835;115
14436;2023;1;1;0;100;0;237200;3041;78
14437;2023;157;84;73;53.5031847133758;46.4968152866242;178559.757961783;2755.35031847134;66.1464968152866
14438;2023;1;1;0;100;0;255000;1821;140
14439;2023;1;1;0;100;0;305000;1894;161
14445;2023;3;3;0;100;0;126948;1040.33333333333;135
14446;2023;2;2;0;100;0;140500;1554;94
14449;2023;2;2;0;100;0;220000;2336.5;94
14452;2023;7;7;0;100;0;144371.428571429;1250.57142857143;110.285714285714
14453;2023;5;5;0;100;0;145820;1651.2;88.4
14454;2023;15;13;2;86.6666666666667;13.3333333333333;236147.8;2171.73333333333;106.733333333333
14455;2023;7;7;0;100;0;177178.571428571;1768.14285714286;98.5714285714286
14456;2023;27;27;0;100;0;249662.962962963;2429.14814814815;107.518518518519
14457;2023;2;2;0;100;0;259000;2023.5;132
14458;2023;3;3;0;100;0;250720;2097;138.333333333333
14460;2023;24;24;0;100;0;214819.583333333;1992.08333333333;104.541666666667
14461;2023;4;4;0;100;0;190925;2153.75;88.5
14465;2023;4;4;0;100;0;347345;2066.5;162
14466;2023;3;3;0;100;0;489710;2992;156.666666666667
14467;2023;3;3;0;100;0;54000;725;75
14468;2023;4;4;0;100;0;143855;1802.25;81.5
14469;2023;2;2;0;100;0;62000;742.5;79
14473;2023;1;1;0;100;0;347000;2196;158
14474;2023;4;4;0;100;0;319250.25;2944.75;93.5
14475;2023;31;31;0;100;0;221267.903225806;1994.67741935484;112
14476;2023;2;2;0;100;0;153135;2181.5;68.5
14478;2023;31;28;3;90.3225806451613;9.67741935483871;118891.677419355;1471.16129032258;78.4838709677419
14480;2023;11;11;0;100;0;218459.090909091;1778;114.363636363636
14482;2023;3;3;0;100;0;258666.666666667;2834.33333333333;100
14483;2023;1;1;0;100;0;159750;2130;75
14484;2023;1;1;0;100;0;210000;4667;45
14486;2023;6;6;0;100;0;171310;1756.83333333333;103.166666666667
14487;2023;14;14;0;100;0;187839.071428571;2097.64285714286;91
14488;2023;211;113;98;53.5545023696682;46.4454976303318;242299.90521327;3679.41232227488;70.2890995260664
14491;2023;2;2;0;100;0;238000;1848;128.5
14492;2023;2;2;0;100;0;446750;2557.5;200
14494;2023;2;2;0;100;0;397375;3108.5;122
14495;2023;7;7;0;100;0;435267.857142857;2521.57142857143;175.857142857143
14496;2023;1;1;0;100;0;65500;873;75
14497;2023;7;7;0;100;0;190598.571428571;2278;98.1428571428571
14498;2023;5;5;0;100;0;181800;1923.6;95.6
14499;2023;4;4;0;100;0;276250;2695;114.25
14500;2023;3;3;0;100;0;483255;4045.66666666667;125.666666666667
14501;2023;2;2;0;100;0;68000;1409.5;53
14502;2023;2;2;0;100;0;107500;2027;62
14504;2023;15;15;0;100;0;212090.333333333;2177.53333333333;104.2
14506;2023;1;1;0;100;0;191000;2851;67
14509;2023;1;1;0;100;0;237275;4237;56
14510;2023;2;2;0;100;0;135150;985;130
14511;2023;3;3;0;100;0;137166.666666667;1079.66666666667;126.666666666667
14514;2023;54;37;17;68.5185185185185;31.4814814814815;260954.166666667;2989.96296296296;90.2592592592593
14515;2023;34;26;8;76.4705882352941;23.5294117647059;190805.323529412;2464.14705882353;75.7352941176471
14516;2023;21;21;0;100;0;132048.380952381;1883.57142857143;70.2857142857143
14519;2023;2;2;0;100;0;440000;2261;190
14520;2023;6;6;0;100;0;200610;2039.83333333333;92.8333333333333
14522;2023;5;5;0;100;0;284288;2447;114.8
14524;2023;4;4;0;100;0;248750;2764;97.25
14527;2023;6;6;0;100;0;255741.666666667;2012.83333333333;116.666666666667
14528;2023;5;5;0;100;0;238000;2541.2;97.2
14529;2023;3;3;0;100;0;194533.333333333;1966.66666666667;98.3333333333333
14530;2023;21;21;0;100;0;263561.904761905;2885.04761904762;91.6190476190476
14531;2023;1;1;0;100;0;35000;486;72
14534;2023;3;3;0;100;0;301450;2243;123
14535;2023;6;6;0;100;0;315485.333333333;2739.66666666667;118
14536;2023;43;28;15;65.1162790697674;34.8837209302326;212264;2715.27906976744;76.9069767441861
14538;2023;17;16;1;94.1176470588235;5.88235294117647;251536.470588235;2606.41176470588;96.0588235294118
14540;2023;4;4;0;100;0;362500;3010.75;119.5
14541;2023;1;1;0;100;0;65000;2167;30
14542;2023;10;10;0;100;0;289541;2571;114.1
14543;2023;25;25;0;100;0;310703.48;2850.56;114.2
14546;2023;1;1;0;100;0;140000;1892;74
14547;2023;1;1;0;100;0;192000;1670;115
14552;2023;7;7;0;100;0;257885.714285714;1894.85714285714;136.142857142857
14554;2023;12;12;0;100;0;252335;2405.16666666667;102.333333333333
14555;2023;5;5;0;100;0;599500;3032;186
14556;2023;16;16;0;100;0;233075;2910;84.25
14557;2023;42;15;27;35.7142857142857;64.2857142857143;328365.738095238;3996.30952380952;77.0476190476191
14558;2023;17;17;0;100;0;273736.352941176;2983.94117647059;91.5294117647059
14559;2023;2;2;0;100;0;55500;599;92.5
14562;2023;44;28;16;63.6363636363636;36.3636363636364;296745;3906.34090909091;76.9318181818182
14563;2023;4;4;0;100;0;408960;2693.5;151
14565;2023;10;10;0;100;0;112215;2223.3;56.1
14566;2023;25;24;1;96;4;357819.2;2932.12;123.6
14569;2023;2;2;0;100;0;402793;2943;137
14570;2023;43;43;0;100;0;160407.209302326;1701.6511627907;102.558139534884
14571;2023;5;5;0;100;0;223900;2202.6;106.4
14572;2023;11;11;0;100;0;110295.909090909;1109.90909090909;99.3636363636364
14574;2023;12;12;0;100;0;210566.666666667;1690.41666666667;126
14575;2023;1;1;0;100;0;853666;4743;180
14576;2023;8;8;0;100;0;223023.875;2104.75;111.5
14578;2023;15;15;0;100;0;361803.333333333;3727.2;96.4666666666667
14579;2023;16;16;0;100;0;167860.5;1452.875;116.375
14582;2023;6;6;0;100;0;175250;2027.83333333333;97
14586;2023;1;1;0;100;0;337000;2055;164
14587;2023;11;10;1;90.9090909090909;9.09090909090909;247999;3013.45454545455;83.5454545454545
14588;2023;3;3;0;100;0;230650;2091.66666666667;105.666666666667
14589;2023;14;14;0;100;0;195511.214285714;2167.85714285714;91.2142857142857
14590;2023;1;1;0;100;0;164950;1500;110
14591;2023;15;15;0;100;0;187645.733333333;2051.2;91.5333333333333
14592;2023;7;7;0;100;0;266785.714285714;2292.57142857143;117.714285714286
14593;2023;11;10;1;90.9090909090909;9.09090909090909;368427.272727273;3679.90909090909;108.545454545455
14595;2023;3;3;0;100;0;239333.333333333;3217;80
14598;2023;3;3;0;100;0;209386.333333333;2805.33333333333;83
14601;2023;2;2;0;100;0;227500;2344;100
14602;2023;6;6;0;100;0;157900;1703.33333333333;88.1666666666667
14603;2023;7;7;0;100;0;175159.285714286;1851.71428571429;96.8571428571429
14605;2023;7;7;0;100;0;285714.285714286;3410.85714285714;80.8571428571429
14606;2023;3;3;0;100;0;213654.666666667;2626.66666666667;77
14607;2023;2;2;0;100;0;184950;1961.5;103
14609;2023;8;8;0;100;0;362625;2975.5;124.875
14610;2023;19;19;0;100;0;309961.578947368;2747.26315789474;119.157894736842
14614;2023;10;9;1;90;10;143577.3;1790.5;84.7
14620;2023;6;6;0;100;0;411095;3160.5;133.833333333333
14621;2023;8;8;0;100;0;91156.25;1076.375;84.75
14622;2023;3;3;0;100;0;120000;1107.66666666667;101
14623;2023;19;17;2;89.4736842105263;10.5263157894737;234094.210526316;2453;94.2631578947368
14625;2023;11;9;2;81.8181818181818;18.1818181818182;176909.090909091;2154.27272727273;93.3636363636364
14626;2023;12;12;0;100;0;189441.666666667;2073.75;95.5833333333333
14627;2023;4;4;0;100;0;184375;1666;109.75
14630;2023;3;3;0;100;0;235016.666666667;2700.33333333333;85
14635;2023;2;2;0;100;0;60000;882.5;60
14637;2023;2;2;0;100;0;222880;2562;87
14639;2023;1;1;0;100;0;1,00E+05;1562;64
14640;2023;3;3;0;100;0;281738.333333333;2020.66666666667;127
14643;2023;4;4;0;100;0;212000;2146;97.5
14644;2023;8;8;0;100;0;362843.75;2936.5;126.75
14645;2023;1;1;0;100;0;1185000;5925;200
14646;2023;3;3;0;100;0;420000;2672;157.666666666667
14648;2023;2;2;0;100;0;407500;2621.5;148.5
14649;2023;7;7;0;100;0;159016.142857143;1500.14285714286;104.285714285714
14650;2023;1;1;0;100;0;207000;1953;106
14651;2023;3;3;0;100;0;350666.666666667;3426.33333333333;95
14654;2023;82;80;2;97.5609756097561;2.4390243902439;167666.524390244;1896.18292682927;91.9268292682927
14656;2023;20;20;0;100;0;144308.45;1543.6;96.7
14657;2023;7;7;0;100;0;279392.857142857;2328;122.428571428571
14658;2023;54;54;0;100;0;127696.851851852;1183.14814814815;106.962962962963
14659;2023;17;13;4;76.4705882352941;23.5294117647059;175604.470588235;2331.05882352941;81.8823529411765
14660;2023;2;2;0;100;0;377260;5078.5;76.5
14661;2023;1;1;0;100;0;175000;1636;107
14663;2023;34;34;0;100;0;273792.794117647;2455.32352941176;113.882352941176
14664;2023;9;9;0;100;0;142222.222222222;1508.22222222222;91.2222222222222
14665;2023;5;5;0;100;0;235300;2788.8;85.4
14666;2023;19;18;1;94.7368421052632;5.26315789473684;254634.210526316;2608.36842105263;100.736842105263
14668;2023;2;2;0;100;0;197500;1990;101
14669;2023;3;3;0;100;0;260000;1739.33333333333;142.333333333333
14672;2023;11;11;0;100;0;137259.090909091;1610.18181818182;80.1818181818182
14675;2023;15;13;2;86.6666666666667;13.3333333333333;252063.333333333;2700.06666666667;93.5333333333333
14676;2023;13;13;0;100;0;253293.076923077;2286.30769230769;112.076923076923
14677;2023;2;2;0;100;0;295000;1973;149.5
14678;2023;7;7;0;100;0;221834.857142857;2441.57142857143;95
14679;2023;6;6;0;100;0;205390;2421.5;88
14680;2023;2;2;0;100;0;572975;3258.5;167
14681;2023;1;1;0;100;0;110000;2973;37
14682;2023;3;3;0;100;0;663333.333333333;2971;217.666666666667
14684;2023;4;4;0;100;0;185850;1884.5;95
14685;2023;23;23;0;100;0;307864.260869565;2773.69565217391;120.565217391304
14689;2023;39;37;2;94.8717948717949;5.12820512820513;175109;1964.69230769231;93.4102564102564
14692;2023;23;23;0;100;0;256003.043478261;2370.08695652174;107.391304347826
14694;2023;6;6;0;100;0;358066.666666667;2979.33333333333;116.666666666667
14698;2023;2;2;0;100;0;188825;2498;73
14699;2023;67;26;41;38.8059701492537;61.1940298507463;243250.313432836;3795.17910447761;66.0149253731343
14700;2023;9;9;0;100;0;261002.222222222;2395.55555555556;107.555555555556
14701;2023;61;13;48;21.3114754098361;78.6885245901639;366020.868852459;5594.44262295082;65.5409836065574
14705;2023;3;3;0;100;0;128251;1018.33333333333;116.666666666667
14706;2023;3;3;0;100;0;753215;3655.33333333333;216.333333333333
14707;2023;9;8;1;88.8888888888889;11.1111111111111;261505;2578.22222222222;100.222222222222
14708;2023;1;1;0;100;0;249500;2151;116
14709;2023;9;9;0;100;0;331779.444444444;2360.55555555556;141.222222222222
14711;2023;17;15;2;88.2352941176471;11.7647058823529;230591.176470588;2221.29411764706;108.470588235294
14712;2023;46;46;0;100;0;247618.47826087;2460.91304347826;104.326086956522
14713;2023;10;10;0;100;0;218261;1860.6;114.8
14714;2023;7;7;0;100;0;167812.714285714;1895.28571428571;95.8571428571429
14715;2023;285;79;206;27.719298245614;72.280701754386;309973.856140351;5724.88771929825;52.9087719298246
14716;2023;6;6;0;100;0;162391.166666667;1509.83333333333;110.166666666667
14719;2023;7;7;0;100;0;189785.714285714;1952.71428571429;97
14720;2023;8;8;0;100;0;199469.375;1670.375;125.25
14721;2023;4;4;0;100;0;260220;2339.75;113.25
14723;2023;3;3;0;100;0;390823.333333333;3936.33333333333;97.6666666666667
14724;2023;30;25;5;83.3333333333333;16.6666666666667;364135.666666667;4119.5;86.3666666666667
14726;2023;56;56;0;100;0;105996.839285714;1259.625;84.5714285714286
14728;2023;15;15;0;100;0;258967;2448.73333333333;108.933333333333
14731;2023;3;3;0;100;0;1390866.66666667;6102;238.666666666667
14732;2023;2;2;0;100;0;216000;2458;87
14733;2023;2;2;0;100;0;281625;2909;100
14734;2023;2;2;0;100;0;218000;1571;140
14735;2023;9;9;0;100;0;203148.777777778;1748.66666666667;116.777777777778
14737;2023;5;5;0;100;0;209200;1928.8;121.2
14738;2023;30;25;5;83.3333333333333;16.6666666666667;273496;2797.53333333333;106.333333333333
14739;2023;37;36;1;97.2972972972973;2.7027027027027;275177.162162162;2886.48648648649;99.7027027027027
14740;2023;12;12;0;100;0;185058.333333333;1722.5;114.583333333333
14741;2023;4;4;0;100;0;168250;2281.5;84.25
14743;2023;2;2;0;100;0;197500;1887.5;119
14744;2023;1;1;0;100;0;349000;4011;87
14745;2023;6;6;0;100;0;281083.333333333;2162.5;134.166666666667
14747;2023;8;6;2;75;25;207887.5;2079.5;100.875
14748;2023;1;1;0;100;0;69050;2092;33
14751;2023;8;8;0;100;0;174341.875;1844.875;94.875
14752;2023;25;24;1;96;4;260446.8;2398.76;116.92
14753;2023;5;5;0;100;0;171350;1793.6;94.8
14754;2023;343;56;287;16.3265306122449;83.6734693877551;200169.941690962;4654.38775510204;41.6938775510204
14755;2023;17;10;7;58.8235294117647;41.1764705882353;317058.823529412;4300.47058823529;76.2941176470588
14756;2023;1;1;0;100;0;79500;1445;55
14758;2023;4;4;0;100;0;349337.5;2337;150
14759;2023;2;2;0;100;0;91500;897;105.5
14760;2023;7;7;0;100;0;273642.857142857;2323.28571428571;118
14761;2023;5;3;2;60;40;206450;2323.6;90.4
14762;2023;225;162;63;72;28;136650.137777778;1637.04;87.7733333333333
14764;2023;11;11;0;100;0;88709.0909090909;1224.54545454545;75.9090909090909
15001;2023;7;7;0;100;0;48342.8571428571;630.714285714286;77.1428571428571
15002;2023;1;1;0;100;0;24000;400;60
15003;2023;10;10;0;100;0;82975;1011.1;82.6
15004;2023;1;1;0;100;0;119765;998;120
15005;2023;1;0;1;0;100;430000;3613;119
15006;2023;13;13;0;100;0;140457.692307692;1626.53846153846;92.8461538461538
15008;2023;5;5;0;100;0;90600;994;89.6
15009;2023;5;5;0;100;0;86700;817;111.2
15010;2023;4;4;0;100;0;92370.75;1104.5;101.75
15011;2023;1;1;0;100;0;88000;715;123
15012;2023;72;48;24;66.6666666666667;33.3333333333333;145142.708333333;1767.09722222222;80.0694444444444
15013;2023;1;1;0;100;0;481000;5344;90
15014;2023;458;118;340;25.764192139738;74.235807860262;120208.172489083;1546.70305676856;76.9497816593886
15015;2023;1;1;0;100;0;50000;625;80
15016;2023;8;8;0;100;0;148159.375;1287.375;115.75
15017;2023;1;1;0;100;0;37500;852;44
15018;2023;1;1;0;100;0;40000;500;80
15019;2023;3;3;0;100;0;103833.333333333;1559.66666666667;73.3333333333333
15021;2023;7;7;0;100;0;122585.714285714;1261.28571428571;117.714285714286
15022;2023;2;2;0;100;0;109000;1209.5;89
15024;2023;1;1;0;100;0;135000;1250;108
15025;2023;3;3;0;100;0;94463.3333333333;1415.66666666667;69.3333333333333
15026;2023;5;5;0;100;0;138950;1725.4;83.4
15027;2023;6;6;0;100;0;125555.833333333;1351.16666666667;97
15028;2023;6;6;0;100;0;161362.833333333;1543;117.166666666667
15029;2023;8;7;1;87.5;12.5;131308.75;1646.875;77.625
15030;2023;2;2;0;100;0;91900;1381;64.5
15033;2023;3;2;1;66.6666666666667;33.3333333333333;96291.6666666667;1099;87.3333333333333
15036;2023;5;5;0;100;0;87000;931.4;93.8
15037;2023;14;13;1;92.8571428571429;7.14285714285714;84061.0714285714;945.642857142857;89.7857142857143
15038;2023;20;20;0;100;0;108951.25;1047.45;111.55
15040;2023;2;2;0;100;0;74500;1241.5;60
15042;2023;6;6;0;100;0;57166.6666666667;792.166666666667;78.1666666666667
15045;2023;13;8;5;61.5384615384615;38.4615384615385;60625.7692307692;1005.23076923077;66.3076923076923
15046;2023;3;3;0;100;0;153466.666666667;1665.33333333333;89.3333333333333
15049;2023;2;2;0;100;0;86250;1562.5;50
15050;2023;3;3;0;100;0;108800;1264.66666666667;90.6666666666667
15051;2023;4;4;0;100;0;47042.5;551.5;85.75
15052;2023;1;1;0;100;0;86000;1623;53
15053;2023;4;4;0;100;0;183525;2075.5;94.5
15054;2023;19;19;0;100;0;95700.5263157895;1059.52631578947;94.8947368421053
15055;2023;2;2;0;100;0;181997.5;2171;86
15056;2023;8;8;0;100;0;189350;1748.5;110.75
15057;2023;1;1;0;100;0;35000;565;62
15059;2023;2;2;0;100;0;190000;1900;100
15061;2023;6;6;0;100;0;86970;1576.66666666667;60.6666666666667
15063;2023;4;4;0;100;0;118000;1066.75;106.75
15064;2023;1;1;0;100;0;42000;700;60
15066;2023;5;5;0;100;0;90400;1227;69.8
15069;2023;3;3;0;100;0;52000;763;66.6666666666667
15070;2023;3;3;0;100;0;114333.333333333;1243.33333333333;98.6666666666667
15072;2023;2;2;0;100;0;55000;622.5;92
15073;2023;1;1;0;100;0;120000;923;130
15074;2023;6;6;0;100;0;186491.666666667;1784;105.666666666667
15075;2023;2;2;0;100;0;74000;1233;60
15076;2023;2;2;0;100;0;57500;908;63.5
15077;2023;1;1;0;100;0;37000;514;72
15079;2023;7;7;0;100;0;90321.4285714286;1064.14285714286;83.7142857142857
15080;2023;2;2;0;100;0;87675;768.5;114.5
15081;2023;2;2;0;100;0;203728.5;1640.5;144
15082;2023;4;4;0;100;0;108000;1195.75;88
15083;2023;16;16;0;100;0;154795.3125;1636.875;101.8125
15084;2023;1;1;0;100;0;88000;1143;77
15085;2023;2;2;0;100;0;180800;2102.5;86
15086;2023;1;1;0;100;0;106000;1413;75
15087;2023;4;4;0;100;0;157875;1538.25;105.5
15088;2023;9;9;0;100;0;148141.111111111;2037.55555555556;78.4444444444444
15089;2023;4;4;0;100;0;128433.75;1879.75;66.75
15090;2023;8;8;0;100;0;185481.25;1729.5;110
15091;2023;1;1;0;100;0;50000;893;56
15092;2023;7;7;0;100;0;135295.714285714;1426.28571428571;95.5714285714286
15093;2023;3;3;0;100;0;144000;1851.66666666667;87.6666666666667
15094;2023;12;12;0;100;0;92740.6666666667;1088.16666666667;81.8333333333333
15095;2023;3;3;0;100;0;93333.3333333333;1279;73
15096;2023;3;3;0;100;0;66966.6666666667;1050;64
15098;2023;1;1;0;100;0;47700;701;68
15100;2023;1;1;0;100;0;114980;1065;108
15101;2023;24;4;20;16.6666666666667;83.3333333333333;83854.9166666667;2440.79166666667;36.0833333333333
15103;2023;1;1;0;100;0;65000;929;70
15104;2023;7;7;0;100;0;75156.4285714286;1239.57142857143;68.8571428571429
15105;2023;3;3;0;100;0;48833.3333333333;941.666666666667;54.6666666666667
15106;2023;3;3;0;100;0;128433.333333333;1078;113
15108;2023;7;7;0;100;0;151402.857142857;1759.71428571429;97.5714285714286
15110;2023;2;2;0;100;0;65000;741.5;86
15111;2023;5;5;0;100;0;56986;821.6;67.2
15112;2023;1;1;0;100;0;110000;2292;48
15113;2023;5;5;0;100;0;145044.6;2071.6;75.8
15114;2023;9;7;2;77.7777777777778;22.2222222222222;94505.5555555556;1333.55555555556;88.1111111111111
15116;2023;1;0;1;0;100;45000;900;50
15117;2023;11;8;3;72.7272727272727;27.2727272727273;102690;991.818181818182;107.181818181818
15118;2023;8;7;1;87.5;12.5;164710.75;2050.625;97
15119;2023;24;21;3;87.5;12.5;131329.583333333;1794.45833333333;90.3333333333333
15120;2023;44;31;13;70.4545454545455;29.5454545454545;101545.909090909;1292.90909090909;84.3181818181818
15122;2023;20;18;2;90;10;124254.85;1420.15;93.1
15123;2023;2;2;0;100;0;92400;777;124.5
15124;2023;8;7;1;87.5;12.5;108762.5;1297.625;76.375
15126;2023;1;0;1;0;100;85000;1932;44
15127;2023;4;4;0;100;0;172151;1942;100.75
15128;2023;1;1;0;100;0;109300;1497;73
15130;2023;1;1;0;100;0;29000;453;64
15131;2023;1;1;0;100;0;84000;1050;80
15132;2023;1;1;0;100;0;67800;997;68
15133;2023;1;1;0;100;0;35000;556;63
15134;2023;8;7;1;87.5;12.5;75500;1048.25;69.625
15135;2023;3;3;0;100;0;165183.333333333;1498.66666666667;108.333333333333
15137;2023;4;4;0;100;0;126037.5;867.25;125.5
15138;2023;12;6;6;50;50;112605.5;1301.16666666667;77.4166666666667
15140;2023;27;25;2;92.5925925925926;7.40740740740741;178340.851851852;1774.77777777778;101.407407407407
15141;2023;18;18;0;100;0;115711.5;1228.66666666667;92.4444444444444
15142;2023;12;12;0;100;0;108780.333333333;1346.91666666667;80.6666666666667
15143;2023;1;1;0;100;0;68000;716;95
15144;2023;6;6;0;100;0;83044.3333333333;1233.66666666667;68
15146;2023;6;6;0;100;0;124783.333333333;1242;107.666666666667
15147;2023;9;8;1;88.8888888888889;11.1111111111111;141712.333333333;1472.77777777778;106
15148;2023;2;2;0;100;0;77000;1137.5;100.5
15151;2023;3;3;0;100;0;92766.6666666667;1113.66666666667;80
15152;2023;6;6;0;100;0;108650;1163.5;93.5
15153;2023;24;24;0;100;0;127087.416666667;1280.33333333333;106.208333333333
15154;2023;18;17;1;94.4444444444444;5.55555555555556;162069.5;1565.66666666667;101.666666666667
15155;2023;2;2;0;100;0;44000;637;62.5
15156;2023;7;7;0;100;0;171489.714285714;1665.57142857143;105.428571428571
15157;2023;2;2;0;100;0;85000;999.5;79
15159;2023;2;2;0;100;0;81492.5;963;85.5
15160;2023;14;14;0;100;0;176957.857142857;1744.5;97.8571428571429
15161;2023;1;1;0;100;0;71000;877;81
15162;2023;38;27;11;71.0526315789474;28.9473684210526;96868.9473684211;1124.5;83.5526315789474
15163;2023;6;6;0;100;0;158650;1836.33333333333;82.8333333333333
15164;2023;3;3;0;100;0;189766.666666667;1450.66666666667;144
15165;2023;2;2;0;100;0;66500;873.5;78
15166;2023;2;2;0;100;0;208525;1903;109.5
15167;2023;1;1;0;100;0;119000;1082;110
15168;2023;8;7;1;87.5;12.5;162820;1815.75;95.5
15169;2023;12;12;0;100;0;95868.3333333333;978.666666666667;96.5
15170;2023;6;5;1;83.3333333333333;16.6666666666667;113816.666666667;1529.66666666667;75
15172;2023;2;2;0;100;0;114210;1142.5;106
15173;2023;2;1;1;50;50;84000;1006.5;80
15174;2023;5;5;0;100;0;123260;1221;97.2
15175;2023;15;14;1;93.3333333333333;6.66666666666667;101485.333333333;1079.2;91.4
15176;2023;6;6;0;100;0;89693;913;99.5
15179;2023;4;4;0;100;0;175875;2236.5;76.5
15180;2023;1;1;0;100;0;122670;1614;76
15181;2023;2;2;0;100;0;139335;1999;66.5
15182;2023;3;3;0;100;0;197000;1863.66666666667;104.333333333333
15183;2023;1;1;0;100;0;69500;1448;48
15184;2023;9;9;0;100;0;159877.777777778;1828.66666666667;86.5555555555556
15185;2023;2;2;0;100;0;130000;1541;84
15186;2023;3;3;0;100;0;105566.666666667;839.333333333333;124
15187;2023;53;29;24;54.7169811320755;45.2830188679245;121334.433962264;1441.33962264151;83.3018867924528
15188;2023;1;1;0;100;0;97400;1299;75
15189;2023;4;4;0;100;0;177961.25;1450.25;113.5
15191;2023;3;3;0;100;0;110333.333333333;1146.66666666667;107.333333333333
15192;2023;16;13;3;81.25;18.75;135998.5625;2228.5;75.3125
15194;2023;1;1;0;100;0;72000;1108;65
15196;2023;8;8;0;100;0;147508.625;1634;86.5
15200;2023;1;1;0;100;0;50000;1111;45
15201;2023;2;2;0;100;0;52118;661;78
15202;2023;12;12;0;100;0;107922.666666667;992;110.666666666667
15203;2023;2;2;0;100;0;108500;1002;109
15204;2023;18;17;1;94.4444444444444;5.55555555555556;124949.166666667;1464.22222222222;86.7777777777778
15205;2023;1;1;0;100;0;35000;700;50
15206;2023;1;1;0;100;0;80000;1600;50
15207;2023;2;2;0;100;0;97375;1289;75
15208;2023;1;1;0;100;0;169750;2122;80
15211;2023;1;1;0;100;0;108300;656;165
15212;2023;4;4;0;100;0;88325;1084.25;81.5
15213;2023;1;1;0;100;0;108000;1385;78
15214;2023;1;1;0;100;0;70000;933;75
15215;2023;4;4;0;100;0;243250;2747.75;86.5
15216;2023;6;5;1;83.3333333333333;16.6666666666667;165991.666666667;2012.66666666667;82.6666666666667
15217;2023;1;1;0;100;0;107830;980;110
15218;2023;1;1;0;100;0;90000;1023;88
15219;2023;4;4;0;100;0;109625;1635;68.5
15220;2023;2;2;0;100;0;106924;4455.5;24
15221;2023;9;8;1;88.8888888888889;11.1111111111111;233214.444444444;2553;110.111111111111
15222;2023;3;3;0;100;0;91333.3333333333;1505.66666666667;62
15225;2023;3;3;0;100;0;78666.6666666667;665;128.333333333333
15226;2023;3;3;0;100;0;119580;3269;45.3333333333333
15228;2023;2;2;0;100;0;55000;709;77.5
15230;2023;1;1;0;100;0;40000;588;68
15231;2023;3;3;0;100;0;98966.6666666667;1083.66666666667;83.6666666666667
15232;2023;2;2;0;100;0;126000;1657;69.5
15233;2023;3;3;0;100;0;248050;1912.33333333333;131.666666666667
15234;2023;4;4;0;100;0;187622.5;1652.75;116
15235;2023;5;5;0;100;0;60680;1023.2;60
15236;2023;3;3;0;100;0;177876.666666667;1199.33333333333;143
15237;2023;1;1;0;100;0;298460;2595;115
15238;2023;1;1;0;100;0;227792;2071;110
15240;2023;2;2;0;100;0;25500;664.5;37.5
15241;2023;2;2;0;100;0;87500;1282.5;70.5
15243;2023;7;7;0;100;0;56000;812.142857142857;80.4285714285714
15244;2023;2;2;0;100;0;147750;1458;101
15246;2023;4;4;0;100;0;115275;1248.5;93.25
15248;2023;2;2;0;100;0;195650;1682.5;116.5
15249;2023;2;2;0;100;0;88825;862.5;115
15250;2023;4;4;0;100;0;129875;899.75;140.5
15251;2023;1;1;0;100;0;100070;1100;91
15252;2023;3;3;0;100;0;134000;1562.33333333333;85.6666666666667
15253;2023;1;1;0;100;0;135500;948;143
15254;2023;3;3;0;100;0;88666.6666666667;824.666666666667;112
15255;2023;15;15;0;100;0;169797.8;2052.06666666667;86.4666666666667
15256;2023;3;3;0;100;0;84133.3333333333;708.666666666667;103.666666666667
15257;2023;3;3;0;100;0;86333.3333333333;1109;82.3333333333333
15258;2023;22;13;9;59.0909090909091;40.9090909090909;110295.909090909;1311.63636363636;88.2272727272727
15259;2023;3;3;0;100;0;111466.666666667;930.666666666667;117.666666666667
15260;2023;3;3;0;100;0;59884;967;65.3333333333333
15261;2023;4;4;0;100;0;81750;1009;84
15262;2023;2;2;0;100;0;116925.5;1461.5;80
15264;2023;2;2;0;100;0;48900;781;67.5
15265;2023;19;18;1;94.7368421052632;5.26315789473684;74684.2105263158;961.421052631579;82.3157894736842
15266;2023;7;7;0;100;0;182887.142857143;1937.71428571429;95.1428571428571
15267;2023;30;30;0;100;0;201719;1920.46666666667;105.633333333333
15268;2023;9;9;0;100;0;163144.444444444;1862.88888888889;83.5555555555556
15269;2023;2;2;0;100;0;125000;1756.5;74
16001;2023;6;6;0;100;0;66641.6666666667;842.333333333333;88
16002;2023;9;9;0;100;0;134295;1249.44444444444;107.888888888889
16003;2023;17;17;0;100;0;160418.176470588;1533.05882352941;105.941176470588
16005;2023;29;29;0;100;0;91513.4482758621;938.344827586207;98.5172413793103
16007;2023;5;5;0;100;0;119700;1332;84
16008;2023;4;4;0;100;0;91000;973.5;91.75
16009;2023;9;9;0;100;0;89677.7777777778;875;96.7777777777778
16011;2023;6;6;0;100;0;183316.666666667;1564;121.666666666667
16012;2023;4;4;0;100;0;296400;2001.75;142
16013;2023;2;2;0;100;0;218094;1401;150
16014;2023;1;1;0;100;0;107600;1582;68
16015;2023;728;416;312;57.1428571428571;42.8571428571429;144460.615384615;1890.55906593407;78.7335164835165
16016;2023;10;10;0;100;0;114485;1095;106.1
16018;2023;9;9;0;100;0;266111.111111111;1653;163.888888888889
16019;2023;8;8;0;100;0;223467.5;2031.5;107.375
16020;2023;9;9;0;100;0;224450.555555556;2266.33333333333;114.555555555556
16023;2023;6;6;0;100;0;153938.666666667;1575.33333333333;103.166666666667
16024;2023;6;6;0;100;0;242631.666666667;1572.33333333333;147
16025;2023;9;9;0;100;0;180249.333333333;1481.88888888889;115.222222222222
16026;2023;13;13;0;100;0;220789;1985.46153846154;110.538461538462
16028;2023;56;56;0;100;0;142933.910714286;1408.10714285714;103.982142857143
16030;2023;13;13;0;100;0;218183.384615385;1861.53846153846;117
16031;2023;1;1;0;100;0;259000;1850;140
16032;2023;7;7;0;100;0;154750;1436.28571428571;103.428571428571
16034;2023;2;2;0;100;0;63500;1029;73
16035;2023;5;5;0;100;0;120189.6;988.8;120.4
16036;2023;1;1;0;100;0;60000;500;120
16037;2023;4;4;0;100;0;180250;1587.25;123
16038;2023;10;10;0;100;0;70657.9;745.1;88.2
16039;2023;3;3;0;100;0;73166.6666666667;1279.66666666667;58.6666666666667
16040;2023;3;3;0;100;0;383946;6308.66666666667;88.3333333333333
16041;2023;2;2;0;100;0;260025;1232;187.5
16044;2023;2;2;0;100;0;129525;846;143
16045;2023;5;5;0;100;0;174150;1652.8;108.6
16046;2023;13;13;0;100;0;133761.538461538;1369.69230769231;94.6923076923077
16047;2023;5;5;0;100;0;292130;2112.2;150.4
16048;2023;1;1;0;100;0;90000;459;196
16049;2023;7;7;0;100;0;231828.428571429;1878.14285714286;118.142857142857
16050;2023;1;1;0;100;0;96000;611;157
16052;2023;6;6;0;100;0;155197.5;1358;105.166666666667
16053;2023;2;2;0;100;0;105000;1460;68.5
16054;2023;4;4;0;100;0;64692.5;809.75;76.5
16055;2023;8;8;0;100;0;156637.5;1407.25;110.125
16056;2023;4;4;0;100;0;277125;1717.25;128.75
16057;2023;3;3;0;100;0;221666.666666667;1817.66666666667;124
16058;2023;18;18;0;100;0;227070.888888889;1878.61111111111;121.722222222222
16059;2023;1;1;0;100;0;77130;1015;76
16060;2023;5;5;0;100;0;174607;1454;116.8
16061;2023;27;27;0;100;0;163003.037037037;1788.96296296296;92.2592592592593
16062;2023;1;1;0;100;0;246990;1752;141
16063;2023;1;1;0;100;0;95000;1583;60
16064;2023;15;14;1;93.3333333333333;6.66666666666667;89356.5333333333;1120.46666666667;83.0666666666667
16065;2023;8;8;0;100;0;72038.75;914.5;78.625
16066;2023;13;13;0;100;0;145405.615384615;1728.15384615385;96.1538461538462
16067;2023;1;1;0;100;0;160400;1865;86
16068;2023;15;15;0;100;0;97458;1067.13333333333;92.2
16069;2023;10;10;0;100;0;94245;1029.2;91.3
16070;2023;28;27;1;96.4285714285714;3.57142857142857;83942.6785714286;865.035714285714;97.25
16071;2023;6;6;0;100;0;84616.6666666667;1040;79.1666666666667
16072;2023;4;4;0;100;0;126575;1409.25;92.75
16073;2023;38;37;1;97.3684210526316;2.63157894736842;95170.0263157895;1042.68421052632;90.8947368421053
16074;2023;3;3;0;100;0;175390;1491.33333333333;121.666666666667
16075;2023;4;4;0;100;0;160500;1402.25;118
16076;2023;12;12;0;100;0;106508.333333333;1093.66666666667;94.5833333333333
16077;2023;2;2;0;100;0;156250;1774;90.5
16078;2023;55;55;0;100;0;181160.636363636;1665.87272727273;110.018181818182
16079;2023;2;2;0;100;0;131500;1449.5;91
16081;2023;5;5;0;100;0;101040;1140.2;84
16082;2023;5;5;0;100;0;274620;1938.6;138.8
16083;2023;10;10;0;100;0;111366;1005.1;111
16084;2023;6;6;0;100;0;163916.666666667;1879.83333333333;101.166666666667
16085;2023;40;38;2;95;5;140261;1373.075;101.025
16086;2023;15;15;0;100;0;110136.666666667;1095.2;105.733333333333
16087;2023;4;4;0;100;0;53850;801;72.75
16088;2023;11;11;0;100;0;192140.727272727;1979.27272727273;96.2727272727273
16089;2023;30;29;1;96.6666666666667;3.33333333333333;156620;1724.13333333333;92.7666666666667
16090;2023;34;32;2;94.1176470588235;5.88235294117647;150023.823529412;1316.61764705882;115.294117647059
16091;2023;1;1;0;100;0;71300;594;120
16093;2023;13;13;0;100;0;149455.769230769;1391.23076923077;106.615384615385
16095;2023;3;3;0;100;0;282933.333333333;1429.33333333333;198.666666666667
16096;2023;4;4;0;100;0;88375;1357.25;67.25
16097;2023;25;25;0;100;0;153745.04;1614.24;99.48
16099;2023;4;4;0;100;0;65338.25;927;75.25
16100;2023;5;5;0;100;0;196383.6;1310.6;149
16101;2023;11;11;0;100;0;159037.818181818;1412.72727272727;113.545454545455
16102;2023;306;231;75;75.4901960784314;24.5098039215686;167799.692810458;1902.83660130719;90.359477124183
16103;2023;3;3;0;100;0;196533.333333333;2000.66666666667;100.666666666667
16104;2023;9;9;0;100;0;171510.555555556;1647.55555555556;98.5555555555556
16105;2023;8;8;0;100;0;180431.25;1533.625;124.5
16106;2023;48;47;1;97.9166666666667;2.08333333333333;109589.166666667;1197.25;99.5208333333333
16107;2023;2;2;0;100;0;146500;1227;113.5
16109;2023;11;11;0;100;0;122922.727272727;1423.90909090909;87.2727272727273
16110;2023;8;7;1;87.5;12.5;97315.375;1125.25;92.375
16112;2023;1;1;0;100;0;174580;1455;120
16113;2023;65;55;10;84.6153846153846;15.3846153846154;145558.215384615;1700.92307692308;90.0153846153846
16114;2023;3;3;0;100;0;98216.3333333333;1164.66666666667;82
16116;2023;3;3;0;100;0;2,00E+05;1578;131.333333333333
16118;2023;1;1;0;100;0;40000;571;70
16119;2023;23;23;0;100;0;128906.347826087;1361.30434782609;94.5652173913043
16120;2023;7;7;0;100;0;196785.714285714;1941.57142857143;99.8571428571429
16121;2023;4;4;0;100;0;116625;1617.25;65.75
16122;2023;2;2;0;100;0;70200;791;102
16123;2023;5;5;0;100;0;119600;1233.6;91.2
16124;2023;43;43;0;100;0;90574.6046511628;1201.3488372093;76.2790697674419
16125;2023;3;3;0;100;0;87625;1162;69
16127;2023;3;3;0;100;0;176078.333333333;1176.66666666667;154.333333333333
16128;2023;2;2;0;100;0;79020;994;82
16130;2023;5;5;0;100;0;118537.8;819.6;140.6
16131;2023;5;5;0;100;0;110100;1195.2;97.8
16132;2023;6;6;0;100;0;169288.333333333;1756.5;93.5
16133;2023;2;2;0;100;0;106118.5;1510.5;76
16134;2023;19;19;0;100;0;112961.947368421;1089.84210526316;103.105263157895
16135;2023;3;3;0;100;0;93333.3333333333;829.666666666667;98.3333333333333
16136;2023;9;9;0;100;0;123287.222222222;1185.55555555556;108.111111111111
16137;2023;1;1;0;100;0;185000;1423;130
16138;2023;40;31;9;77.5;22.5;206868.5;2050;96.375
16141;2023;8;8;0;100;0;95660.125;1003.5;95.875
16142;2023;3;3;0;100;0;107833.333333333;848.333333333333;118.666666666667
16143;2023;7;7;0;100;0;151327;1571.14285714286;103.857142857143
16144;2023;9;9;0;100;0;138036.222222222;1623.11111111111;99.3333333333333
16145;2023;6;6;0;100;0;211498.333333333;1793;108.333333333333
16146;2023;21;21;0;100;0;197041.285714286;1791.80952380952;113.095238095238
16147;2023;3;3;0;100;0;144766.666666667;1371.66666666667;111
16148;2023;15;15;0;100;0;140635.133333333;1297;112.2
16150;2023;20;20;0;100;0;203067.05;1798.45;114.15
16151;2023;5;5;0;100;0;234916;1766.6;135.4
16152;2023;6;6;0;100;0;149433.333333333;1700.33333333333;88.6666666666667
16153;2023;13;13;0;100;0;210582.307692308;1907;119.076923076923
16154;2023;12;12;0;100;0;157820;1832.66666666667;83.1666666666667
16155;2023;1;1;0;100;0;159195;926;172
16157;2023;4;4;0;100;0;131125;1352.5;95.5
16158;2023;3;3;0;100;0;86746;1095.66666666667;81.3333333333333
16160;2023;2;2;0;100;0;148000;1281;108
16161;2023;1;1;0;100;0;114200;1903;60
16162;2023;2;2;0;100;0;259225;1649.5;153.5
16163;2023;12;12;0;100;0;132428;1469.33333333333;92.3333333333333
16164;2023;8;8;0;100;0;157762.5;1328.875;120.375
16165;2023;4;4;0;100;0;144250;1201.75;99.5
16166;2023;83;65;18;78.3132530120482;21.6867469879518;147844.879518072;1798.95180722892;81.7831325301205
16167;2023;79;72;7;91.1392405063291;8.86075949367089;184669.493670886;1680.3417721519;109.278481012658
16168;2023;12;12;0;100;0;163960;1377.83333333333;124.833333333333
16169;2023;7;7;0;100;0;195590.428571429;1554.28571428571;120
16170;2023;7;7;0;100;0;135166.285714286;1599.71428571429;87.2857142857143
16171;2023;8;8;0;100;0;249432.5;1547;180
16173;2023;5;5;0;100;0;127000;912.4;142.8
16174;2023;4;4;0;100;0;272002.25;2121.5;127.25
16175;2023;6;6;0;100;0;179500;1943.66666666667;106.333333333333
16176;2023;4;4;0;100;0;106250;912.75;117.25
16177;2023;4;4;0;100;0;186675;1865.75;107.5
16178;2023;2;2;0;100;0;243000;2547.5;94.5
16180;2023;3;3;0;100;0;132899;1201.66666666667;121.333333333333
16181;2023;9;9;0;100;0;82173.8888888889;1057.88888888889;78.5555555555556
16182;2023;7;7;0;100;0;102856.428571429;1318.85714285714;101.571428571429
16183;2023;6;6;0;100;0;235750;2080.33333333333;100.666666666667
16186;2023;5;5;0;100;0;127500;1104.6;118.6
16187;2023;21;21;0;100;0;169112.666666667;1609.33333333333;109.047619047619
16188;2023;8;8;0;100;0;232319.625;1947.25;134.625
16189;2023;4;4;0;100;0;114846.25;917.25;120.5
16190;2023;5;5;0;100;0;119300.2;962.6;122.2
16191;2023;2;2;0;100;0;114000;1218.5;98.5
16192;2023;47;47;0;100;0;99673.8510638298;1036.27659574468;96.8936170212766
16193;2023;4;4;0;100;0;126250;1537.75;80.25
16194;2023;3;3;0;100;0;99233.3333333333;928;123.666666666667
16195;2023;5;5;0;100;0;155710;1103.4;139
16196;2023;17;17;0;100;0;123672.117647059;1197.94117647059;100.352941176471
16197;2023;1;1;0;100;0;31500;543;58
16198;2023;3;3;0;100;0;210040;1661.66666666667;135.333333333333
16199;2023;34;34;0;100;0;151078.911764706;1739.58823529412;86.9705882352941
16200;2023;5;5;0;100;0;104200;1113;94.2
16203;2023;3;3;0;100;0;148333.333333333;1721.33333333333;82
16204;2023;13;13;0;100;0;171082.076923077;1319.92307692308;131.230769230769
16205;2023;11;11;0;100;0;162495;2153.54545454545;87
16206;2023;20;20;0;100;0;134150.8;1063.7;122.45
16207;2023;14;14;0;100;0;116991.428571429;1223.35714285714;109.642857142857
16208;2023;2;2;0;100;0;160000;1181.5;146
16209;2023;5;5;0;100;0;135200;1310;106.2
16210;2023;4;4;0;100;0;227625;1603;126.5
16211;2023;9;9;0;100;0;117811.111111111;1217.33333333333;97.1111111111111
16212;2023;8;8;0;100;0;157973.375;1524.125;88.375
16213;2023;5;5;0;100;0;100200;1171.8;79.8
16215;2023;5;5;0;100;0;124050;1566;76.8
16216;2023;8;8;0;100;0;178437.5;1395.625;132.375
16217;2023;17;16;1;94.1176470588235;5.88235294117647;201260.588235294;1987.47058823529;102.588235294118
16218;2023;6;6;0;100;0;238298.666666667;1611;144.833333333333
16220;2023;7;7;0;100;0;209189.142857143;2002.28571428571;103.285714285714
16221;2023;2;2;0;100;0;177662;1586;105.5
16222;2023;4;4;0;100;0;236450;1699;128.75
16223;2023;34;33;1;97.0588235294118;2.94117647058824;136821.382352941;1311.61764705882;103.647058823529
16224;2023;4;4;0;100;0;163970;1139.5;143
16225;2023;15;15;0;100;0;92120;1046.13333333333;86.8666666666667
16226;2023;14;14;0;100;0;117475.357142857;1493.14285714286;82.0714285714286
16227;2023;4;3;1;75;25;138134.25;1356.75;93.25
16229;2023;6;6;0;100;0;116309.166666667;831.5;142
16230;2023;23;23;0;100;0;153860.565217391;1574.78260869565;105.260869565217
16231;2023;5;5;0;100;0;120114;1807;74.6
16232;2023;15;15;0;100;0;182683.2;1723.26666666667;104
16233;2023;7;7;0;100;0;143050;1372.57142857143;98.2857142857143
16234;2023;13;13;0;100;0;267630.769230769;1777.53846153846;148.846153846154
16236;2023;24;24;0;100;0;155293.291666667;1632.54166666667;99.0833333333333
16237;2023;2;2;0;100;0;111250;1019.5;103
16238;2023;3;3;0;100;0;101000;1031.66666666667;114.333333333333
16239;2023;2;2;0;100;0;117425;1232;104
16241;2023;6;6;0;100;0;178564.166666667;1749.66666666667;120.666666666667
16242;2023;24;24;0;100;0;140301.708333333;1407.33333333333;105.166666666667
16243;2023;15;15;0;100;0;219771.933333333;1643.33333333333;129.6
16244;2023;32;29;3;90.625;9.375;164826.09375;1629.09375;98.90625
16245;2023;11;11;0;100;0;82068.1818181818;1258.45454545455;83.5454545454545
16246;2023;2;2;0;100;0;185000;1228;137.5
16249;2023;6;6;0;100;0;69931.6666666667;975.5;71.1666666666667
16250;2023;4;4;0;100;0;111000;951.25;113.25
16251;2023;2;2;0;100;0;125500;948.5;148
16253;2023;8;8;0;100;0;159627.625;1226.25;137.875
16254;2023;2;2;0;100;0;190750;1994;101
16255;2023;2;2;0;100;0;104000;1142.5;91.5
16256;2023;3;3;0;100;0;117553.333333333;868.333333333333;152.333333333333
16258;2023;6;6;0;100;0;106500;1133.16666666667;106.166666666667
16260;2023;3;3;0;100;0;78500;1349.33333333333;62.6666666666667
16261;2023;4;4;0;100;0;151250;1442.25;110.75
16263;2023;3;3;0;100;0;250321.666666667;1507.66666666667;167.666666666667
16264;2023;3;3;0;100;0;152424.333333333;1209;124.666666666667
16267;2023;1;1;0;100;0;123000;1538;80
16268;2023;4;4;0;100;0;120630;1108;120
16269;2023;8;8;0;100;0;177351.625;1676.125;108.25
16270;2023;10;10;0;100;0;98394.8;1043;99.2
16271;2023;29;29;0;100;0;202594.448275862;1907.06896551724;105.586206896552
16272;2023;10;10;0;100;0;160337;1509.1;96.9
16273;2023;3;3;0;100;0;247562.333333333;1961.33333333333;126
16275;2023;2;2;0;100;0;122300;1212;101
16276;2023;5;5;0;100;0;147744;1575.4;91.8
16277;2023;6;6;0;100;0;252401.833333333;1957.16666666667;114
16279;2023;4;4;0;100;0;135198.75;1613.75;97.75
16280;2023;19;19;0;100;0;174851.157894737;1608.52631578947;112.736842105263
16281;2023;67;63;4;94.0298507462687;5.97014925373134;149117.791044776;1588.91044776119;94.6865671641791
16282;2023;8;8;0;100;0;107675;1092.375;100.375
16283;2023;4;4;0;100;0;102250;891.75;120
16285;2023;5;5;0;100;0;123540;1425.2;82.2
16286;2023;29;29;0;100;0;154584.172413793;1486.79310344828;111
16287;2023;58;57;1;98.2758620689655;1.72413793103448;173200.810344828;1610.25862068966;109.258620689655
16289;2023;5;5;0;100;0;81010.2;962.4;87.4
16290;2023;6;6;0;100;0;215691.666666667;1601.33333333333;150.833333333333
16291;2023;96;91;5;94.7916666666667;5.20833333333333;159777.208333333;1854.41666666667;86.1770833333333
16292;2023;62;58;4;93.5483870967742;6.45161290322581;114569.629032258;1310.75806451613;90.0645161290323
16293;2023;7;7;0;100;0;191014.285714286;2432.57142857143;93.8571428571429
16295;2023;7;7;0;100;0;197138.428571429;1600.71428571429;127.571428571429
16297;2023;4;4;0;100;0;113605;1600.25;90
16298;2023;5;5;0;100;0;163260;1249;133.6
16300;2023;10;10;0;100;0;152138.5;1414.9;105.1
16301;2023;3;3;0;100;0;94540;1192.66666666667;82
16302;2023;1;1;0;100;0;1,00E+05;1111;90
16303;2023;1;1;0;100;0;220000;1719;128
16304;2023;16;16;0;100;0;240287.5;1887.625;126.4375
16306;2023;3;3;0;100;0;149043.333333333;1603.66666666667;93
16307;2023;6;6;0;100;0;224133.333333333;1604.33333333333;131.333333333333
16308;2023;19;18;1;94.7368421052632;5.26315789473684;123989.473684211;1133.42105263158;114.263157894737
16312;2023;8;8;0;100;0;206787.5;1635.5;116.625
16316;2023;3;3;0;100;0;311916;1489.33333333333;190.666666666667
16317;2023;5;5;0;100;0;87140.4;1220.4;73.2
16318;2023;4;4;0;100;0;174358.5;1304.25;133.75
16320;2023;6;6;0;100;0;139644.333333333;1165.16666666667;109.5
16321;2023;1;1;0;100;0;92800;1009;92
16323;2023;2;2;0;100;0;105500;1124.5;95.5
16325;2023;3;3;0;100;0;57400;813.333333333333;61.6666666666667
16326;2023;1;1;0;100;0;80000;964;83
16329;2023;13;13;0;100;0;93280.7692307692;1039;92.3076923076923
16330;2023;13;13;0;100;0;169319.461538462;1628.92307692308;105.384615384615
16334;2023;3;3;0;100;0;136350;1217;110.333333333333
16335;2023;3;3;0;100;0;87333.3333333333;1114.33333333333;91.3333333333333
16336;2023;4;4;0;100;0;92275;1279.75;75.5
16337;2023;6;6;0;100;0;83283.3333333333;959.333333333333;79.6666666666667
16338;2023;3;3;0;100;0;289354.333333333;1494.33333333333;184.333333333333
16339;2023;8;8;0;100;0;129386.625;1480.625;112.75
16340;2023;16;16;0;100;0;268773.375;1995;121.125
16341;2023;42;31;11;73.8095238095238;26.1904761904762;138268.833333333;1728.38095238095;81.1190476190476
16342;2023;4;4;0;100;0;198900;1621.25;128.75
16343;2023;4;4;0;100;0;504900;2795.75;166
16345;2023;1;1;0;100;0;76500;543;141
16346;2023;4;4;0;100;0;354253.75;1925.75;169
16347;2023;9;9;0;100;0;198673;2043.66666666667;110.666666666667
16348;2023;9;9;0;100;0;144788.888888889;1450.77777777778;94.5555555555556
16349;2023;5;5;0;100;0;116900;1398.2;79.2
16350;2023;13;13;0;100;0;132017.076923077;1264.69230769231;106.153846153846
16352;2023;2;2;0;100;0;99312;1226;82.5
16353;2023;15;15;0;100;0;126760.8;1387.53333333333;88.6666666666667
16354;2023;2;2;0;100;0;150500;888;167.5
16355;2023;5;5;0;100;0;223630;1974.8;113.4
16356;2023;2;2;0;100;0;239500;1373;143
16357;2023;1;1;0;100;0;2,00E+05;2174;92
16358;2023;88;82;6;93.1818181818182;6.81818181818182;191211.261363636;2056.89772727273;97.8181818181818
16359;2023;9;9;0;100;0;171588.888888889;1551.66666666667;111.777777777778
16360;2023;1;1;0;100;0;170000;1910;89
16361;2023;3;3;0;100;0;90000;847.666666666667;99.3333333333333
16362;2023;3;3;0;100;0;237333.333333333;1589.33333333333;171.666666666667
16363;2023;11;11;0;100;0;111805.454545455;1213.09090909091;85.1818181818182
16364;2023;1;1;0;100;0;76000;400;190
16365;2023;1;1;0;100;0;169000;2112;80
16366;2023;10;10;0;100;0;208570;1634.3;112
16368;2023;12;12;0;100;0;193958.916666667;1762.58333333333;116.333333333333
16369;2023;10;10;0;100;0;164635;1311.7;119.1
16370;2023;11;11;0;100;0;125013.636363636;1165.81818181818;102.090909090909
16372;2023;1;1;0;100;0;128000;1164;110
16373;2023;6;6;0;100;0;97905.3333333333;825.833333333333;113.833333333333
16374;2023;103;89;14;86.4077669902913;13.5922330097087;157391.961165049;1748.59223300971;89.368932038835
16375;2023;4;4;0;100;0;84577.5;837;103
16377;2023;4;4;0;100;0;148500;1269.5;104
16378;2023;5;5;0;100;0;151738.4;1305.2;117.4
16379;2023;22;22;0;100;0;181120.045454545;1657.04545454545;116.090909090909
16380;2023;4;4;0;100;0;150075;1698;85.75
16381;2023;4;4;0;100;0;135579.5;1261.5;109.25
16382;2023;5;5;0;100;0;224038.4;1816.6;119.2
16383;2023;6;6;0;100;0;147426.666666667;1411.16666666667;103.166666666667
16384;2023;7;6;1;85.7142857142857;14.2857142857143;121100;1246;98.5714285714286
16385;2023;12;12;0;100;0;173588.333333333;1676.66666666667;101.416666666667
16387;2023;8;8;0;100;0;236772.75;1726.125;139
16388;2023;8;8;0;100;0;230213.25;1997.875;118.625
16389;2023;2;2;0;100;0;79057.5;1245.5;63
16390;2023;4;4;0;100;0;86375;1038.25;88
16392;2023;2;2;0;100;0;111750;847;123
16393;2023;22;22;0;100;0;138396.909090909;1373.63636363636;101
16395;2023;3;3;0;100;0;141130.333333333;1308;105.333333333333
16396;2023;1;1;0;100;0;151778;1686;90
16397;2023;8;8;0;100;0;154127.625;1168.5;129.875
16398;2023;1;1;0;100;0;226550;2730;83
16399;2023;2;2;0;100;0;205000;1791;115.5
16400;2023;12;12;0;100;0;193605.75;1644.66666666667;118
16401;2023;1;1;0;100;0;245000;1750;140
16402;2023;6;6;0;100;0;128333.333333333;1366.66666666667;95.3333333333333
16404;2023;4;4;0;100;0;123807.5;1925;59.5
16405;2023;1;1;0;100;0;155000;1490;104
16406;2023;8;8;0;100;0;198867.5;1909.875;108.75
16408;2023;7;7;0;100;0;132357.142857143;1258.42857142857;106.714285714286
16409;2023;11;11;0;100;0;100009.090909091;983.818181818182;101.363636363636
16412;2023;2;2;0;100;0;89400;1073.5;83.5
16413;2023;5;5;0;100;0;194435;1344;144.8
16414;2023;2;2;0;100;0;68500;993.5;73
16415;2023;10;10;0;100;0;147938;1540.9;96.6
16416;2023;9;9;0;100;0;162622.222222222;1453;106.111111111111
16418;2023;17;17;0;100;0;206840.764705882;1808.35294117647;112.764705882353
16419;2023;3;3;0;100;0;46666.6666666667;868.333333333333;61
16420;2023;4;4;0;100;0;127400;960.25;157.75
16421;2023;6;6;0;100;0;231158.5;2141.33333333333;117.333333333333
16422;2023;8;8;0;100;0;204512.5;1604.75;136.75
16423;2023;5;5;0;100;0;136046;1385.4;102.6
16424;2023;7;7;0;100;0;138000;1350;98
16425;2023;5;5;0;100;0;150000;1378.6;107.8
17002;2023;3;3;0;100;0;119666.666666667;1080.66666666667;111.666666666667
17003;2023;57;57;0;100;0;292683.50877193;2946.38596491228;98.2456140350877
17004;2023;4;4;0;100;0;840000;7034.25;118
17005;2023;2;2;0;100;0;169500;1418.5;132.5
17006;2023;2;2;0;100;0;145000;1861.5;74.5
17007;2023;1;1;0;100;0;382000;2616;146
17008;2023;23;22;1;95.6521739130435;4.34782608695652;293208.043478261;2958.86956521739;107.913043478261
17009;2023;13;13;0;100;0;293315.384615385;3148.53846153846;94.3076923076923
17010;2023;48;43;5;89.5833333333333;10.4166666666667;476651.458333333;4651.47916666667;96.5416666666667
17011;2023;4;4;0;100;0;170108.75;1706.75;105.25
17012;2023;3;3;0;100;0;155500;1203.33333333333;119
17013;2023;4;4;0;100;0;122875;1200.25;110
17015;2023;11;11;0;100;0;205697.454545455;2270.18181818182;94.8181818181818
17016;2023;8;8;0;100;0;110673.375;1103.625;111.75
17017;2023;8;8;0;100;0;129926.25;1293.375;97.75
17018;2023;13;13;0;100;0;174280.769230769;1891.30769230769;98.4615384615385
17019;2023;21;21;0;100;0;632536.666666667;7468.04761904762;86.3809523809524
17020;2023;2;2;0;100;0;111500;1438;78
17021;2023;61;50;11;81.9672131147541;18.0327868852459;243102.081967213;2774.96721311475;87.7704918032787
17022;2023;13;13;0;100;0;193192.307692308;1724.07692307692;107
17023;2023;3;3;0;100;0;147666.666666667;1472;102.333333333333
17024;2023;29;28;1;96.551724137931;3.44827586206897;117017.965517241;1153.58620689655;104.379310344828
17025;2023;9;9;0;100;0;138994.444444444;1322.55555555556;101
17026;2023;7;7;0;100;0;135500;1316.42857142857;107
17027;2023;4;4;0;100;0;187750;1454.25;130.25
17028;2023;135;64;71;47.4074074074074;52.5925925925926;260431.844444444;3968.19259259259;68.4666666666667
17029;2023;1;1;0;100;0;160000;1416;113
17030;2023;11;11;0;100;0;233063.636363636;1925.09090909091;122.545454545455
17031;2023;2;2;0;100;0;168500;1312.5;127.5
17032;2023;8;8;0;100;0;263038.125;2380.625;121
17033;2023;4;4;0;100;0;137375;1444;95.75
17034;2023;11;11;0;100;0;245649.090909091;2433.90909090909;101.181818181818
17035;2023;4;4;0;100;0;105984.25;1114;97.75
17036;2023;11;11;0;100;0;256876.363636364;2271.54545454545;121
17037;2023;12;12;0;100;0;98125;877;116.666666666667
17038;2023;9;9;0;100;0;143748.888888889;1583.55555555556;88.4444444444444
17039;2023;1;1;0;100;0;355000;2367;150
17041;2023;19;19;0;100;0;222440.526315789;2328.21052631579;97.1052631578947
17042;2023;4;4;0;100;0;155750;1494;106.75
17043;2023;13;13;0;100;0;179041.538461538;1547;115.769230769231
17044;2023;7;7;0;100;0;237207.142857143;1845.28571428571;135.142857142857
17045;2023;14;14;0;100;0;201841.5;1955.92857142857;111.071428571429
17046;2023;6;6;0;100;0;184441.666666667;1611.16666666667;117
17047;2023;2;2;0;100;0;158655;1322;120
17048;2023;8;8;0;100;0;164858;1245.75;118.625
17050;2023;3;3;0;100;0;123333.333333333;1242.66666666667;111.333333333333
17051;2023;69;67;2;97.1014492753623;2.89855072463768;933788.898550725;8812.60869565217;105.95652173913
17052;2023;6;6;0;100;0;135048.333333333;1389.66666666667;91.5
17053;2023;27;27;0;100;0;171287.407407407;1793.51851851852;104.888888888889
17054;2023;2;2;0;100;0;169357.5;1353.5;117.5
17056;2023;4;4;0;100;0;160787.5;1527.75;110.25
17057;2023;5;5;0;100;0;199400;1934.2;101.6
17058;2023;51;50;1;98.0392156862745;1.96078431372549;233756.647058824;2630.07843137255;91.6666666666667
17059;2023;14;14;0;100;0;442417.142857143;3812;111.071428571429
17060;2023;5;5;0;100;0;189206;1669.2;112.2
17061;2023;5;5;0;100;0;173946;1077.8;155.2
17062;2023;2;2;0;100;0;143000;1470.5;98
17063;2023;8;8;0;100;0;172662.5;1614.5;107.5
17064;2023;41;41;0;100;0;371434.682926829;3401.56097560976;109.048780487805
17065;2023;24;24;0;100;0;253982.916666667;2361.58333333333;112
17066;2023;3;3;0;100;0;155366.666666667;1433.33333333333;90
17067;2023;1;1;0;100;0;65000;1140;57
17068;2023;2;2;0;100;0;107875;1264.5;92
17069;2023;7;7;0;100;0;162089.285714286;1303.14285714286;123.428571428571
17070;2023;10;10;0;100;0;129410;1252.7;102.8
17071;2023;13;13;0;100;0;160944;1242.23076923077;134.692307692308
17072;2023;12;12;0;100;0;145653.333333333;1318.58333333333;116
17073;2023;12;12;0;100;0;187934.25;2039.5;96.5
17074;2023;8;8;0;100;0;169387.75;1463.875;111
17075;2023;16;16;0;100;0;226229.375;2078.25;109.3125
17076;2023;4;4;0;100;0;225147.5;1968.75;99.25
17077;2023;14;14;0;100;0;171199.5;1684.71428571429;103.357142857143
17078;2023;5;5;0;100;0;184700;1559.4;119
17079;2023;23;20;3;86.9565217391304;13.0434782608696;208514.913043478;2398.26086956522;87.7826086956522
17080;2023;11;11;0;100;0;234751.818181818;2763.63636363636;89.9090909090909
17081;2023;3;3;0;100;0;121037.333333333;1265.33333333333;95.3333333333333
17082;2023;3;3;0;100;0;145066.666666667;1588;91.6666666666667
17083;2023;5;5;0;100;0;257880;2459.8;108.4
17084;2023;6;6;0;100;0;115238.5;1260.66666666667;88.6666666666667
17085;2023;3;3;0;100;0;238266.666666667;1832;136.666666666667
17086;2023;59;58;1;98.3050847457627;1.69491525423729;192430.389830508;2079.38983050847;99.2203389830509
17087;2023;5;5;0;100;0;246297;1497.4;154
17089;2023;12;12;0;100;0;165314.75;1872.08333333333;84.8333333333333
17091;2023;25;25;0;100;0;237089.12;2596.68;93.04
17093;2023;83;82;1;98.7951807228916;1.20481927710843;316298.722891566;3676.73493975904;90.9518072289157
17094;2023;148;95;53;64.1891891891892;35.8108108108108;402903.560810811;5342.48648648649;78.4662162162162
17095;2023;2;2;0;100;0;242500;2437.5;105
17096;2023;2;2;0;100;0;124000;1333.5;96
17097;2023;16;16;0;100;0;258850.0625;2312.125;109.0625
17098;2023;10;9;1;90;10;245717.2;2295.4;95
17099;2023;7;7;0;100;0;105755.428571429;1224.28571428571;89.8571428571429
17100;2023;16;16;0;100;0;159230.9375;1509;109.375
17101;2023;8;8;0;100;0;118512.5;1095.75;112.625
17102;2023;14;14;0;100;0;208823.928571429;2266.64285714286;91.0714285714286
17104;2023;5;5;0;100;0;152367.4;1511.2;93.4
17105;2023;7;7;0;100;0;115685.714285714;1271;105.857142857143
17106;2023;5;5;0;100;0;169800;1719.6;104.2
17107;2023;19;19;0;100;0;249162.368421053;2633.21052631579;94.7894736842105
17108;2023;4;4;0;100;0;211751.25;2615.75;91
17109;2023;20;19;1;95;5;333113.35;3672.55;94.85
17110;2023;4;4;0;100;0;148125;1549.25;97.5
17111;2023;10;10;0;100;0;152139.4;1723.6;100.8
17112;2023;13;13;0;100;0;252817.461538462;2108.07692307692;121.692307692308
17113;2023;10;10;0;100;0;157924.1;1475.1;103.7
17114;2023;1;1;0;100;0;66000;776;85
17115;2023;7;7;0;100;0;224011.142857143;1727.14285714286;132.714285714286
17116;2023;1;1;0;100;0;120000;1446;83
17117;2023;1;1;0;100;0;143000;1765;81
17118;2023;4;4;0;100;0;224690.5;2370.5;94.75
17119;2023;10;10;0;100;0;257537.3;2264.3;118
17120;2023;24;23;1;95.8333333333333;4.16666666666667;206835.375;2071.29166666667;102.208333333333
17121;2023;46;42;4;91.304347826087;8.69565217391304;668569.826086957;7699.39130434783;89.5652173913043
17122;2023;3;3;0;100;0;187250;1048.33333333333;196.666666666667
17124;2023;3;3;0;100;0;158516.666666667;1331.33333333333;125.666666666667
17125;2023;4;4;0;100;0;123400;1209.25;109.25
17126;2023;1;1;0;100;0;52500;515;102
17127;2023;57;30;27;52.6315789473684;47.3684210526316;163155.105263158;2078.31578947368;78.2280701754386
17128;2023;9;9;0;100;0;171668.333333333;1565.66666666667;107
17129;2023;2;2;0;100;0;75550;722.5;114
17130;2023;4;4;0;100;0;112000;1307.25;87.75
17131;2023;33;29;4;87.8787878787879;12.1212121212121;195465.939393939;1962.36363636364;105.272727272727
17132;2023;11;11;0;100;0;199684.818181818;1850;113.272727272727
17133;2023;11;11;0;100;0;203757.272727273;1840;117.727272727273
17134;2023;8;8;0;100;0;206862.5;1784.25;130.25
17135;2023;4;4;0;100;0;134500;1136.5;123.75
17136;2023;6;6;0;100;0;356291.666666667;3136.66666666667;116.333333333333
17137;2023;2;2;0;100;0;99000;1122.5;86
17138;2023;9;9;0;100;0;122223.555555556;1308.33333333333;101.333333333333
17139;2023;7;7;0;100;0;165962.142857143;1269.71428571429;126.571428571429
17140;2023;93;84;9;90.3225806451613;9.67741935483871;294696.698924731;4026.70967741935;73.9247311827957
17141;2023;8;8;0;100;0;184162.25;1698.5;104.25
17142;2023;64;56;8;87.5;12.5;399007.25;3545.203125;108.3125
17143;2023;7;5;2;71.4285714285714;28.5714285714286;231487.714285714;1819.42857142857;144.428571428571
17145;2023;7;7;0;100;0;168344.857142857;1382.57142857143;123.285714285714
17146;2023;39;34;5;87.1794871794872;12.8205128205128;229575.794871795;2490.82051282051;94.6410256410256
17147;2023;18;18;0;100;0;167546.888888889;1516;110.277777777778
17148;2023;4;4;0;100;0;249250;2149;119.75
17150;2023;8;8;0;100;0;161085;1609.625;117.875
17151;2023;20;20;0;100;0;237763.25;2696.15;90
17152;2023;14;14;0;100;0;212707.142857143;1941.64285714286;109
17153;2023;24;24;0;100;0;294738.583333333;2900.70833333333;100.208333333333
17154;2023;7;7;0;100;0;236457.142857143;1756.57142857143;136
17155;2023;55;53;2;96.3636363636364;3.63636363636364;273654.563636364;2992.27272727273;92.2909090909091
17156;2023;2;2;0;100;0;102500;1633.5;72.5
17157;2023;1;1;0;100;0;45000;1125;40
17158;2023;25;25;0;100;0;271215.68;2599.28;106.52
17159;2023;3;3;0;100;0;185000;1641.33333333333;105.333333333333
17160;2023;4;4;0;100;0;223700;2265;109
17161;2023;63;58;5;92.0634920634921;7.93650793650794;743906.333333333;7508.68253968254;105.380952380952
17162;2023;7;7;0;100;0;82696.4285714286;1058.28571428571;88.1428571428571
17163;2023;5;5;0;100;0;140200;1816.6;78
17164;2023;23;23;0;100;0;224315.217391304;1910.78260869565;118.391304347826
17165;2023;3;3;0;100;0;123066.666666667;1046;102.666666666667
17166;2023;14;14;0;100;0;208010.714285714;1814.28571428571;117.142857142857
17167;2023;4;4;0;100;0;164513.75;1411.5;114
17168;2023;123;105;18;85.3658536585366;14.6341463414634;343761.008130081;4430.70731707317;81.6178861788618
17171;2023;6;6;0;100;0;211500;1495.33333333333;148.666666666667
17172;2023;38;36;2;94.7368421052632;5.26315789473684;186148.736842105;1764.44736842105;105.131578947368
17173;2023;6;6;0;100;0;117303;963.833333333333;122.833333333333
17174;2023;11;11;0;100;0;187727.272727273;2153.72727272727;92.0909090909091
17175;2023;7;7;0;100;0;162371.428571429;1645.57142857143;103.428571428571
17176;2023;2;2;0;100;0;75500;959;77.5
17177;2023;1;1;0;100;0;80001;625;128
17179;2023;20;18;2;90;10;194131;1999.45;97.9
17180;2023;3;3;0;100;0;156153.333333333;1012.66666666667;148
17181;2023;7;7;0;100;0;156571.428571429;1384.57142857143;119.285714285714
17182;2023;7;7;0;100;0;152007.142857143;1472.28571428571;100.428571428571
17183;2023;11;11;0;100;0;355151.090909091;2830.90909090909;127.181818181818
17184;2023;9;9;0;100;0;222777.777777778;2124.22222222222;109.333333333333
17185;2023;37;37;0;100;0;202265.810810811;2123.40540540541;99.1891891891892
17186;2023;10;10;0;100;0;254420.5;2283.8;115.4
17187;2023;5;5;0;100;0;180759.4;1822.2;99.2
17188;2023;6;6;0;100;0;148820.833333333;1163.33333333333;128.166666666667
17190;2023;34;30;4;88.2352941176471;11.7647058823529;425744.794117647;4201.11764705882;100.529411764706
17191;2023;3;3;0;100;0;173833.333333333;2098.66666666667;81
17192;2023;4;4;0;100;0;119500;861.75;141
17193;2023;36;36;0;100;0;298234.305555556;3291.75;92.0277777777778
17194;2023;38;38;0;100;0;338816.052631579;3209.60526315789;105.105263157895
17195;2023;1;1;0;100;0;70000;1458;48
17196;2023;6;6;0;100;0;191933.333333333;1749.5;108.5
17197;2023;60;44;16;73.3333333333333;26.6666666666667;134307.066666667;1885;75.65
17198;2023;4;4;0;100;0;145400;1647.75;93
17199;2023;1;1;0;100;0;168224;1246;135
17200;2023;97;82;15;84.5360824742268;15.4639175257732;437689.30927835;4067.49484536082;104.907216494845
17201;2023;2;2;0;100;0;277000;1998.5;146.5
17202;2023;6;6;0;100;0;120666.666666667;1266.16666666667;97.5
17203;2023;7;7;0;100;0;142827.142857143;1382.71428571429;104.428571428571
17204;2023;5;5;0;100;0;175700;1614;130
17205;2023;2;2;0;100;0;152935;1116;109.5
17206;2023;7;7;0;100;0;94958.5714285714;825.285714285714;122.428571428571
17207;2023;24;23;1;95.8333333333333;4.16666666666667;947040.833333333;8785.16666666667;111.5
17208;2023;8;8;0;100;0;267846.875;2839.625;91.625
17209;2023;4;4;0;100;0;237425;1534.25;153.25
17210;2023;5;5;0;100;0;120582.2;1003;110.6
17211;2023;8;8;0;100;0;123106.625;1214.625;102.125
17212;2023;2;2;0;100;0;149555;1293;105.5
17213;2023;4;4;0;100;0;135250;1367.5;104.5
17214;2023;3;3;0;100;0;224666.666666667;2429;100
17216;2023;12;12;0;100;0;176927.5;1896.25;95.5833333333333
17217;2023;4;4;0;100;0;163750;1058.5;149.25
17218;2023;87;66;21;75.8620689655172;24.1379310344828;169138.620689655;1968.94252873563;87.2068965517241
17219;2023;95;80;15;84.2105263157895;15.7894736842105;225859.578947368;2506.09473684211;90.5684210526316
17220;2023;4;4;0;100;0;173742.5;1596.75;108.25
17221;2023;19;19;0;100;0;165803.631578947;1543.78947368421;109.157894736842
17222;2023;49;48;1;97.9591836734694;2.04081632653061;416865.244897959;3659.95918367347;114.673469387755
17223;2023;6;6;0;100;0;132357.333333333;1258.33333333333;103.333333333333
17224;2023;30;30;0;100;0;141756.466666667;1392.73333333333;103.333333333333
17225;2023;113;101;12;89.3805309734513;10.6194690265487;256412.584070796;4279.0796460177;63.8938053097345
17226;2023;10;10;0;100;0;187650;1838.2;111.1
17228;2023;45;37;8;82.2222222222222;17.7777777777778;284250.311111111;3047.37777777778;95.8222222222222
17229;2023;3;3;0;100;0;317733.333333333;1616.33333333333;195.333333333333
17230;2023;97;84;13;86.5979381443299;13.4020618556701;294959.103092783;3950.45360824742;79.360824742268
17231;2023;2;2;0;100;0;170665;917.5;156
17232;2023;31;26;5;83.8709677419355;16.1290322580645;162145.967741935;1789.64516129032;91.0967741935484
17233;2023;3;3;0;100;0;165000;1371.66666666667;126
17234;2023;2;2;0;100;0;172450;1474;125.5
17235;2023;5;5;0;100;0;122069;725.8;153.2
17236;2023;34;22;12;64.7058823529412;35.2941176470588;124011.147058824;1304.67647058824;95.1176470588235
17237;2023;9;9;0;100;0;235020;2338.44444444444;100.111111111111
17239;2023;6;6;0;100;0;148500;1132.66666666667;127.5
17240;2023;49;43;6;87.7551020408163;12.2448979591837;156433.020408163;1876.69387755102;90.1020408163265
17241;2023;23;23;0;100;0;131182.217391304;1287.4347826087;104.869565217391
17242;2023;7;7;0;100;0;139900;1429.71428571429;94.5714285714286
17243;2023;14;14;0;100;0;106495.357142857;1411.92857142857;81.7857142857143
17244;2023;9;9;0;100;0;194647.777777778;1996.77777777778;98.3333333333333
17245;2023;8;8;0;100;0;276550;2795.875;107.375
17246;2023;8;7;1;87.5;12.5;176410.375;1925.125;91.625
17247;2023;13;13;0;100;0;290778.461538462;3481.53846153846;92.8461538461538
17248;2023;19;17;2;89.4736842105263;10.5263157894737;176905.263157895;1970.84210526316;96.0526315789474
17250;2023;6;6;0;100;0;151250;1195.5;124
17252;2023;2;2;0;100;0;266000;1651;139
17253;2023;21;21;0;100;0;197545.238095238;1821.95238095238;117.619047619048
17254;2023;6;6;0;100;0;124833.333333333;1000.16666666667;123.666666666667
17255;2023;6;6;0;100;0;188641.666666667;1799.83333333333;105
17256;2023;8;8;0;100;0;183875;1786.25;100.25
17257;2023;8;8;0;100;0;96612.5;1102.625;89.625
17258;2023;3;3;0;100;0;181000;1384.66666666667;124.333333333333
17259;2023;1;1;0;100;0;480000;7385;65
17260;2023;2;2;0;100;0;126000;1364.5;91.5
17261;2023;2;2;0;100;0;161400;1260;125
17262;2023;14;14;0;100;0;202522.142857143;2022.64285714286;102.642857142857
17263;2023;7;7;0;100;0;92595.2857142857;1114.14285714286;82.5714285714286
17264;2023;65;63;2;96.9230769230769;3.07692307692308;464665.261538462;4056.89230769231;111.476923076923
17265;2023;16;16;0;100;0;226686.875;2094.9375;108.9375
17266;2023;7;7;0;100;0;193538.571428571;1820.57142857143;111.714285714286
17267;2023;13;13;0;100;0;265275.538461538;2530.92307692308;102.923076923077
17268;2023;3;3;0;100;0;232400;1349;167.333333333333
17269;2023;10;10;0;100;0;160594.5;1504.7;110.7
17270;2023;13;13;0;100;0;132323.384615385;1973.92307692308;74.2307692307692
17271;2023;5;5;0;100;0;175529.4;1747.6;96
17273;2023;11;11;0;100;0;155636.363636364;1511.54545454545;110.454545454545
17274;2023;101;79;22;78.2178217821782;21.7821782178218;389364.633663366;4061.54455445545;96.7821782178218
17275;2023;6;6;0;100;0;257748.333333333;2434.16666666667;111.5
17277;2023;10;10;0;100;0;122020;1425.6;90.7
17278;2023;11;11;0;100;0;188235.181818182;1934;97.5454545454545
17279;2023;8;8;0;100;0;185787.5;1697.5;112.75
17280;2023;9;9;0;100;0;279726.666666667;2188.33333333333;132.777777777778
17281;2023;2;2;0;100;0;96000;1587.5;61
17282;2023;3;3;0;100;0;185390;1642.66666666667;115
17283;2023;61;60;1;98.3606557377049;1.63934426229508;146358.967213115;1518.39344262295;94.4590163934426
17284;2023;38;37;1;97.3684210526316;2.63157894736842;223806.052631579;2072.42105263158;108.473684210526
17285;2023;16;16;0;100;0;258460;2164.8125;122.9375
17286;2023;34;33;1;97.0588235294118;2.94117647058824;1168094.70588235;8553.61764705882;133.588235294118
17287;2023;2;2;0;100;0;99050;1302;78
17288;2023;7;7;0;100;0;134557.142857143;1522;88
17289;2023;5;5;0;100;0;276580;1724.6;188.2
17290;2023;1;1;0;100;0;300540;1495;201
17291;2023;86;53;33;61.6279069767442;38.3720930232558;311889.813953488;3784.12790697674;85.2674418604651
17292;2023;2;2;0;100;0;214050;1503.5;151.5
17293;2023;10;10;0;100;0;202307;2079.7;95.9
17295;2023;5;5;0;100;0;183910;1392.4;135
17296;2023;15;15;0;100;0;178835.6;1707.4;103.933333333333
17297;2023;48;45;3;93.75;6.25;773176.104166667;7868.20833333333;96.8333333333333
17298;2023;9;9;0;100;0;165388.888888889;1589.33333333333;116.333333333333
17299;2023;497;213;284;42.8571428571429;57.1428571428571;168737.094567404;2416.59758551308;71.7505030181086
17300;2023;1396;471;925;33.7392550143266;66.2607449856733;323658.052292264;5011.39398280802;65.845988538682
17301;2023;2;2;0;100;0;38000;584.5;65
17302;2023;7;7;0;100;0;193071.428571429;2155.42857142857;88.8571428571429
17303;2023;13;13;0;100;0;179617.692307692;1711.15384615385;105.307692307692
17304;2023;8;8;0;100;0;179812.5;1767;112.125
17305;2023;5;5;0;100;0;129600;1505;82
17306;2023;661;244;417;36.9137670196672;63.0862329803328;286280.416036309;4289.2602118003;67.0423600605144
17307;2023;13;13;0;100;0;319132.692307692;2853.53846153846;117
17308;2023;39;39;0;100;0;233568.41025641;2274.46153846154;102.897435897436
17309;2023;26;26;0;100;0;115754.961538462;1264.69230769231;89.7307692307692
17310;2023;16;16;0;100;0;199374.75;1741.125;110.4375
17311;2023;38;35;3;92.1052631578947;7.89473684210526;260672.657894737;3294.52631578947;82.3157894736842
17312;2023;9;9;0;100;0;146777.888888889;1462.11111111111;121.555555555556
17313;2023;8;8;0;100;0;267668.75;1993.25;123
17314;2023;9;9;0;100;0;154544.444444444;1349.11111111111;108.111111111111
17315;2023;12;12;0;100;0;290387.583333333;2804.83333333333;105.333333333333
17316;2023;7;7;0;100;0;152428.571428571;1643;95.4285714285714
17317;2023;9;9;0;100;0;175125.333333333;1749.11111111111;104.555555555556
17318;2023;22;21;1;95.4545454545455;4.54545454545455;609167.045454545;6905.18181818182;89.6818181818182
17319;2023;1;1;0;100;0;65000;722;90
17320;2023;4;4;0;100;0;241800;3032.5;86
17321;2023;2;2;0;100;0;191500;2289.5;84
17322;2023;8;8;0;100;0;212028.375;2051.25;105.5
17323;2023;50;49;1;98;2;279024.52;4744.66;64.8
17325;2023;9;9;0;100;0;152950;1383.88888888889;109.666666666667
17326;2023;2;2;0;100;0;102495;1370.5;75
17327;2023;2;2;0;100;0;174000;1636.5;112.5
17328;2023;25;25;0;100;0;130694.4;1451.12;93.28
17329;2023;6;6;0;100;0;243833.333333333;2342;111.666666666667
17330;2023;19;19;0;100;0;135863.157894737;1771.73684210526;84.2631578947368
17331;2023;15;15;0;100;0;159113.333333333;1432.46666666667;121.466666666667
17332;2023;5;5;0;100;0;117787;1208.8;92.8
17333;2023;224;112;112;50;50;271659.410714286;4423.26785714286;65.5535714285714
17334;2023;4;4;0;100;0;163225;1443.25;125.5
17335;2023;2;2;0;100;0;118000;1510.5;78.5
17336;2023;33;32;1;96.969696969697;3.03030303030303;253400.03030303;2283;112.909090909091
17337;2023;125;115;10;92;8;265843.904;3936.256;69.552
17338;2023;11;11;0;100;0;219309.454545455;1983.09090909091;109
17339;2023;18;18;0;100;0;169766.666666667;1790.33333333333;95.1666666666667
17340;2023;19;19;0;100;0;176819.631578947;2120.10526315789;98.8421052631579
17341;2023;5;5;0;100;0;195256;1618;114.4
17342;2023;4;4;0;100;0;169825;1556.25;112.5
17343;2023;1;1;0;100;0;135000;1406;96
17344;2023;18;18;0;100;0;158094.888888889;1634.38888888889;97.1111111111111
17345;2023;3;3;0;100;0;488903.333333333;2884;172.666666666667
17346;2023;27;27;0;100;0;213043.37037037;2005.92592592593;103.740740740741
17347;2023;125;105;20;84;16;151789.376;1718.656;96.552
17348;2023;8;8;0;100;0;183562.5;2527.625;83.5
17349;2023;36;36;0;100;0;229828.472222222;2184.86111111111;104.361111111111
17350;2023;13;13;0;100;0;132616.923076923;1478.84615384615;90.7692307692308
17351;2023;14;14;0;100;0;252048.142857143;2463.35714285714;107
17353;2023;37;37;0;100;0;285792.081081081;3049.64864864865;95.4324324324324
17354;2023;9;9;0;100;0;222663.333333333;1814.55555555556;133.111111111111
17355;2023;3;3;0;100;0;165060;1520.66666666667;101
17356;2023;6;6;0;100;0;163275.333333333;1452;114.166666666667
17357;2023;5;5;0;100;0;147969.8;1501.2;108.2
17358;2023;3;3;0;100;0;160933.333333333;882;187
17359;2023;18;18;0;100;0;234000.722222222;2003.11111111111;122.333333333333
17360;2023;65;64;1;98.4615384615385;1.53846153846154;773258.938461538;7070.96923076923;110.107692307692
17361;2023;1;1;0;100;0;1,00E+05;885;113
17362;2023;5;5;0;100;0;215820;1207.2;185
17363;2023;6;6;0;100;0;193108.333333333;1762.5;101.166666666667
17364;2023;3;3;0;100;0;97000;927.666666666667;97.6666666666667
17365;2023;5;5;0;100;0;121700;1175.4;103.2
17366;2023;5;5;0;100;0;202480;1672;137.2
17367;2023;1;1;0;100;0;219000;1888;116
17369;2023;53;35;18;66.0377358490566;33.9622641509434;792349.79245283;8099.71698113208;94.8490566037736
17373;2023;29;29;0;100;0;281515.75862069;2773.20689655172;101.931034482759
17374;2023;1;1;0;100;0;80000;503;159
17375;2023;18;18;0;100;0;249237.777777778;2257.94444444444;106.722222222222
17376;2023;26;26;0;100;0;353383.153846154;3248.96153846154;113.076923076923
17377;2023;2;2;0;100;0;189000;1476.5;113.5
17378;2023;4;4;0;100;0;75875;906.25;88
17379;2023;1;1;0;100;0;38000;613;62
17380;2023;143;93;50;65.034965034965;34.965034965035;366029.216783217;5138;72.6153846153846
17381;2023;2;2;0;100;0;88500;1550;54.5
17382;2023;10;10;0;100;0;173910;1790.3;105
17383;2023;5;5;0;100;0;155370;1454;104.8
17384;2023;4;4;0;100;0;118660;1343;92.25
17385;2023;155;144;11;92.9032258064516;7.09677419354839;316273.838709677;4043.38064516129;80.1225806451613
17386;2023;3;3;0;100;0;145633.333333333;1874.66666666667;85.6666666666667
17387;2023;20;19;1;95;5;189408.25;1779.25;109.4
17388;2023;5;5;0;100;0;163800;1336;132
17389;2023;2;2;0;100;0;263100;2030;135.5
17390;2023;3;3;0;100;0;80003.3333333333;987.333333333333;91.6666666666667
17391;2023;30;30;0;100;0;423436.866666667;3685.03333333333;112.066666666667
17393;2023;22;22;0;100;0;191729;2163.63636363636;87
17394;2023;7;7;0;100;0;225778.571428571;1551.85714285714;141.428571428571
17395;2023;9;9;0;100;0;229533.333333333;1800.22222222222;128.666666666667
17396;2023;26;26;0;100;0;289680.846153846;2601.61538461538;114.269230769231
17397;2023;46;45;1;97.8260869565217;2.17391304347826;152361.586956522;1769.17391304348;92.1739130434783
17398;2023;1;1;0;100;0;212000;1122;189
17400;2023;6;6;0;100;0;224791.666666667;2056.66666666667;111.333333333333
17401;2023;2;2;0;100;0;75000;832.5;88.5
17402;2023;2;2;0;100;0;167500;1769.5;97
17403;2023;11;11;0;100;0;147934.090909091;1729.81818181818;85.9090909090909
17404;2023;5;5;0;100;0;229220;1932.4;119
17405;2023;6;6;0;100;0;170845.166666667;1545.16666666667;108
17406;2023;5;5;0;100;0;227646;1810.8;128
17407;2023;62;61;1;98.3870967741936;1.61290322580645;321243.870967742;3250.72580645161;102.725806451613
17408;2023;21;21;0;100;0;203804.095238095;1998.57142857143;103.47619047619
17409;2023;38;34;4;89.4736842105263;10.5263157894737;278724.578947368;3022.65789473684;91.7105263157895
17410;2023;12;12;0;100;0;229525.833333333;1870.5;124.583333333333
17411;2023;33;28;5;84.8484848484848;15.1515151515152;268282.303030303;3830.78787878788;76.030303030303
17412;2023;6;6;0;100;0;174676.5;1908.83333333333;91.5
17413;2023;14;14;0;100;0;411695.571428571;3572.85714285714;111.642857142857
17414;2023;62;56;6;90.3225806451613;9.67741935483871;342091.161290323;3746.24193548387;91.758064516129
17415;2023;460;330;130;71.7391304347826;28.2608695652174;185902.789130435;2183.81086956522;85.5239130434783
17416;2023;3;3;0;100;0;84523;839;106.666666666667
17417;2023;1;1;0;100;0;219900;1374;160
17418;2023;6;6;0;100;0;175360;1541.33333333333;116.333333333333
17420;2023;27;26;1;96.2962962962963;3.7037037037037;395727.703703704;3860.14814814815;105.740740740741
17421;2023;128;101;27;78.90625;21.09375;229242.640625;2727.5703125;86.359375
17422;2023;1;1;0;100;0;130000;1083;120
17424;2023;2;2;0;100;0;157953.5;1471.5;95
17425;2023;39;38;1;97.4358974358974;2.56410256410256;289426.948717949;2965.4358974359;97.6410256410256
17426;2023;4;4;0;100;0;128825;1314.5;96.5
17427;2023;4;4;0;100;0;125246;954;139.5
17428;2023;2;2;0;100;0;80500;1096;74.5
17429;2023;29;28;1;96.551724137931;3.44827586206897;239792.586206897;2555.65517241379;95.1034482758621
17430;2023;4;4;0;100;0;127250;1411;86.5
17431;2023;7;7;0;100;0;236647.285714286;1995.14285714286;114.857142857143
17432;2023;1;1;0;100;0;61325;524;117
17433;2023;3;3;0;100;0;157333.333333333;1928;76.6666666666667
17434;2023;120;110;10;91.6666666666667;8.33333333333333;182481.541666667;2027.35;90.0833333333333
17435;2023;2;2;0;100;0;117500;1400;86.5
17436;2023;13;13;0;100;0;172761.538461538;1996.53846153846;94.4615384615385
17437;2023;2;2;0;100;0;333150;3763.5;89
17438;2023;4;4;0;100;0;172529.5;1692.25;97
17439;2023;14;14;0;100;0;138877.142857143;1823.28571428571;86.5714285714286
17440;2023;9;9;0;100;0;123611.111111111;1650.33333333333;78.3333333333333
17441;2023;17;17;0;100;0;187952.529411765;1753.05882352941;104.411764705882
17442;2023;7;7;0;100;0;200357.142857143;1888.42857142857;110.857142857143
17443;2023;24;24;0;100;0;328763.125;3270.08333333333;100.666666666667
17444;2023;28;27;1;96.4285714285714;3.57142857142857;178639.285714286;2374.28571428571;87.2857142857143
17445;2023;2;2;0;100;0;3,00E+05;4414;84
17446;2023;4;4;0;100;0;173264.25;1814.25;94
17447;2023;22;22;0;100;0;216584.409090909;2656;85.5454545454545
17448;2023;11;11;0;100;0;168836.363636364;1815.54545454545;97.6363636363636
17449;2023;126;85;41;67.4603174603175;32.5396825396825;175499.547619048;2144.02380952381;86.9523809523809
17450;2023;1;1;0;100;0;110000;1089;101
17451;2023;7;7;0;100;0;223400;1544.85714285714;127.285714285714
17452;2023;126;111;15;88.0952380952381;11.9047619047619;315069.365079365;3987.11904761905;83.2380952380952
17453;2023;15;15;0;100;0;254504.733333333;2647.66666666667;105.733333333333
17454;2023;4;4;0;100;0;140281.25;1107.25;128.5
17455;2023;8;8;0;100;0;175637.5;2051.75;111
17457;2023;20;20;0;100;0;175111;2355.7;78.6
17459;2023;13;13;0;100;0;92673.0769230769;1076.23076923077;86.4615384615385
17460;2023;14;14;0;100;0;210966.428571429;2035.07142857143;109
17461;2023;165;100;65;60.6060606060606;39.3939393939394;343844.157575758;4901.01818181818;72.9030303030303
17462;2023;8;8;0;100;0;221083.75;2041.875;117.375
17463;2023;9;9;0;100;0;282550;2596.11111111111;112
17465;2023;8;7;1;87.5;12.5;250716.875;2197.25;119.625
17466;2023;20;20;0;100;0;306455;2471.1;132.9
17467;2023;4;4;0;100;0;180523.25;1479.75;120
17468;2023;6;6;0;100;0;135725.166666667;1222.83333333333;103.166666666667
17469;2023;3;3;0;100;0;299500;2059;142
17470;2023;1;1;0;100;0;152000;1974;77
17471;2023;3;3;0;100;0;125466.666666667;1103.66666666667;114.333333333333
17472;2023;21;21;0;100;0;297138.095238095;3267.61904761905;92.2380952380952
17473;2023;3;3;0;100;0;141000;1063;132.333333333333
17474;2023;12;12;0;100;0;146153.333333333;1679.91666666667;86.0833333333333
17476;2023;5;5;0;100;0;123340;1257.8;103.6
17477;2023;4;4;0;100;0;117408;1461.5;86.75
17478;2023;1;1;0;100;0;260000;1333;195
17479;2023;2;2;0;100;0;103000;901.5;113.5
17480;2023;6;6;0;100;0;181673.166666667;1921.83333333333;95.3333333333333
17481;2023;2;2;0;100;0;227500;1520.5;148
17482;2023;8;8;0;100;0;263285.625;2180;116.125
17483;2023;20;20;0;100;0;372893;3366.45;115
17484;2023;38;37;1;97.3684210526316;2.63157894736842;209421.342105263;2657.63157894737;82.6578947368421
17485;2023;20;18;2;90;10;367479.25;4463.15;85.05
17486;2023;33;31;2;93.9393939393939;6.06060606060606;352426.242424242;4839.21212121212;80.969696969697
18001;2023;3;3;0;100;0;115666.666666667;1563.66666666667;76.6666666666667
18002;2023;2;2;0;100;0;65000;902;81
18003;2023;21;21;0;100;0;102721.428571429;1256.28571428571;80.0476190476191
18004;2023;13;13;0;100;0;108307.692307692;1186;89.8461538461538
18005;2023;10;10;0;100;0;141250;1398.8;100.5
18006;2023;7;7;0;100;0;113142.857142857;1344;86.4285714285714
18008;2023;5;5;0;100;0;178850;1838.4;100.6
18009;2023;4;4;0;100;0;72750;822;85.25
18010;2023;4;4;0;100;0;66065;841.75;79.75
18011;2023;25;24;1;96;4;113234.08;1262.64;91.64
18012;2023;6;6;0;100;0;96183.3333333333;1223;77
18013;2023;3;3;0;100;0;132333.333333333;1326.33333333333;100.666666666667
18014;2023;4;4;0;100;0;170500;2230.25;74
18015;2023;61;53;8;86.8852459016393;13.1147540983607;107385.245901639;1426.55737704918;77.1311475409836
18016;2023;5;5;0;100;0;128800;1421.2;95.8
18017;2023;7;7;0;100;0;94880.2857142857;1070;101.714285714286
18018;2023;24;24;0;100;0;139955.416666667;1491.54166666667;95.5416666666667
18019;2023;11;11;0;100;0;73095.4545454545;964.818181818182;85.2727272727273
18020;2023;12;12;0;100;0;124608.333333333;1362.41666666667;86.4166666666667
18021;2023;10;10;0;100;0;79563;1233.3;82.4
18022;2023;11;11;0;100;0;72454.5454545455;1007.27272727273;71.7272727272727
18023;2023;14;14;0;100;0;128273.571428571;1244.28571428571;103.785714285714
18024;2023;2;2;0;100;0;75600;743.5;102.5
18025;2023;5;5;0;100;0;75600;1146.8;70.8
18026;2023;12;12;0;100;0;131137.5;1316.5;98.0833333333333
18027;2023;11;11;0;100;0;101701.818181818;1039.45454545455;98.6363636363636
18028;2023;7;7;0;100;0;172214.285714286;1547;108.571428571429
18029;2023;9;9;0;100;0;77500;895.333333333333;88
18030;2023;13;13;0;100;0;104361.538461538;1209.38461538462;83.2307692307692
18031;2023;8;8;0;100;0;75600;801.875;89.125
18032;2023;22;22;0;100;0;151011.363636364;1454.63636363636;110.090909090909
18033;2023;934;436;498;46.6809421841542;53.3190578158458;130245.792291221;1757.10385438972;74.7815845824411
18034;2023;2;2;0;100;0;54000;762;67.5
18035;2023;9;9;0;100;0;165972.222222222;1634.11111111111;107.444444444444
18036;2023;7;7;0;100;0;88944.2857142857;1039.57142857143;84.7142857142857
18037;2023;12;12;0;100;0;96000;1246.41666666667;82.6666666666667
18038;2023;4;4;0;100;0;97002.5;1042.25;89.5
18039;2023;5;5;0;100;0;135000;1428.8;78
18040;2023;2;2;0;100;0;129000;1088;132
18041;2023;2;2;0;100;0;74000;1099;67
18042;2023;4;4;0;100;0;73375;950;77.5
18043;2023;2;2;0;100;0;45500;748;61
18044;2023;5;5;0;100;0;76400;1072.6;67.6
18045;2023;3;3;0;100;0;115500;1016.66666666667;129.333333333333
18046;2023;4;4;0;100;0;156600;2467.5;60
18047;2023;6;6;0;100;0;123116.666666667;1623;73.6666666666667
18048;2023;4;4;0;100;0;119000;1015.25;108.75
18049;2023;6;6;0;100;0;184166.666666667;1277.16666666667;133.5
18050;2023;26;26;0;100;0;181839.423076923;1846.65384615385;100.807692307692
18051;2023;4;4;0;100;0;82000;1019.75;82.5
18052;2023;25;23;2;92;8;128648;1053.92;106.16
18053;2023;8;8;0;100;0;53179.875;835.125;64
18054;2023;4;4;0;100;0;101625;818.25;123.5
18055;2023;11;11;0;100;0;98177.2727272727;962.363636363636;115.363636363636
18056;2023;8;8;0;100;0;86525;971.25;100.25
18057;2023;30;30;0;100;0;109824.133333333;1199.46666666667;86.1
18058;2023;21;21;0;100;0;72284.7142857143;778.952380952381;85.2857142857143
18059;2023;21;21;0;100;0;78771.4285714286;946.857142857143;90.6190476190476
18060;2023;3;3;0;100;0;107500;915;110.333333333333
18061;2023;1;1;0;100;0;90000;588;153
18062;2023;2;2;0;100;0;125000;2017.5;63
18063;2023;1;1;0;100;0;130000;1287;101
18065;2023;16;15;1;93.75;6.25;72254.625;959.5;78.8125
18066;2023;9;9;0;100;0;105388.888888889;1167.77777777778;92
18067;2023;11;11;0;100;0;91909.1818181818;1000.63636363636;96.1818181818182
18069;2023;11;11;0;100;0;112636.363636364;1300.72727272727;86
18070;2023;4;4;0;100;0;107875;1138;91.25
18072;2023;6;6;0;100;0;124750;1134.5;112.666666666667
18073;2023;2;2;0;100;0;85000;881.5;97
18074;2023;2;2;0;100;0;225250;1378.5;143
18075;2023;7;7;0;100;0;124642.857142857;1421;84
18076;2023;7;7;0;100;0;152228.571428571;1115.42857142857;128.142857142857
18077;2023;7;7;0;100;0;146642.857142857;1284.71428571429;123.857142857143
18079;2023;4;4;0;100;0;146537.5;1624.75;101.25
18080;2023;3;3;0;100;0;80000;1119.33333333333;69
18081;2023;3;3;0;100;0;151500;1436.66666666667;104.666666666667
18082;2023;7;7;0;100;0;167285.714285714;1454.28571428571;113.571428571429
18083;2023;14;14;0;100;0;124010;1209.78571428571;93.5714285714286
18084;2023;4;4;0;100;0;96865;1388.25;72.5
18085;2023;1;1;0;100;0;43000;754;57
18086;2023;6;6;0;100;0;97333.3333333333;1025.66666666667;99.5
18087;2023;34;34;0;100;0;104843.088235294;1069.52941176471;100.705882352941
18088;2023;2;2;0;100;0;24500;711;34
18089;2023;4;4;0;100;0;141875;1482.5;92
18090;2023;7;7;0;100;0;103820;965;102.714285714286
18091;2023;3;3;0;100;0;114436.666666667;1149.33333333333;100.333333333333
18092;2023;9;9;0;100;0;124222.222222222;1274.11111111111;93.4444444444444
18093;2023;3;3;0;100;0;83621.6666666667;900.666666666667;83.3333333333333
18094;2023;7;7;0;100;0;69004.1428571429;876;78.7142857142857
18095;2023;2;2;0;100;0;69000;722.5;95.5
18096;2023;24;24;0;100;0;98258.6666666667;1194.75;84.375
18097;2023;17;17;0;100;0;168073.470588235;1869.05882352941;91.0588235294118
18098;2023;5;5;0;100;0;177900;1389.6;122.4
18099;2023;1;1;0;100;0;92000;702;131
18100;2023;10;10;0;100;0;73560.1;961.7;77.7
18101;2023;6;6;0;100;0;85750;764;107.833333333333
18102;2023;5;5;0;100;0;86300;869.6;96.6
18103;2023;19;18;1;94.7368421052632;5.26315789473684;89729.7368421053;1040.63157894737;87.8421052631579
18104;2023;1;1;0;100;0;57720;916;63
18105;2023;5;5;0;100;0;94200;1219;75.4
18106;2023;3;3;0;100;0;105333.333333333;738.666666666667;136.666666666667
18108;2023;36;36;0;100;0;114234.25;1312.97222222222;90.5277777777778
18109;2023;32;32;0;100;0;96042.25;1100.46875;92.84375
18110;2023;12;12;0;100;0;103291.583333333;1081.83333333333;91
18111;2023;2;2;0;100;0;45000;709;62
18112;2023;4;4;0;100;0;87250;1592.25;64.25
18113;2023;1;1;0;100;0;32000;492;65
18114;2023;6;5;1;83.3333333333333;16.6666666666667;165948.166666667;2784.83333333333;62
18115;2023;14;14;0;100;0;79421.7857142857;1106.42857142857;82.2857142857143
18116;2023;3;3;0;100;0;62500;812.333333333333;82.6666666666667
18117;2023;4;4;0;100;0;102300;968;102.5
18118;2023;19;18;1;94.7368421052632;5.26315789473684;97166.7894736842;1035.89473684211;97.8947368421053
18119;2023;1;1;0;100;0;130000;1477;88
18120;2023;8;8;0;100;0;97017;964.25;103.5
18122;2023;5;5;0;100;0;140496.2;1534.2;92.2
18124;2023;5;5;0;100;0;98200;866.6;110
18125;2023;19;19;0;100;0;102707.894736842;1162.73684210526;85.2105263157895
18126;2023;14;14;0;100;0;137928.571428571;1396.42857142857;99.3571428571429
18127;2023;14;14;0;100;0;76381.6428571429;792.928571428571;93.8571428571429
18128;2023;1;1;0;100;0;84500;1363;62
18129;2023;3;3;0;100;0;229433.333333333;1574.33333333333;156.333333333333
18130;2023;10;10;0;100;0;110918.5;1148.6;90.8
18132;2023;1;1;0;100;0;46940;643;73
18133;2023;21;21;0;100;0;97669;1225.57142857143;79.4285714285714
18134;2023;12;12;0;100;0;81464.1666666667;998;90.4166666666667
18135;2023;5;5;0;100;0;101200;1089;97.8
18136;2023;3;3;0;100;0;81000;1013.66666666667;82.6666666666667
18137;2023;10;10;0;100;0;82661;888.7;92.2
18138;2023;23;20;3;86.9565217391304;13.0434782608696;170270.869565217;1671.86956521739;100.173913043478
18139;2023;6;6;0;100;0;104166.666666667;1265;82.1666666666667
18140;2023;21;21;0;100;0;118541.666666667;1102.19047619048;106
18141;2023;96;94;2;97.9166666666667;2.08333333333333;114644.6875;1357.34375;86.90625
18142;2023;10;10;0;100;0;88305;950.9;92.4
18143;2023;4;4;0;100;0;101000;1048;127
18144;2023;9;9;0;100;0;171222.222222222;1410.55555555556;110.111111111111
18145;2023;19;19;0;100;0;140099.736842105;1636.47368421053;90.5789473684211
18146;2023;4;4;0;100;0;119056.25;1472.25;81.25
18147;2023;4;4;0;100;0;435937.5;4767;90.5
18148;2023;24;24;0;100;0;120546.375;1338.79166666667;88.25
18149;2023;8;8;0;100;0;98032.5;985;108
18150;2023;3;3;0;100;0;134050;1836.33333333333;102.666666666667
18151;2023;2;2;0;100;0;95000;1763.5;52
18152;2023;1;1;0;100;0;130000;1529;85
18153;2023;3;3;0;100;0;98666.6666666667;1321.66666666667;83.3333333333333
18154;2023;1;1;0;100;0;110000;1009;109
18155;2023;4;4;0;100;0;69450;983.25;69.25
18156;2023;8;8;0;100;0;102000;1274.875;76.375
18157;2023;9;9;0;100;0;138597.777777778;1427.88888888889;99.7777777777778
18158;2023;8;8;0;100;0;149402;1518.25;99.25
18159;2023;10;10;0;100;0;170905;1280.5;130.7
18160;2023;13;13;0;100;0;86207.6923076923;916.153846153846;90.4615384615385
18161;2023;5;5;0;100;0;68200;1044.2;62.8
18162;2023;5;5;0;100;0;72440;1069.4;70
18163;2023;4;4;0;100;0;139337.5;950.5;135.5
18164;2023;3;3;0;100;0;199703.333333333;1872.66666666667;95
18165;2023;18;17;1;94.4444444444444;5.55555555555556;95212.2222222222;1231.72222222222;73
18166;2023;6;6;0;100;0;161406.666666667;1799.16666666667;91.8333333333333
18167;2023;2;2;0;100;0;74000;655;114
18168;2023;5;5;0;100;0;105740;1068;96.8
18169;2023;2;2;0;100;0;114840;1631.5;70
18170;2023;14;14;0;100;0;100498.857142857;1285;77.1428571428571
18171;2023;2;2;0;100;0;258005;1789.5;109.5
18172;2023;17;17;0;100;0;93579.2352941177;1076.23529411765;89.1764705882353
18173;2023;3;3;0;100;0;91666.6666666667;753.666666666667;123
18174;2023;1;1;0;100;0;244340;2443;100
18175;2023;8;8;0;100;0;109825;1813.625;77.75
18176;2023;4;4;0;100;0;97500;1257.25;77.5
18177;2023;1;1;0;100;0;178500;1231;145
18178;2023;2;2;0;100;0;39500;574.5;66
18179;2023;11;11;0;100;0;172922.727272727;1439.18181818182;119.272727272727
18180;2023;18;18;0;100;0;190287.222222222;1861.38888888889;103.555555555556
18181;2023;9;9;0;100;0;131944.444444444;1528.66666666667;82.7777777777778
18182;2023;7;7;0;100;0;105571.428571429;1040.85714285714;90.8571428571429
18183;2023;5;5;0;100;0;86600;908.8;74.6
18184;2023;7;7;0;100;0;74500;1000.28571428571;73.8571428571429
18185;2023;4;4;0;100;0;56875;786;69
18186;2023;4;4;0;100;0;79300;1072.25;79.75
18187;2023;14;14;0;100;0;118110.714285714;1346.85714285714;88.3571428571429
18188;2023;5;5;0;100;0;52900;1301.2;54.6
18189;2023;7;7;0;100;0;161071.428571429;1965.14285714286;89.2857142857143
18190;2023;15;15;0;100;0;128227;1408.26666666667;97.4666666666667
18191;2023;3;3;0;100;0;105666.666666667;1116;98
18192;2023;8;8;0;100;0;69071.375;911.25;75
18193;2023;1;1;0;100;0;55000;426;129
18194;2023;9;9;0;100;0;159511.111111111;1414.55555555556;110.666666666667
18195;2023;1;1;0;100;0;69500;1069;65
18196;2023;3;3;0;100;0;70000;628.333333333333;111.333333333333
18197;2023;155;136;19;87.741935483871;12.258064516129;96595.5677419355;1172.10967741935;82.8516129032258
18198;2023;2;2;0;100;0;72500;975.5;69
18199;2023;3;3;0;100;0;76555.6666666667;1015;75
18200;2023;9;9;0;100;0;84666.6666666667;964.777777777778;87.6666666666667
18201;2023;3;3;0;100;0;65000;1122.33333333333;66.6666666666667
18203;2023;1;1;0;100;0;70000;538;130
18204;2023;1;1;0;100;0;133000;1198;111
18205;2023;107;97;10;90.6542056074766;9.34579439252336;210700.46728972;2092.40186915888;103.579439252336
18206;2023;18;18;0;100;0;172638.888888889;1741.66666666667;108.277777777778
18207;2023;88;78;10;88.6363636363636;11.3636363636364;109321.977272727;1306.11363636364;82.8636363636364
18208;2023;7;7;0;100;0;109714.285714286;1014.57142857143;109.857142857143
18209;2023;5;5;0;100;0;114480;873.2;136.6
18210;2023;7;7;0;100;0;104750;953;102.142857142857
18211;2023;5;5;0;100;0;128000;1371;94.4
18212;2023;8;8;0;100;0;151425;1182.125;129.75
18213;2023;47;47;0;100;0;143025.723404255;1628.36170212766;88.2340425531915
18214;2023;9;9;0;100;0;79333.3333333333;1051.88888888889;78.2222222222222
18215;2023;4;4;0;100;0;90750;949.25;101.75
18216;2023;6;6;0;100;0;134500;1579.83333333333;80.8333333333333
18217;2023;2;2;0;100;0;24250;663;38.5
18218;2023;7;7;0;100;0;178542.857142857;1729.14285714286;100.428571428571
18219;2023;7;7;0;100;0;158714.285714286;2162.28571428571;101.857142857143
18220;2023;6;6;0;100;0;91541.6666666667;1146.16666666667;76.3333333333333
18221;2023;1;1;0;100;0;1,00E+05;926;108
18223;2023;20;20;0;100;0;168893.75;1548.85;112.1
18224;2023;2;2;0;100;0;172500;1244;136.5
18225;2023;4;4;0;100;0;62000;823.75;72
18226;2023;4;4;0;100;0;162125;1715;96.25
18227;2023;4;4;0;100;0;413850;4047;127.75
18228;2023;2;2;0;100;0;93500;858.5;113.5
18229;2023;6;6;0;100;0;78583.3333333333;1247;69
18230;2023;5;5;0;100;0;90954;1076;91.6
18231;2023;7;7;0;100;0;113141.428571429;967.714285714286;116.142857142857
18232;2023;4;4;0;100;0;107375;1222;96.25
18233;2023;27;27;0;100;0;103122.962962963;1226.14814814815;84.4074074074074
18234;2023;10;10;0;100;0;76610.5;1173.3;78.1
18235;2023;11;11;0;100;0;163818.181818182;1541;105.545454545455
18236;2023;1;1;0;100;0;80000;833;96
18237;2023;7;7;0;100;0;125035.428571429;1163.28571428571;102.714285714286
18238;2023;1;1;0;100;0;30000;682;44
18240;2023;8;8;0;100;0;103531.25;1163.375;95.375
18241;2023;28;28;0;100;0;160471.464285714;1736.21428571429;98.1428571428571
18242;2023;52;52;0;100;0;74515.6538461538;856.5;88.4038461538462
18243;2023;5;5;0;100;0;81130;1233;64
18245;2023;7;7;0;100;0;71000;902.714285714286;83.7142857142857
18246;2023;17;17;0;100;0;129405.294117647;1313.82352941176;99.8823529411765
18247;2023;8;8;0;100;0;139625;1180.625;113.375
18248;2023;1;1;0;100;0;236000;1967;120
18249;2023;11;11;0;100;0;124772.727272727;1315.54545454545;91.8181818181818
18251;2023;1;1;0;100;0;162600;1084;150
18252;2023;8;8;0;100;0;108312.5;1071.75;102.375
18253;2023;3;3;0;100;0;125333.333333333;1355;91
18254;2023;6;6;0;100;0;149983.333333333;1821.16666666667;84
18255;2023;6;6;0;100;0;217850;1765.16666666667;123
18256;2023;3;3;0;100;0;225333.333333333;2334.66666666667;85.3333333333333
18257;2023;7;7;0;100;0;115714.285714286;1254.57142857143;91.5714285714286
18258;2023;8;8;0;100;0;58653.75;648.25;94
18259;2023;5;5;0;100;0;85300;1136.4;80.4
18260;2023;1;1;0;100;0;80000;1143;70
18261;2023;9;9;0;100;0;100777.777777778;1181.77777777778;84.7777777777778
18262;2023;5;5;0;100;0;74600;910.8;66.4
18263;2023;3;3;0;100;0;118333.333333333;1083.66666666667;104
18264;2023;1;1;0;100;0;95000;1080;88
18265;2023;9;9;0;100;0;90611.1111111111;1227.77777777778;74.8888888888889
18266;2023;5;5;0;100;0;72200;880.4;81.4
18267;2023;27;27;0;100;0;184061.111111111;1945.07407407407;96.3703703703704
18268;2023;6;6;0;100;0;61915;870;74.8333333333333
18269;2023;11;11;0;100;0;98618.1818181818;1058;92.4545454545455
18270;2023;10;10;0;100;0;83400;973.6;87
18271;2023;13;13;0;100;0;191883.076923077;1841.76923076923;105.615384615385
18272;2023;11;11;0;100;0;89045.4545454545;886.363636363636;103.090909090909
18273;2023;6;6;0;100;0;115278.333333333;1020.16666666667;108.333333333333
18274;2023;2;2;0;100;0;156750;1256.5;111
18276;2023;1;1;0;100;0;88000;1630;54
18277;2023;2;2;0;100;0;106196.5;964.5;100.5
18278;2023;11;11;0;100;0;76536.3636363636;1077.36363636364;68.0909090909091
18279;2023;370;299;71;80.8108108108108;19.1891891891892;84980.0243243243;1110.02972972973;78.3135135135135
18280;2023;6;6;0;100;0;141333.333333333;1692.33333333333;88.6666666666667
18281;2023;34;34;0;100;0;120006.176470588;1277.82352941176;92.4705882352941
18282;2023;5;5;0;100;0;102910;1127.4;84.4
18284;2023;3;3;0;100;0;119333.333333333;1955;87.3333333333333
18285;2023;6;5;1;83.3333333333333;16.6666666666667;78702.6666666667;1214.66666666667;67.6666666666667
18286;2023;9;9;0;100;0;114444.444444444;1581.55555555556;80.7777777777778
18287;2023;4;4;0;100;0;82500;1067.5;71.25
18288;2023;1;1;0;100;0;60000;896;67
18289;2023;9;9;0;100;0;113966.666666667;1111.33333333333;101.888888888889
18290;2023;3;3;0;100;0;79000;1022;76.6666666666667
19001;2023;6;6;0;100;0;112208.333333333;1266.66666666667;104.166666666667
19002;2023;4;4;0;100;0;82000;1082.5;65.75
19004;2023;6;6;0;100;0;147871.5;1313.16666666667;116
19005;2023;34;33;1;97.0588235294118;2.94117647058824;154426.676470588;1517.23529411765;104.882352941176
19007;2023;9;9;0;100;0;120267.777777778;1350.88888888889;95.6666666666667
19008;2023;3;3;0;100;0;158066.666666667;1379;112
19009;2023;1;1;0;100;0;244200;2282;107
19010;2023;58;43;15;74.1379310344828;25.8620689655172;120643.293103448;1593.89655172414;82
19011;2023;12;12;0;100;0;134900;1269;103.5
19012;2023;7;7;0;100;0;233298.571428571;1794;108.285714285714
19013;2023;5;5;0;100;0;195699.4;1991.6;97.6
19014;2023;8;8;0;100;0;116375;1259.5;95.625
19015;2023;13;12;1;92.3076923076923;7.69230769230769;120156.923076923;1141.92307692308;115.384615384615
19016;2023;4;4;0;100;0;118180.5;1183;89
19017;2023;3;3;0;100;0;188466.666666667;2479.66666666667;75.6666666666667
19018;2023;2;2;0;100;0;95330;1084.5;83.5
19019;2023;23;20;3;86.9565217391304;13.0434782608696;133557.608695652;1548.13043478261;85.4347826086957
19022;2023;5;5;0;100;0;162239;2091.4;81.6
19023;2023;25;24;1;96;4;83578.8;1141.56;70.8
19024;2023;10;10;0;100;0;111141;1287.1;91.3
19025;2023;6;5;1;83.3333333333333;16.6666666666667;201150;3006.33333333333;74.1666666666667
19026;2023;3;3;0;100;0;182210;1973;87.6666666666667
19028;2023;30;29;1;96.6666666666667;3.33333333333333;92017.1666666667;1222.23333333333;80.2333333333333
19029;2023;5;5;0;100;0;190980;2229.2;99.6
19030;2023;12;12;0;100;0;149116.666666667;1422.08333333333;109.166666666667
19031;2023;795;412;383;51.8238993710692;48.1761006289308;154649.281761006;1977.72327044025;78.6389937106918
19033;2023;17;16;1;94.1176470588235;5.88235294117647;76012.6470588235;1004.64705882353;86.2352941176471
19034;2023;5;5;0;100;0;127020;1653.8;78.8
19035;2023;6;6;0;100;0;77358.3333333333;1202.83333333333;58.5
19036;2023;15;15;0;100;0;103114.333333333;1334.2;80.7333333333333
19037;2023;19;18;1;94.7368421052632;5.26315789473684;106558.947368421;1215.63157894737;87.4736842105263
19038;2023;11;11;0;100;0;144905.545454545;1425.81818181818;102.454545454545
19039;2023;5;5;0;100;0;172280;1634.6;121.2
19040;2023;4;4;0;100;0;92522.5;1440;66.5
19041;2023;5;5;0;100;0;80000;1050.2;70.4
19042;2023;3;3;0;100;0;139000;1188.66666666667;120.333333333333
19043;2023;4;4;0;100;0;267662.5;2178.25;123
19044;2023;3;3;0;100;0;83237.3333333333;1233.33333333333;60
19045;2023;3;3;0;100;0;110576.666666667;2258;64
19046;2023;1;1;0;100;0;25000;694;36
19047;2023;4;4;0;100;0;93000;1476.75;69.25
19048;2023;2;2;0;100;0;137500;1676.5;90
19049;2023;10;10;0;100;0;185930.9;1796;107.1
19050;2023;2;2;0;100;0;256000;1876;137
19051;2023;1;1;0;100;0;50000;625;80
19053;2023;1;1;0;100;0;150000;1000;150
19054;2023;2;2;0;100;0;100966;1010.5;94
19055;2023;1;1;0;100;0;60500;1260;48
19056;2023;4;4;0;100;0;145375;1448.75;106
19057;2023;6;6;0;100;0;258333.333333333;2804.16666666667;127.666666666667
19058;2023;6;6;0;100;0;141233.333333333;1249.66666666667;116
19060;2023;10;10;0;100;0;108366.6;1292.8;80.6
19061;2023;11;9;2;81.8181818181818;18.1818181818182;88820;1035.90909090909;82.5454545454545
19062;2023;11;11;0;100;0;162819.090909091;1614.63636363636;97.3636363636364
19063;2023;23;17;6;73.9130434782609;26.0869565217391;225969.260869565;1906.73913043478;115.217391304348
19066;2023;19;17;2;89.4736842105263;10.5263157894737;164647.368421053;1693.26315789474;93.2105263157895
19067;2023;2;2;0;100;0;180650;3771.5;48.5
19068;2023;2;2;0;100;0;163500;1342.5;109.5
19069;2023;3;3;0;100;0;146960;1298;110.666666666667
19070;2023;4;4;0;100;0;172375;1550.5;111
19071;2023;3;3;0;100;0;54000;655.666666666667;81
19072;2023;22;22;0;100;0;140285.590909091;1496.86363636364;96.0454545454545
19073;2023;40;35;5;87.5;12.5;112330.95;1182.5;91.25
19074;2023;3;2;1;66.6666666666667;33.3333333333333;88366.6666666667;1097.66666666667;70
19075;2023;4;4;0;100;0;147113.75;2596.25;61.5
19076;2023;4;4;0;100;0;79500;1043.25;72.5
19078;2023;6;6;0;100;0;157894.666666667;1786.5;81.3333333333333
19079;2023;2;2;0;100;0;138100;1764;78.5
19080;2023;4;4;0;100;0;108710;1057.75;103.5
19081;2023;5;5;0;100;0;110460;1372.4;81.4
19082;2023;8;8;0;100;0;157979.375;1558.5;99.25
19083;2023;1;1;0;100;0;780000;4875;160
19084;2023;5;5;0;100;0;1,00E+05;876.2;114.2
19085;2023;11;11;0;100;0;125266.363636364;1129.45454545455;111.909090909091
19086;2023;4;4;0;100;0;142920.75;1822.5;89.25
19087;2023;4;4;0;100;0;87000;1030.25;89.5
19088;2023;1;1;0;100;0;65000;812;80
19089;2023;3;3;0;100;0;166500;1096;150.333333333333
19091;2023;1;1;0;100;0;65000;756;86
19093;2023;10;10;0;100;0;183930;1539.5;120.5
19094;2023;13;12;1;92.3076923076923;7.69230769230769;130364.230769231;1370.38461538462;104.076923076923
19095;2023;1;1;0;100;0;60000;469;128
19096;2023;2;2;0;100;0;112990;935;131
19098;2023;8;8;0;100;0;138600;1406.75;100
19099;2023;3;3;0;100;0;235666.666666667;2659.33333333333;98
19100;2023;13;13;0;100;0;120605.230769231;1464.15384615385;83.5384615384615
19101;2023;13;12;1;92.3076923076923;7.69230769230769;122957.692307692;1416.53846153846;85.7692307692308
19102;2023;4;4;0;100;0;101750;1298.5;73.5
19103;2023;1;1;0;100;0;384400;2957;130
19104;2023;3;3;0;100;0;112833.333333333;1330.66666666667;98.3333333333333
19105;2023;2;2;0;100;0;157000;1604;94.5
19106;2023;3;3;0;100;0;61333.3333333333;767;77.3333333333333
19107;2023;18;14;4;77.7777777777778;22.2222222222222;160277.777777778;1656.33333333333;96
19108;2023;1;1;0;100;0;90000;511;176
19109;2023;1;1;0;100;0;296500;1877;158
19110;2023;2;2;0;100;0;42500;781.5;58.5
19111;2023;1;1;0;100;0;84000;1200;70
19112;2023;1;1;0;100;0;45000;1500;30
19113;2023;11;11;0;100;0;126996.454545455;1586.90909090909;83.8181818181818
19114;2023;2;2;0;100;0;116500;1257.5;94.5
19116;2023;5;5;0;100;0;128180;1121.2;130
19117;2023;18;18;0;100;0;119618.944444444;1900.55555555556;61.3888888888889
19118;2023;13;12;1;92.3076923076923;7.69230769230769;106892;1057.30769230769;98.3846153846154
19119;2023;3;3;0;100;0;91729;1399;65
19120;2023;1;1;0;100;0;322930;3588;90
19121;2023;29;29;0;100;0;151286.896551724;1384.20689655172;108.827586206897
19122;2023;7;7;0;100;0;106214.285714286;1096.14285714286;105.285714285714
19123;2023;119;72;47;60.5042016806723;39.4957983193277;145538.428571429;1786.3025210084;79.9663865546218
19124;2023;17;17;0;100;0;140479.411764706;1597.94117647059;92.9411764705882
19125;2023;13;13;0;100;0;117000;1347.07692307692;87.8461538461538
19126;2023;4;4;0;100;0;111750;1257.5;84
19128;2023;3;3;0;100;0;79333.3333333333;1046;71
19129;2023;7;7;0;100;0;108071.428571429;1198.28571428571;93
19130;2023;10;9;1;90;10;127197;1384;91
19131;2023;11;11;0;100;0;110308.818181818;1313.90909090909;103.181818181818
19132;2023;3;3;0;100;0;158000;2722.33333333333;63.3333333333333
19133;2023;1;1;0;100;0;108510;1550;70
19134;2023;10;9;1;90;10;78134.6;1010.7;78.6
19135;2023;1;1;0;100;0;25000;532;47
19136;2023;24;22;2;91.6666666666667;8.33333333333333;137804.166666667;1331.25;102.041666666667
19138;2023;14;14;0;100;0;161102;1855.42857142857;93.7857142857143
19139;2023;1;1;0;100;0;130000;1171;111
19140;2023;7;7;0;100;0;146654.714285714;1483.14285714286;100.285714285714
19141;2023;2;2;0;100;0;91860;1070.5;82.5
19142;2023;1;1;0;100;0;81000;810;100
19143;2023;6;6;0;100;0;99208.3333333333;1142.5;91.8333333333333
19144;2023;5;5;0;100;0;119960.8;1160.6;107.6
19145;2023;3;3;0;100;0;128666.666666667;1896.66666666667;73.6666666666667
19146;2023;26;19;7;73.0769230769231;26.9230769230769;143410.961538462;1465.73076923077;94.8461538461538
19147;2023;5;5;0;100;0;233008;2122.4;113.6
19148;2023;15;15;0;100;0;124353.866666667;1147.26666666667;108.2
19149;2023;2;2;0;100;0;84705;684.5;123.5
19150;2023;5;5;0;100;0;244900;2547.2;89.6
19151;2023;8;8;0;100;0;260463.375;1825.25;142.25
19152;2023;8;8;0;100;0;83000;1134.25;75.75
19153;2023;56;52;4;92.8571428571429;7.14285714285714;147150.892857143;1550.55357142857;95.75
19154;2023;4;4;0;100;0;114300;1831.5;62.5
19155;2023;4;4;0;100;0;152925;1402.25;117
19156;2023;2;2;0;100;0;415161;1880.5;205.5
19157;2023;2;2;0;100;0;242750;3316.5;70
19158;2023;4;4;0;100;0;115237.5;1679;67
19159;2023;1;1;0;100;0;65000;878;74
19161;2023;9;9;0;100;0;150588.888888889;1331.33333333333;110.444444444444
19162;2023;12;11;1;91.6666666666667;8.33333333333333;136442.916666667;1629.66666666667;84.6666666666667
19163;2023;4;4;0;100;0;160238.75;1924.5;75.5
19164;2023;14;14;0;100;0;91388.5714285714;975;97.2142857142857
19165;2023;4;4;0;100;0;68192.5;1183.25;65
19168;2023;1;1;0;100;0;47000;1175;40
19170;2023;2;2;0;100;0;221925;1959;112.5
19171;2023;1;1;0;100;0;245000;2042;120
19172;2023;2;2;0;100;0;121750;1023.5;139
19173;2023;1;1;0;100;0;108000;1964;55
19174;2023;5;5;0;100;0;109960;1237.6;90.8
19176;2023;7;7;0;100;0;101954;1368.42857142857;75.7142857142857
19178;2023;6;6;0;100;0;145279.333333333;1730.33333333333;83.3333333333333
19179;2023;4;4;0;100;0;212500;1507.25;126.25
19180;2023;7;6;1;85.7142857142857;14.2857142857143;123785.714285714;1435.14285714286;83
19181;2023;13;13;0;100;0;106502.692307692;1187;96.2307692307692
19182;2023;9;9;0;100;0;135344.444444444;1403;95.5555555555556
19184;2023;2;2;0;100;0;136650;1535.5;95
19186;2023;2;2;0;100;0;130691;1679.5;77.5
19187;2023;5;5;0;100;0;219924;1690.8;127
19188;2023;5;5;0;100;0;72400;950.6;82
19190;2023;2;2;0;100;0;64500;671;92.5
19191;2023;9;9;0;100;0;198954.888888889;1723.44444444444;114.888888888889
19192;2023;9;8;1;88.8888888888889;11.1111111111111;108722.222222222;1132.55555555556;97.8888888888889
19193;2023;3;3;0;100;0;84000;1027;89.3333333333333
19194;2023;13;13;0;100;0;147185.769230769;1410.38461538462;106.692307692308
19195;2023;5;5;0;100;0;172510;1635;113.4
19196;2023;6;6;0;100;0;169150;2080.66666666667;90.1666666666667
19199;2023;1;1;0;100;0;60000;1364;44
19200;2023;1;1;0;100;0;60000;612;98
19201;2023;3;3;0;100;0;135983.333333333;1366.33333333333;103.666666666667
19202;2023;17;17;0;100;0;180695.823529412;1990.35294117647;97.5882352941177
19203;2023;11;11;0;100;0;135523.818181818;1533;91.7272727272727
19205;2023;2;2;0;100;0;196500;3901.5;51.5
19207;2023;7;7;0;100;0;158561.428571429;1619.14285714286;96.5714285714286
19208;2023;2;2;0;100;0;50000;571.5;81
19209;2023;2;2;0;100;0;84500;765.5;113.5
19211;2023;9;9;0;100;0;181089.444444444;1499.22222222222;122.333333333333
19212;2023;2;2;0;100;0;154000;1259;136
19213;2023;5;5;0;100;0;104365.6;1167.2;85.2
19214;2023;8;8;0;100;0;115495;1395.625;84
19215;2023;1;1;0;100;0;220000;1571;140
19216;2023;2;2;0;100;0;111550;1394.5;80
19219;2023;2;2;0;100;0;198915;1829;111
19220;2023;4;4;0;100;0;100112.5;1030.25;96.5
19221;2023;4;4;0;100;0;207949;1470.25;138.25
19222;2023;3;3;0;100;0;155333.333333333;1297.33333333333;117
19223;2023;5;5;0;100;0;76700;963.6;81
19225;2023;4;4;0;100;0;107225;1333;80.5
19227;2023;15;14;1;93.3333333333333;6.66666666666667;178224.533333333;1740.86666666667;100.666666666667
19228;2023;1;1;0;100;0;81600;1540;53
19229;2023;48;43;5;89.5833333333333;10.4166666666667;190590.75;2100.89583333333;90.8125
19230;2023;2;2;0;100;0;129725;1212;100
19231;2023;2;2;0;100;0;92500;1529.5;63.5
19233;2023;4;4;0;100;0;99250;1391.5;92.25
19234;2023;4;4;0;100;0;109375;1061.5;93
19235;2023;4;4;0;100;0;130687.5;1588;84.75
19236;2023;4;4;0;100;0;93125;827.75;113.25
19237;2023;17;16;1;94.1176470588235;5.88235294117647;86934.9411764706;1060.29411764706;87.1176470588235
19238;2023;2;2;0;100;0;115000;969.5;137
19239;2023;9;9;0;100;0;112948.333333333;1262.22222222222;86
19240;2023;6;5;1;83.3333333333333;16.6666666666667;109733.333333333;1421.66666666667;82.6666666666667
19241;2023;3;3;0;100;0;74700;1336.66666666667;80.6666666666667
19242;2023;5;4;1;80;20;93600;1448.6;65.6
19243;2023;5;5;0;100;0;113800;1531.2;74.2
19244;2023;2;2;0;100;0;107500;873;125
19245;2023;4;4;0;100;0;129978;1714.5;89.25
19246;2023;8;8;0;100;0;199225;2015.625;95.75
19248;2023;4;4;0;100;0;145600;1383.25;103.75
19249;2023;7;7;0;100;0;102941.714285714;1234.71428571429;85.2857142857143
19250;2023;9;9;0;100;0;144817.777777778;1310.33333333333;114
19251;2023;1;1;0;100;0;215000;2471;87
19252;2023;9;9;0;100;0;120838.888888889;1392.66666666667;84.2222222222222
19253;2023;4;4;0;100;0;100662.5;1088.75;85.75
19254;2023;6;6;0;100;0;153190;1150.83333333333;131.333333333333
19255;2023;15;15;0;100;0;157908;1894.6;84.9333333333333
19256;2023;6;6;0;100;0;148677.5;1843.33333333333;80
19257;2023;3;2;1;66.6666666666667;33.3333333333333;73359;1611.66666666667;46.6666666666667
19258;2023;7;7;0;100;0;135921.142857143;1923;74.2857142857143
19259;2023;3;3;0;100;0;87766.6666666667;1117.66666666667;83.3333333333333
19260;2023;3;3;0;100;0;180301.666666667;2301.66666666667;83
19261;2023;6;6;0;100;0;78675.3333333333;807.5;104.166666666667
19262;2023;3;3;0;100;0;98333.3333333333;1089.33333333333;82.6666666666667
19263;2023;2;2;0;100;0;102300;1523.5;71.5
19264;2023;8;7;1;87.5;12.5;150062.5;2106.375;75.125
19265;2023;6;6;0;100;0;101083.333333333;1052.66666666667;87
19268;2023;1;1;0;100;0;120000;1200;100
19269;2023;17;16;1;94.1176470588235;5.88235294117647;96426.4705882353;1090.58823529412;95.1764705882353
19270;2023;6;6;0;100;0;156936.666666667;1204.33333333333;119.833333333333
19271;2023;2;2;0;100;0;139105;1505;91.5
19272;2023;159;69;90;43.3962264150943;56.6037735849057;85032.0503144654;1045.22641509434;83.7106918238994
19273;2023;14;14;0;100;0;229375.571428571;2478.78571428571;94.5
19274;2023;32;25;7;78.125;21.875;219997.0625;2077.3125;99.9375
19275;2023;83;61;22;73.4939759036145;26.5060240963855;113613.686746988;1434.06024096386;88.3012048192771
19276;2023;33;28;5;84.8484848484848;15.1515151515152;106170.939393939;1201.69696969697;94.5454545454545
19277;2023;2;2;0;100;0;97300;1090.5;89.5
19278;2023;10;9;1;90;10;163365;1954.1;87
19279;2023;5;5;0;100;0;117278;1436.6;79.8
19280;2023;2;2;0;100;0;109500;1045.5;93
19284;2023;3;3;0;100;0;104218.333333333;1411;67.3333333333333
19285;2023;22;20;2;90.9090909090909;9.09090909090909;137227.272727273;1496.63636363636;98.2727272727273
19286;2023;9;9;0;100;0;87533.3333333333;1271;70.6666666666667
19287;2023;2;2;0;100;0;150000;1714.5;87
19288;2023;17;17;0;100;0;116852.647058824;1546.41176470588;84.4705882352941
19289;2023;4;4;0;100;0;216448.75;2119.5;105.5
21001;2023;3;3;0;100;0;281516.666666667;2439.66666666667;115
21002;2023;2;2;0;100;0;260284.5;2198;123.5
21003;2023;15;10;5;66.6666666666667;33.3333333333333;280829.666666667;2798.33333333333;92.8
21004;2023;8;7;1;87.5;12.5;109425;793.75;136.5
21005;2023;14;14;0;100;0;232473.428571429;2205.64285714286;106.071428571429
21006;2023;1;1;0;100;0;135000;1205;112
21007;2023;4;4;0;100;0;117750;1273.5;104.5
21008;2023;5;5;0;100;0;193580;1578.4;128.6
21009;2023;4;4;0;100;0;99157.5;1065.75;93.5
21010;2023;4;4;0;100;0;252900;2753.5;97
21011;2023;1;1;0;100;0;68000;701;97
21012;2023;3;3;0;100;0;79666.6666666667;1217.66666666667;64.6666666666667
21013;2023;4;4;0;100;0;199395.75;1676.75;103.5
21014;2023;1;1;0;100;0;52000;812;64
21015;2023;1;1;0;100;0;276590;1317;210
21016;2023;8;8;0;100;0;434631.25;3809.5;140.25
21017;2023;5;5;0;100;0;257600;2157.8;121.8
21018;2023;1;1;0;100;0;262371;2262;116
21021;2023;15;14;1;93.3333333333333;6.66666666666667;265258.066666667;2908.86666666667;104.8
21022;2023;7;7;0;100;0;181235.714285714;1840.28571428571;101.142857142857
21023;2023;17;13;4;76.4705882352941;23.5294117647059;96474.8823529412;892.411764705882;115.294117647059
21026;2023;1;1;0;100;0;19000;950;20
21027;2023;11;8;3;72.7272727272727;27.2727272727273;311732.727272727;2854.90909090909;109.454545454545
21028;2023;7;7;0;100;0;144078.571428571;1699.42857142857;86.7142857142857
21029;2023;1;1;0;100;0;84500;1083;78
21031;2023;6;6;0;100;0;197683.333333333;2011.33333333333;97
21032;2023;3;3;0;100;0;158766.666666667;1437.66666666667;103.666666666667
21033;2023;1;1;0;100;0;90650;708;128
21035;2023;1;1;0;100;0;280000;1867;150
21036;2023;1;1;0;100;0;87000;1130;77
21037;2023;4;4;0;100;0;143112.5;1734.25;86.25
21038;2023;71;36;35;50.7042253521127;49.2957746478873;145923.169014085;1600.47887323944;90.3098591549296
21041;2023;1;1;0;100;0;60000;1333;45
21043;2023;1;1;0;100;0;50000;641;78
21044;2023;1;1;0;100;0;25000;714;35
21045;2023;5;5;0;100;0;190860;1626.6;107.8
21047;2023;1;1;0;100;0;20000;1250;16
21048;2023;6;6;0;100;0;262366.666666667;2710.83333333333;95.1666666666667
21050;2023;7;7;0;100;0;214960;1829.71428571429;116.285714285714
21051;2023;1;1;0;100;0;140000;3111;45
21053;2023;1;1;0;100;0;221900;2197;101
21054;2023;304;125;179;41.1184210526316;58.8815789473684;226854.680921053;2790.86842105263;81.3486842105263
21056;2023;11;11;0;100;0;197374.545454545;2229.81818181818;93.7272727272727
21057;2023;2;2;0;100;0;294000;2771;110
21058;2023;4;4;0;100;0;79500;781.25;95.75
21059;2023;11;10;1;90.9090909090909;9.09090909090909;306227.272727273;2765.27272727273;114.454545454545
21060;2023;13;13;0;100;0;226350;2556.30769230769;93.0769230769231
21062;2023;2;2;0;100;0;271700;2097.5;129
21064;2023;2;2;0;100;0;86750;1051.5;106
21065;2023;1;1;0;100;0;83000;1025;81
21067;2023;9;9;0;100;0;206000;2055.77777777778;98.3333333333333
21068;2023;1;1;0;100;0;35500;986;36
21069;2023;4;4;0;100;0;97500;1327.5;72.25
21070;2023;1;1;0;100;0;115000;1186;97
21071;2023;12;12;0;100;0;192904.166666667;2168.91666666667;91.75
21074;2023;5;5;0;100;0;160880;1970.6;82
21076;2023;4;3;1;75;25;261237.5;2316.75;113.25
21077;2023;2;2;0;100;0;55250;862;59.5
21078;2023;2;2;0;100;0;78000;611.5;125
21079;2023;1;1;0;100;0;190000;1462;130
21080;2023;10;10;0;100;0;185684.6;1782.4;107.9
21083;2023;5;5;0;100;0;88849;850.8;106.6
21084;2023;1;1;0;100;0;179470;935;192
21085;2023;2;2;0;100;0;175000;1686;100
21086;2023;9;9;0;100;0;386771.666666667;2909.66666666667;128
21087;2023;11;11;0;100;0;119390.909090909;1340.90909090909;95.0909090909091
21088;2023;2;2;0;100;0;199000;2724.5;72.5
21089;2023;2;2;0;100;0;150125;1706;85
21090;2023;4;4;0;100;0;47052.5;476.5;101.75
21092;2023;3;3;0;100;0;247133.333333333;2246.66666666667;109.333333333333
21093;2023;1;1;0;100;0;145000;906;160
21094;2023;3;3;0;100;0;97850;1373;71.3333333333333
21096;2023;4;4;0;100;0;86375;1017;85.25
21098;2023;3;3;0;100;0;98333.3333333333;1268.33333333333;74.6666666666667
21099;2023;2;2;0;100;0;210625;2503.5;84
21101;2023;3;3;0;100;0;142616.666666667;1868;79.3333333333333
21102;2023;2;2;0;100;0;109295;1352.5;83.5
21103;2023;36;36;0;100;0;204584.722222222;2048.77777777778;104.805555555556
21105;2023;7;7;0;100;0;280850.285714286;2676.14285714286;106
21106;2023;9;9;0;100;0;215433.777777778;2408.44444444444;95.2222222222222
21107;2023;5;5;0;100;0;286500;2233.6;142.6
21108;2023;1;1;0;100;0;250000;1786;140
21109;2023;4;4;0;100;0;74325;882.75;85.25
21110;2023;3;3;0;100;0;245000;2487.33333333333;100
21111;2023;1;1;0;100;0;641000;3392;189
21112;2023;3;3;0;100;0;167783.333333333;2357;76.6666666666667
21113;2023;1;1;0;100;0;302500;2363;128
21114;2023;4;4;0;100;0;119450;2070.5;72.75
21115;2023;3;3;0;100;0;96466.6666666667;941.666666666667;91.3333333333333
21116;2023;1;1;0;100;0;30000;638;47
21117;2023;1;1;0;100;0;164100;1641;100
21120;2023;4;4;0;100;0;159875;1334.25;129.25
21122;2023;1;1;0;100;0;110000;1549;71
21123;2023;1;1;0;100;0;500950;1802;278
21124;2023;2;2;0;100;0;65000;854.5;77
21125;2023;2;2;0;100;0;105000;1151;92.5
21126;2023;9;8;1;88.8888888888889;11.1111111111111;244013.444444444;2515.44444444444;93.7777777777778
21127;2023;5;5;0;100;0;249130;1946;125.2
21128;2023;2;2;0;100;0;100600;1356.5;71.5
21129;2023;1;1;0;100;0;40000;408;98
21130;2023;3;3;0;100;0;202833.333333333;2305;87.6666666666667
21131;2023;9;9;0;100;0;171133.333333333;1539;112.888888888889
21132;2023;5;5;0;100;0;192700;1840;105.6
21133;2023;7;6;1;85.7142857142857;14.2857142857143;238494.285714286;2594.71428571429;94.4285714285714
21134;2023;7;7;0;100;0;134528.571428571;1053.57142857143;132.571428571429
21135;2023;3;3;0;100;0;173333.333333333;1404.33333333333;129
21137;2023;1;1;0;100;0;131000;809;162
21138;2023;8;8;0;100;0;188725;1432.25;141.375
21139;2023;3;3;0;100;0;124333.333333333;1215;101.333333333333
21142;2023;2;2;0;100;0;230480;1523;149
21146;2023;2;2;0;100;0;181750;1075;133
21148;2023;3;3;0;100;0;191000;1630.66666666667;118
21149;2023;5;5;0;100;0;105920;954.4;122.6
21150;2023;2;2;0;100;0;135000;1488.5;93
21152;2023;2;2;0;100;0;159700.5;2002;81.5
21153;2023;4;4;0;100;0;128750;1214.25;94
21154;2023;76;47;29;61.8421052631579;38.1578947368421;85489.1842105263;994.447368421053;83.0131578947368
21157;2023;1;1;0;100;0;141500;1252;113
21158;2023;2;2;0;100;0;87500;910;87.5
21159;2023;1;1;0;100;0;76000;507;150
21162;2023;5;5;0;100;0;233080;3746;76.6
21163;2023;1;1;0;100;0;145000;1318;110
21164;2023;3;3;0;100;0;181166.666666667;1843;113.333333333333
21166;2023;146;43;103;29.4520547945205;70.5479452054795;131059.438356164;1823.65068493151;70.972602739726
21169;2023;3;3;0;100;0;220000;1981;113.333333333333
21170;2023;6;6;0;100;0;236162.833333333;1769.16666666667;137.5
21171;2023;169;46;123;27.2189349112426;72.7810650887574;185120.106508876;2602.22485207101;72.2011834319527
21172;2023;2;2;0;100;0;118575;1040;108
21173;2023;6;6;0;100;0;258828.333333333;2919.5;94.3333333333333
21175;2023;2;2;0;100;0;234200;1943;123.5
21176;2023;1;1;0;100;0;129000;1142;113
21177;2023;2;2;0;100;0;191380;1219;176.5
21178;2023;3;3;0;100;0;196520;2961.33333333333;69
21179;2023;5;5;0;100;0;402412;2382.2;190.8
21180;2023;1;1;0;100;0;205000;1220;168
21181;2023;4;4;0;100;0;151250;1742.25;84.75
21183;2023;10;10;0;100;0;220450;2252.2;102.6
21184;2023;1;1;0;100;0;28000;467;60
21185;2023;5;5;0;100;0;283206;2625.4;116.8
21186;2023;9;8;1;88.8888888888889;11.1111111111111;260531.111111111;2550.22222222222;99.1111111111111
21189;2023;5;5;0;100;0;192664;1752.2;107
21190;2023;5;5;0;100;0;387240;3506.8;111.8
21191;2023;10;10;0;100;0;301630;2723.3;111.9
21192;2023;10;10;0;100;0;321859.5;2894.9;112.6
21193;2023;4;4;0;100;0;211462.5;1839;105.5
21194;2023;10;9;1;90;10;190472;2324;82.1
21195;2023;1;1;0;100;0;221000;1922;115
21196;2023;12;12;0;100;0;202028.75;2048.16666666667;102
21199;2023;2;2;0;100;0;130500;2337.5;54.5
21200;2023;17;15;2;88.2352941176471;11.7647058823529;217915.882352941;2644.58823529412;85.6470588235294
21201;2023;5;5;0;100;0;113720;976.2;134.8
21202;2023;1;1;0;100;0;45000;662;68
21203;2023;2;2;0;100;0;45000;906;55.5
21204;2023;2;2;0;100;0;121750;1005.5;103.5
21207;2023;2;2;0;100;0;66000;1397.5;55
21208;2023;1;1;0;100;0;304000;1877;162
21209;2023;10;9;1;90;10;322117;3074.4;107.3
21210;2023;6;6;0;100;0;144520.833333333;1754.66666666667;86.5
21214;2023;4;4;0;100;0;58522.5;1066.25;64.75
21215;2023;1;1;0;100;0;289000;3176;91
21216;2023;1;1;0;100;0;164000;820;200
21217;2023;2;2;0;100;0;371000;2955.5;118.5
21219;2023;3;3;0;100;0;375333.333333333;2592.33333333333;149
21221;2023;1;1;0;100;0;210000;955;220
21222;2023;2;2;0;100;0;86250;1142;76
21223;2023;17;14;3;82.3529411764706;17.6470588235294;454602;3967.88235294118;116.176470588235
21225;2023;2;2;0;100;0;208500;1850;113
21226;2023;3;3;0;100;0;176950;1674;104.333333333333
21227;2023;4;4;0;100;0;357775;2723.5;132.75
21228;2023;1;1;0;100;0;115000;950;121
21229;2023;1;1;0;100;0;47000;783;60
21230;2023;1;1;0;100;0;274900;1922;143
21231;2023;2924;347;2577;11.8673050615595;88.1326949384405;170914.730506156;2798.27462380301;61.7393980848153
21233;2023;2;2;0;100;0;154500;1597.5;106.5
21234;2023;1;1;0;100;0;203000;2256;90
21235;2023;1;1;0;100;0;75000;630;119
21236;2023;4;4;0;100;0;190157.5;2033.75;94.75
21238;2023;5;5;0;100;0;239118.6;2142;109.8
21239;2023;11;11;0;100;0;179468.181818182;1927.81818181818;96.3636363636364
21241;2023;3;3;0;100;0;321666.666666667;2652;121.666666666667
21242;2023;2;2;0;100;0;176975;1683.5;100.5
21243;2023;1;1;0;100;0;240000;1500;160
21245;2023;2;2;0;100;0;146000;811.5;180
21246;2023;4;4;0;100;0;345287.5;3050.5;113.25
21247;2023;10;9;1;90;10;131085;1205.5;112
21249;2023;7;7;0;100;0;156608.571428571;1823.57142857143;87
21250;2023;1;1;0;100;0;25000;532;47
21251;2023;7;3;4;42.8571428571429;57.1428571428571;102714.285714286;1318.42857142857;80.1428571428571
21252;2023;1;1;0;100;0;48000;1500;32
21253;2023;1;1;0;100;0;88000;451;195
21254;2023;1;1;0;100;0;278800;1799;155
21255;2023;2;2;0;100;0;480500;3257.5;152
21256;2023;6;6;0;100;0;197766.666666667;1381;141.166666666667
21258;2023;3;2;1;66.6666666666667;33.3333333333333;104710;1072.33333333333;110.333333333333
21259;2023;6;6;0;100;0;126052.5;1236.66666666667;98
21261;2023;6;5;1;83.3333333333333;16.6666666666667;274000;2206.5;124.5
21263;2023;21;21;0;100;0;213456.19047619;2628.09523809524;78.9047619047619
21264;2023;1;1;0;100;0;247000;6175;40
21265;2023;4;4;0;100;0;1394525;6382.5;183.75
21266;2023;1;1;0;100;0;275000;3438;80
21267;2023;4;4;0;100;0;360278;3142.5;118.75
21268;2023;4;4;0;100;0;199750;1979.25;99.5
21269;2023;5;5;0;100;0;112868;1297.8;87.6
21270;2023;1;1;0;100;0;406000;3007;135
21271;2023;7;7;0;100;0;178857.142857143;2005.28571428571;103
21272;2023;2;2;0;100;0;130000;1573;81.5
21273;2023;11;9;2;81.8181818181818;18.1818181818182;287422.727272727;2370.09090909091;121.636363636364
21274;2023;1;1;0;100;0;50000;1087;46
21275;2023;2;2;0;100;0;185500;1902;97
21277;2023;14;14;0;100;0;145210.714285714;1406.35714285714;100.857142857143
21278;2023;110;49;61;44.5454545454545;55.4545454545455;275713.890909091;3006.24545454545;89.1363636363636
21280;2023;1;1;0;100;0;117000;1147;102
21281;2023;4;4;0;100;0;183412.5;1037.75;161.25
21283;2023;1;1;0;100;0;110000;1028;107
21284;2023;1;1;0;100;0;258000;2554;101
21285;2023;3;3;0;100;0;160500;1703;106
21287;2023;3;3;0;100;0;137666.666666667;1104;138
21289;2023;2;2;0;100;0;234850;2064.5;115.5
21290;2023;12;12;0;100;0;186071.833333333;1740.91666666667;112
21291;2023;2;2;0;100;0;191500;1626;117.5
21292;2023;51;37;14;72.5490196078431;27.4509803921569;184341.745098039;2167.74509803922;84.9411764705882
21293;2023;2;2;0;100;0;145005;1795.5;77
21294;2023;4;4;0;100;0;333662.5;2505;136.75
21295;2023;49;22;27;44.8979591836735;55.1020408163265;223512.163265306;2730.77551020408;82.3469387755102
21296;2023;2;2;0;100;0;82750;835;107
21297;2023;5;4;1;80;20;367800;2576.4;141
21298;2023;1;1;0;100;0;65100;740;88
21299;2023;1;1;0;100;0;40000;1143;35
21300;2023;5;5;0;100;0;221850;1883.4;121.8
21301;2023;2;2;0;100;0;77750;1405.5;52
21302;2023;2;2;0;100;0;62500;506.5;121
21304;2023;4;4;0;100;0;96224.75;1102.25;90
21305;2023;2;2;0;100;0;82500;700.5;120
21306;2023;1;1;0;100;0;256347;2136;120
21307;2023;1;1;0;100;0;90000;1364;66
21308;2023;2;2;0;100;0;49750;773;63.5
21309;2023;1;1;0;100;0;35000;700;50
21310;2023;2;2;0;100;0;205275;1622;129.5
21311;2023;2;2;0;100;0;217500;1663;136.5
21315;2023;3;3;0;100;0;418083.333333333;2992.66666666667;139.666666666667
21316;2023;5;5;0;100;0;102460;1640;69.6
21317;2023;45;42;3;93.3333333333333;6.66666666666667;241183.244444444;2355.86666666667;104.911111111111
21319;2023;6;6;0;100;0;242866.666666667;2260.83333333333;112
21320;2023;3;3;0;100;0;241266.666666667;2248.66666666667;110.333333333333
21321;2023;2;2;0;100;0;60000;659.5;82.5
21322;2023;4;4;0;100;0;186750;2091;92
21323;2023;2;2;0;100;0;158950;1964;81
21325;2023;1;1;0;100;0;248125;1909;130
21327;2023;2;2;0;100;0;2,00E+05;1311;132.5
21328;2023;1;1;0;100;0;139000;1015;137
21330;2023;1;1;0;100;0;295000;2077;142
21331;2023;3;3;0;100;0;133333.333333333;2116;76
21332;2023;12;12;0;100;0;117995;1336.5;92.5833333333333
21333;2023;6;6;0;100;0;143833.333333333;1607.16666666667;91.3333333333333
21334;2023;10;10;0;100;0;94635;1116.7;82.7
21335;2023;2;2;0;100;0;205900;1595.5;139.5
21336;2023;7;7;0;100;0;95064.2857142857;803.571428571429;120.857142857143
21337;2023;24;24;0;100;0;150666.166666667;1643.70833333333;95.125
21339;2023;5;5;0;100;0;250300;2370.4;104.2
21340;2023;2;2;0;100;0;226300;1550;146
21341;2023;1;1;0;100;0;50000;641;78
21342;2023;2;2;0;100;0;163575;2001.5;81.5
21343;2023;4;4;0;100;0;57750;1292.75;52.5
21344;2023;2;2;0;100;0;156500;1481;106
21345;2023;5;5;0;100;0;89900;1190;76.6
21346;2023;1;1;0;100;0;110000;1667;66
21347;2023;4;4;0;100;0;298777.5;2868.25;107
21348;2023;1;1;0;100;0;57500;1106;52
21349;2023;6;6;0;100;0;71784.3333333333;863.666666666667;82.5
21351;2023;12;11;1;91.6666666666667;8.33333333333333;195058.333333333;2166.75;89.5833333333333
21352;2023;14;13;1;92.8571428571429;7.14285714285714;248736.785714286;2486.35714285714;101.428571428571
21353;2023;12;11;1;91.6666666666667;8.33333333333333;282095.833333333;2547.66666666667;112.166666666667
21355;2023;91;33;58;36.2637362637363;63.7362637362637;184874.758241758;2602.56043956044;72.2637362637363
21356;2023;17;17;0;100;0;153384.294117647;1807.47058823529;87.9411764705882
21357;2023;2;2;0;100;0;85500;778;110
21358;2023;4;4;0;100;0;117625;830.5;140.5
21360;2023;2;2;0;100;0;93397.5;1545;60
21361;2023;5;5;0;100;0;270360;1823;144.2
21362;2023;3;3;0;100;0;213683.333333333;1476;149.333333333333
21363;2023;2;2;0;100;0;125250;1485;74
21364;2023;2;2;0;100;0;50875;682.5;75
21367;2023;5;5;0;100;0;219390;2552.2;90.2
21368;2023;3;3;0;100;0;123166.666666667;1400.33333333333;88.6666666666667
21369;2023;6;6;0;100;0;231333.333333333;2348.33333333333;98.6666666666667
21370;2023;6;6;0;100;0;325858.333333333;2817.16666666667;119.5
21371;2023;6;6;0;100;0;198133.333333333;1785.83333333333;111.333333333333
21372;2023;1;1;0;100;0;85000;977;87
21373;2023;6;6;0;100;0;229025;2456.5;98.8333333333333
21374;2023;1;1;0;100;0;185000;2011;92
21375;2023;3;3;0;100;0;60066.6666666667;764.333333333333;97.3333333333333
21376;2023;3;3;0;100;0;135000;1126.66666666667;118.333333333333
21377;2023;1;1;0;100;0;232000;1933;120
21379;2023;2;2;0;100;0;121500;1290.5;94
21380;2023;2;2;0;100;0;181500;1216;157.5
21382;2023;1;1;0;100;0;154500;1500;103
21383;2023;19;19;0;100;0;204413.684210526;2062.52631578947;100.421052631579
21385;2023;4;4;0;100;0;130050;1238.25;103.5
21386;2023;2;2;0;100;0;139425;820;170
21387;2023;3;3;0;100;0;275476.666666667;2346;119.666666666667
21388;2023;8;6;2;75;25;203841;1895;109.5
21390;2023;58;53;5;91.3793103448276;8.62068965517241;226634.603448276;2653.77586206897;86.5
21391;2023;6;6;0;100;0;354450;2101.83333333333;171
21392;2023;2;2;0;100;0;184875;1233;155
21393;2023;4;4;0;100;0;91875;927.75;98
21397;2023;1;1;0;100;0;253800;1302;195
21398;2023;5;5;0;100;0;129721.6;1328.4;102.6
21399;2023;4;4;0;100;0;117875;1489.75;71.25
21401;2023;1;1;0;100;0;2,00E+05;2500;80
21403;2023;2;2;0;100;0;90750;1184;73.5
21404;2023;4;4;0;100;0;164375;1957.25;85.25
21405;2023;4;4;0;100;0;303670;2563.5;113.25
21406;2023;3;3;0;100;0;231973.333333333;1812.66666666667;121
21407;2023;3;3;0;100;0;217000;2084;105.666666666667
21408;2023;18;16;2;88.8888888888889;11.1111111111111;392246.444444444;3309.33333333333;112.444444444444
21409;2023;4;4;0;100;0;176625;2409.75;83
21411;2023;3;3;0;100;0;304143.333333333;2550;119.333333333333
21412;2023;17;15;2;88.2352941176471;11.7647058823529;313055.882352941;2740.58823529412;111.705882352941
21413;2023;6;6;0;100;0;153916.666666667;2366.66666666667;85.1666666666667
21414;2023;1;1;0;100;0;218250;1949;112
21415;2023;1;1;0;100;0;93000;795;117
21416;2023;24;21;3;87.5;12.5;194133.458333333;2023.16666666667;97.1666666666667
21419;2023;7;7;0;100;0;119328.571428571;1559.42857142857;88.4285714285714
21420;2023;3;3;0;100;0;87666.6666666667;1058.33333333333;76.3333333333333
21421;2023;1;1;0;100;0;184200;1375;134
21422;2023;3;3;0;100;0;132000;1719;83
21423;2023;6;6;0;100;0;372400;3481.33333333333;118.5
21424;2023;4;4;0;100;0;219875;1947.75;111.5
21425;2023;51;35;16;68.6274509803922;31.3725490196078;103373.333333333;1395.76470588235;77.4117647058823
21426;2023;4;4;0;100;0;96350;1035.25;91.5
21427;2023;3;3;0;100;0;226166.666666667;1735.66666666667;111.666666666667
21429;2023;6;6;0;100;0;179215.833333333;1581;113.166666666667
21430;2023;1;1;0;100;0;120000;1091;110
21431;2023;1;1;0;100;0;65000;833;78
21432;2023;2;2;0;100;0;107900;593;175
21433;2023;5;5;0;100;0;100840;988.2;101.2
21434;2023;4;4;0;100;0;98900;1064;89.75
21435;2023;3;3;0;100;0;184006.666666667;1472.33333333333;136.333333333333
21436;2023;2;2;0;100;0;262500;1433;171.5
21437;2023;1;1;0;100;0;942988;9430;100
21438;2023;1;1;0;100;0;180000;2400;75
21440;2023;1;1;0;100;0;704260;7043;100
21441;2023;8;7;1;87.5;12.5;190475;1553.875;117
21442;2023;4;4;0;100;0;354712.5;2502.25;145.75
21445;2023;2;2;0;100;0;47500;565;81.5
21446;2023;3;3;0;100;0;84066.6666666667;881;107
21447;2023;2;2;0;100;0;146675;1452;94.5
21448;2023;1;1;0;100;0;76667;1394;55
21449;2023;1;1;0;100;0;25000;833;30
21451;2023;1;1;0;100;0;136000;663;205
21452;2023;17;13;4;76.4705882352941;23.5294117647059;268111.176470588;2790.70588235294;95
21454;2023;5;5;0;100;0;64288;752.2;85.8
21455;2023;2;2;0;100;0;51500;590;90
21456;2023;1;1;0;100;0;126700;1267;100
21457;2023;1;1;0;100;0;140000;1228;114
21458;2023;10;10;0;100;0;318039;2685.9;119
21459;2023;4;4;0;100;0;165175;2020;75.75
21460;2023;1;1;0;100;0;75000;862;87
21461;2023;22;20;2;90.9090909090909;9.09090909090909;101279.545454545;997.636363636364;105
21462;2023;6;6;0;100;0;365908.333333333;3073.83333333333;119.666666666667
21463;2023;1;1;0;100;0;55000;873;63
21464;2023;78;39;39;50;50;179013.641025641;2288.26923076923;79.6538461538462
21467;2023;3;3;0;100;0;205700;1656;116.666666666667
21468;2023;1;1;0;100;0;198500;1241;160
21469;2023;3;3;0;100;0;152333.333333333;1971.66666666667;90
21470;2023;1;1;0;100;0;31000;646;48
21472;2023;3;3;0;100;0;71499.3333333333;899;84
21473;2023;7;6;1;85.7142857142857;14.2857142857143;172878.571428571;2368.28571428571;81.7142857142857
21474;2023;9;9;0;100;0;163385.555555556;1650.33333333333;101
21475;2023;5;5;0;100;0;216640;1642.2;133
21476;2023;2;2;0;100;0;245395;1406;175
21478;2023;3;3;0;100;0;208333.333333333;1488.33333333333;137
21480;2023;1;1;0;100;0;175945;2514;70
21481;2023;14;10;4;71.4285714285714;28.5714285714286;260628.571428571;2891;90.6428571428571
21482;2023;10;10;0;100;0;183824.2;1597.3;122.1
21483;2023;3;3;0;100;0;243666.666666667;2003.33333333333;140.333333333333
21485;2023;30;22;8;73.3333333333333;26.6666666666667;210302;2633;78.3333333333333
21487;2023;3;3;0;100;0;155000;1631.66666666667;99
21488;2023;4;4;0;100;0;97793.5;817.75;111.25
21490;2023;1;1;0;100;0;50000;588;85
21492;2023;9;9;0;100;0;287407.777777778;2664.22222222222;108.111111111111
21493;2023;5;5;0;100;0;110550;1441.2;80.6
21494;2023;1;1;0;100;0;99000;582;170
21495;2023;3;3;0;100;0;164333.333333333;1851.33333333333;89.6666666666667
21496;2023;23;22;1;95.6521739130435;4.34782608695652;146964.043478261;1844.4347826087;84.3478260869565
21497;2023;3;3;0;100;0;210833.333333333;1683.33333333333;136.333333333333
21498;2023;2;1;1;50;50;84000;745.5;122.5
21499;2023;2;2;0;100;0;109000;914;131
21500;2023;4;4;0;100;0;107825;1874.5;62.5
21501;2023;14;13;1;92.8571428571429;7.14285714285714;173807.142857143;1702.35714285714;111.071428571429
21502;2023;6;6;0;100;0;147433.333333333;1040.33333333333;146.333333333333
21503;2023;2;2;0;100;0;144700;1648.5;83
21504;2023;1;1;0;100;0;174800;2056;85
21505;2023;7;7;0;100;0;133307.142857143;1416.42857142857;103.428571428571
21506;2023;4;2;2;50;50;167750;1782.5;96
21508;2023;4;4;0;100;0;355750;3138;123
21510;2023;1;1;0;100;0;2,00E+05;943;212
21512;2023;6;5;1;83.3333333333333;16.6666666666667;297638.333333333;3177;94.1666666666667
21514;2023;4;4;0;100;0;81250;680.25;120.5
21515;2023;73;29;44;39.7260273972603;60.2739726027397;191294.164383562;2302.20547945205;82.6027397260274
21516;2023;1;1;0;100;0;172500;2430;71
21517;2023;6;5;1;83.3333333333333;16.6666666666667;231233.333333333;2431;103.333333333333
21518;2023;1;1;0;100;0;70000;933;75
21519;2023;3;3;0;100;0;73700;719.333333333333;100.666666666667
21521;2023;10;10;0;100;0;316877.4;2549.5;126.3
21522;2023;10;10;0;100;0;171520;1972.5;94
21523;2023;1;1;0;100;0;30000;1364;22
21524;2023;1;1;0;100;0;130000;1300;100
21525;2023;12;12;0;100;0;113965.833333333;1240.58333333333;90.5
21527;2023;7;7;0;100;0;194628.571428571;2342.28571428571;78.4285714285714
21528;2023;2;2;0;100;0;78000;1089;70
21530;2023;3;3;0;100;0;71500;1005.66666666667;65.3333333333333
21531;2023;6;5;1;83.3333333333333;16.6666666666667;251133.333333333;1956.5;126.166666666667
21532;2023;12;12;0;100;0;331348.75;2723.75;134.416666666667
21533;2023;1;1;0;100;0;66200;1891;35
21534;2023;8;8;0;100;0;243512.5;2605.125;93.375
21535;2023;13;12;1;92.3076923076923;7.69230769230769;306873.076923077;2773.38461538462;118.692307692308
21536;2023;3;3;0;100;0;96473.3333333333;859.333333333333;110.666666666667
21537;2023;1;1;0;100;0;76000;1086;70
21538;2023;1;1;0;100;0;150000;1579;95
21540;2023;92;52;40;56.5217391304348;43.4782608695652;225311.967391304;2833.86956521739;82.0869565217391
21541;2023;2;2;0;100;0;165000;1289;128
21542;2023;2;2;0;100;0;282500;2660.5;108
21543;2023;3;3;0;100;0;85666.6666666667;948.333333333333;92.3333333333333
21545;2023;11;11;0;100;0;111215;1120.45454545455;99.6363636363636
21546;2023;9;9;0;100;0;97688.8888888889;1481.88888888889;71.7777777777778
21547;2023;2;2;0;100;0;140500;1570;92.5
21548;2023;1;1;0;100;0;80000;1455;55
21549;2023;2;2;0;100;0;75450;1088;69
21550;2023;2;2;0;100;0;177000;1632.5;111.5
21553;2023;5;5;0;100;0;169200;1335.8;124.4
21554;2023;24;4;20;16.6666666666667;83.3333333333333;67712.4583333333;982.458333333333;72.9166666666667
21555;2023;13;12;1;92.3076923076923;7.69230769230769;349523.076923077;2767.53846153846;130.076923076923
21556;2023;3;3;0;100;0;206800;1743;115.333333333333
21557;2023;3;3;0;100;0;145190;1172;130.666666666667
21558;2023;11;10;1;90.9090909090909;9.09090909090909;270204.545454545;2452.72727272727;109.545454545455
21559;2023;13;13;0;100;0;175253.846153846;1720.46153846154;100
21560;2023;5;5;0;100;0;101500;1456.4;69.2
21561;2023;4;4;0;100;0;201175;1918.75;105.25
21562;2023;5;5;0;100;0;101478;1101.2;96
21563;2023;3;3;0;100;0;83666.6666666667;1742.33333333333;70
21564;2023;2;2;0;100;0;117770;1152.5;113
21565;2023;5;5;0;100;0;285355.6;2546;125.2
21566;2023;2;2;0;100;0;99000;1127;88
21567;2023;1;1;0;100;0;110000;2200;50
21568;2023;7;7;0;100;0;97907.1428571429;1130.85714285714;86.5714285714286
21569;2023;5;5;0;100;0;181800;1354.8;134.2
21571;2023;4;3;1;75;25;85550;1211.5;79.5
21572;2023;1;1;0;100;0;183000;1397;131
21573;2023;8;8;0;100;0;146218.875;1654.25;97.125
21574;2023;7;7;0;100;0;121250;1040.85714285714;142.285714285714
21575;2023;2;1;1;50;50;89000;1215;72
21576;2023;2;2;0;100;0;134000;1508.5;100.5
21577;2023;14;14;0;100;0;201392.857142857;1961.85714285714;106.285714285714
21578;2023;4;4;0;100;0;172250;1826.75;96
21579;2023;3;3;0;100;0;104450;2233.66666666667;95.3333333333333
21580;2023;5;5;0;100;0;108220;1038;100.4
21582;2023;8;8;0;100;0;362861;3932.5;87
21584;2023;25;21;4;84;16;102247.52;1125.8;93.2
21585;2023;8;8;0;100;0;221227.5;2387.125;90.875
21586;2023;1;1;0;100;0;365300;2686;136
21587;2023;3;3;0;100;0;201666.666666667;1868;102.333333333333
21588;2023;1;1;0;100;0;35000;714;49
21589;2023;1;1;0;100;0;220000;2683;82
21590;2023;15;15;0;100;0;293516.666666667;2307.6;127.933333333333
21591;2023;6;6;0;100;0;323370;2664.83333333333;120.5
21592;2023;4;4;0;100;0;210887.5;1791.75;124.5
21593;2023;1;1;0;100;0;45000;849;53
21594;2023;2;2;0;100;0;95000;753.5;130.5
21595;2023;1;1;0;100;0;306500;2030;151
21596;2023;7;6;1;85.7142857142857;14.2857142857143;222014.285714286;2035.42857142857;109.571428571429
21597;2023;1;1;0;100;0;369550;2933;126
21598;2023;3;3;0;100;0;80166.6666666667;875.666666666667;83
21599;2023;30;26;4;86.6666666666667;13.3333333333333;145037.666666667;1654.23333333333;91.6
21601;2023;1;1;0;100;0;219000;3129;70
21602;2023;2;2;0;100;0;30500;664;46.5
21603;2023;32;25;7;78.125;21.875;160704.71875;1734.59375;94.03125
21604;2023;1;1;0;100;0;157000;707;222
21605;2023;17;15;2;88.2352941176471;11.7647058823529;269118.529411765;2841.11764705882;99.0588235294118
21606;2023;14;14;0;100;0;230882.5;2229.85714285714;106.857142857143
21607;2023;47;39;8;82.9787234042553;17.0212765957447;98110;1235.48936170213;81.936170212766
21608;2023;2;2;0;100;0;151478.5;1257.5;115
21609;2023;6;6;0;100;0;245758.333333333;2067.16666666667;118.833333333333
21610;2023;2;2;0;100;0;202450;1850.5;111
21611;2023;6;6;0;100;0;199250;1735.33333333333;122.333333333333
21613;2023;3;3;0;100;0;110801.333333333;1030;124.333333333333
21614;2023;3;3;0;100;0;195316.666666667;1792.33333333333;106.666666666667
21615;2023;1;1;0;100;0;50000;833;60
21616;2023;1;1;0;100;0;312750;2406;130
21617;2023;137;46;91;33.5766423357664;66.4233576642336;219565.773722628;2703.6496350365;79.7153284671533
21618;2023;2;2;0;100;0;97500;1800;58.5
21619;2023;1;1;0;100;0;223900;1683;133
21620;2023;1;1;0;100;0;37000;1542;24
21622;2023;2;2;0;100;0;281250;2397.5;120.5
21623;2023;8;8;0;100;0;269162.5;2779.5;95.875
21624;2023;1;1;0;100;0;160000;1391;115
21627;2023;1;1;0;100;0;60000;741;81
21629;2023;5;5;0;100;0;133400;1216.8;107.6
21630;2023;5;5;0;100;0;153582;1372.4;122.6
21631;2023;2;2;0;100;0;51000;526.5;92
21632;2023;20;17;3;85;15;243669.5;2485.1;98.45
21633;2023;1;1;0;100;0;189500;1458;130
21634;2023;6;6;0;100;0;99250;1072.5;81.6666666666667
21635;2023;2;2;0;100;0;135000;653;200.5
21636;2023;8;8;0;100;0;90716;1682.75;64.25
21637;2023;4;4;0;100;0;229387.5;1821.75;125.75
21638;2023;9;7;2;77.7777777777778;22.2222222222222;210011.111111111;1955;108.222222222222
21639;2023;6;6;0;100;0;186908.333333333;1687.83333333333;112.166666666667
21640;2023;2;2;0;100;0;105525;1144.5;91.5
21641;2023;7;7;0;100;0;109633.571428571;930.285714285714;121.714285714286
21642;2023;1;1;0;100;0;156635;1205;130
21643;2023;5;5;0;100;0;196567.2;1611.6;122.4
21644;2023;3;3;0;100;0;154000;1447.33333333333;102
21645;2023;8;8;0;100;0;183125;1465.75;133.75
21648;2023;2;2;0;100;0;176000;1351.5;168
21649;2023;2;2;0;100;0;185000;2022;102.5
21650;2023;1;1;0;100;0;361100;1952;185
21651;2023;5;5;0;100;0;198610.6;1919;98.6
21652;2023;5;5;0;100;0;139600;1758.2;79.4
21655;2023;4;4;0;100;0;131250;1347;99.25
21656;2023;3;3;0;100;0;245000;2680;92.6666666666667
21657;2023;28;25;3;89.2857142857143;10.7142857142857;307352.142857143;2948.42857142857;108.142857142857
21659;2023;2;2;0;100;0;123750;931.5;131.5
21661;2023;18;14;4;77.7777777777778;22.2222222222222;266217.222222222;2265.27777777778;112.166666666667
21662;2023;1;1;0;100;0;99800;786;127
21663;2023;13;11;2;84.6153846153846;15.3846153846154;135723.076923077;1537.30769230769;92
21664;2023;1;1;0;100;0;165000;1701;97
21667;2023;1;1;0;100;0;91000;758;120
21669;2023;2;2;0;100;0;236875;1978.5;120
21670;2023;6;6;0;100;0;103958.333333333;1160.16666666667;81
21671;2023;3;3;0;100;0;74666.6666666667;1512.66666666667;41.3333333333333
21672;2023;1;1;0;100;0;92800;910;102
21673;2023;3;3;0;100;0;133786.666666667;1154.66666666667;122
21676;2023;2;2;0;100;0;89500;1011;99
21677;2023;1;1;0;100;0;90000;1000;90
21678;2023;3;3;0;100;0;260430;1875.33333333333;140.333333333333
21679;2023;1;1;0;100;0;65000;1477;44
21680;2023;4;4;0;100;0;115475;975.75;118
21681;2023;2;2;0;100;0;120500;1385.5;80
21682;2023;3;3;0;100;0;191000;1776.66666666667;105.333333333333
21683;2023;5;5;0;100;0;129800;1926.4;72.2
21684;2023;3;3;0;100;0;355378;2158.66666666667;163
21685;2023;3;3;0;100;0;55306.6666666667;550.666666666667;101
21686;2023;2;2;0;100;0;205000;1923;102
21688;2023;4;4;0;100;0;343265;2436.5;153.75
21690;2023;1;1;0;100;0;45000;652;69
21691;2023;2;2;0;100;0;195100;1570.5;114.5
21692;2023;1;1;0;100;0;370000;2312;160
21696;2023;3;3;0;100;0;174000;1471.33333333333;122
21698;2023;4;4;0;100;0;243725;2634.25;94.5
21699;2023;12;11;1;91.6666666666667;8.33333333333333;196937.5;1804.83333333333;108
21700;2023;3;3;0;100;0;111666.666666667;1290.33333333333;87.3333333333333
21701;2023;2;2;0;100;0;134750;1500.5;90
21702;2023;4;4;0;100;0;138575;1543.25;99.25
21703;2023;2;2;0;100;0;62000;1302.5;48
21704;2023;1;1;0;100;0;73000;811;90
21707;2023;1;1;0;100;0;154000;1262;122
21708;2023;1;1;0;100;0;539000;2519;214
21709;2023;1;1;0;100;0;280000;1867;150
21710;2023;20;18;2;90;10;90771.75;941.85;93.45
21712;2023;4;4;0;100;0;194605;2503.75;82
21713;2023;8;7;1;87.5;12.5;157218.75;1567;101.75
21714;2023;8;8;0;100;0;224262.5;2445.625;101.875
21715;2023;1;1;0;100;0;32000;821;39
21716;2023;5;5;0;100;0;167330;1954.6;82.8
21717;2023;3;3;0;100;0;52400;914.333333333333;75.6666666666667
22001;2023;9;9;0;100;0;122666.666666667;1191.77777777778;104.555555555556
22002;2023;16;16;0;100;0;208190.625;2123.875;97.0625
22003;2023;12;12;0;100;0;217004.166666667;2089.66666666667;100.166666666667
22004;2023;73;67;6;91.7808219178082;8.21917808219178;164725.849315068;1859.52054794521;90.7397260273973
22005;2023;18;18;0;100;0;118548.333333333;1258.83333333333;99.8888888888889
22006;2023;2;2;0;100;0;117243;1153.5;99
22008;2023;11;11;0;100;0;214678.181818182;2137;108.636363636364
22009;2023;3;3;0;100;0;77500;1591.33333333333;68.3333333333333
22011;2023;11;11;0;100;0;125227.272727273;1341.63636363636;96.8181818181818
22012;2023;10;10;0;100;0;166550;2054.7;79.1
22013;2023;41;41;0;100;0;110041.487804878;1264.14634146341;86.5609756097561
22014;2023;13;13;0;100;0;227382.307692308;2313.92307692308;101
22015;2023;12;12;0;100;0;187033.25;2076.5;89.1666666666667
22016;2023;12;12;0;100;0;498993.333333333;6849.83333333333;75.4166666666667
22018;2023;3;3;0;100;0;215333.333333333;2042.33333333333;110
22019;2023;7;7;0;100;0;186941.142857143;2080.14285714286;96
22020;2023;35;35;0;100;0;187732.371428571;1780.2;105.4
22021;2023;12;12;0;100;0;206516.666666667;2119.33333333333;98.1666666666667
22023;2023;7;7;0;100;0;147142.714285714;1101.85714285714;133
22024;2023;4;4;0;100;0;96962.5;1148.25;89.5
22025;2023;67;67;0;100;0;104153.358208955;1147.02985074627;94.8059701492537
22026;2023;6;6;0;100;0;142753.333333333;1775.33333333333;78.6666666666667
22027;2023;5;5;0;100;0;64383;725;86
22028;2023;7;7;0;100;0;241552.285714286;2140.28571428571;112
22029;2023;4;4;0;100;0;111367.5;1517.75;81
22030;2023;5;5;0;100;0;194560;1811.8;108.6
22031;2023;11;11;0;100;0;78418.1818181818;1254.63636363636;67.4545454545455
22032;2023;23;23;0;100;0;158830;1533.65217391304;109.347826086957
22033;2023;9;9;0;100;0;100424.444444444;1589.88888888889;65.5555555555556
22034;2023;16;16;0;100;0;178284.0625;2043.375;95.6875
22035;2023;21;21;0;100;0;177995.238095238;1967.90476190476;90.6666666666667
22036;2023;5;5;0;100;0;93900;1064.8;97.4
22037;2023;14;14;0;100;0;86179.3571428571;1076.35714285714;83.4285714285714
22039;2023;6;6;0;100;0;133400;1351.16666666667;99.6666666666667
22040;2023;6;6;0;100;0;166166.666666667;1306.83333333333;128.333333333333
22041;2023;2;2;0;100;0;113000;1647;78
22042;2023;7;7;0;100;0;184285.714285714;1689.14285714286;110
22043;2023;4;4;0;100;0;102467.5;1646.5;67.75
22044;2023;20;20;0;100;0;217084.6;2282.5;95.9
22046;2023;105;102;3;97.1428571428571;2.85714285714286;128617.819047619;1235.2380952381;103.4
22047;2023;17;17;0;100;0;123872.941176471;1378.64705882353;97
22048;2023;28;28;0;100;0;242658.035714286;2236.39285714286;109.678571428571
22049;2023;23;23;0;100;0;221065.217391304;2363;92.0434782608696
22050;2023;280;125;155;44.6428571428571;55.3571428571429;243008.275;2964.84642857143;82.6642857142857
22052;2023;9;9;0;100;0;120308;1012.22222222222;126.444444444444
22053;2023;17;17;0;100;0;118617.647058824;1251.35294117647;92.7647058823529
22054;2023;92;68;24;73.9130434782609;26.0869565217391;339209.945652174;3896.96739130435;94.5760869565217
22055;2023;119;102;17;85.7142857142857;14.2857142857143;337586.789915966;3353.25210084034;100.596638655462
22056;2023;22;22;0;100;0;256826.363636364;2078.95454545455;126.727272727273
22057;2023;5;5;0;100;0;162800;2191.2;88.8
22059;2023;17;17;0;100;0;206095;1757.70588235294;122.176470588235
22060;2023;6;6;0;100;0;81416.6666666667;991.666666666667;88
22061;2023;35;35;0;100;0;115884.142857143;1459.45714285714;82.6
22062;2023;6;6;0;100;0;174416.666666667;1573.5;125.5
22063;2023;8;8;0;100;0;175143.125;1829;97.5
22064;2023;11;11;0;100;0;120497.272727273;1566.18181818182;87.8181818181818
22065;2023;30;30;0;100;0;186636.666666667;1876.63333333333;101.7
22067;2023;30;30;0;100;0;156280;1769.6;87.9
22068;2023;4;4;0;100;0;108250;1177.75;89.25
22069;2023;4;4;0;100;0;121450;1731.25;81.5
22070;2023;108;59;49;54.6296296296296;45.3703703703704;117884.453703704;1747.65740740741;75.1944444444444
22071;2023;11;11;0;100;0;141745.454545455;1619.90909090909;85.8181818181818
22072;2023;5;5;0;100;0;101000;1315;77.8
22073;2023;2;2;0;100;0;121500;1435;84.5
22074;2023;10;10;0;100;0;99447;1249;79.3
22075;2023;4;4;0;100;0;138250;1384.25;113.25
22076;2023;16;16;0;100;0;198471.875;2145;96.9375
22077;2023;8;8;0;100;0;236406;2383.875;98.625
22079;2023;27;27;0;100;0;212547.037037037;1889.59259259259;122.407407407407
22081;2023;42;41;1;97.6190476190476;2.38095238095238;249622.119047619;2422.59523809524;102.166666666667
22082;2023;8;8;0;100;0;244450.875;2271.75;107.5
22083;2023;14;14;0;100;0;107027;1128.5;94.2857142857143
22084;2023;32;31;1;96.875;3.125;155590.3125;1816.28125;89.1875
22085;2023;4;4;0;100;0;189875;2056.25;95
22086;2023;11;11;0;100;0;216757.272727273;2444.09090909091;91.0909090909091
22087;2023;19;19;0;100;0;86159.1578947368;856.421052631579;97.4210526315789
22088;2023;7;7;0;100;0;114117.857142857;1212.57142857143;88.5714285714286
22090;2023;15;15;0;100;0;239733.333333333;2432.46666666667;98.7333333333333
22091;2023;6;6;0;100;0;135775;1528.33333333333;92.5
22092;2023;3;3;0;100;0;64796.6666666667;706.666666666667;92
22093;2023;193;136;57;70.4663212435233;29.5336787564767;214679.533678756;2493.92227979275;87.0932642487047
22094;2023;36;29;7;80.5555555555556;19.4444444444444;505659.611111111;5788.55555555556;85.5
22095;2023;3;3;0;100;0;108333.333333333;1426.66666666667;83
22096;2023;6;6;0;100;0;148776.166666667;1395;107.833333333333
22097;2023;4;4;0;100;0;184250;1463.75;138.75
22098;2023;14;14;0;100;0;244005;1976.28571428571;126.571428571429
22099;2023;13;13;0;100;0;146682;1397;111.461538461538
22101;2023;21;21;0;100;0;180312.380952381;1863.95238095238;99.3333333333333
22103;2023;14;14;0;100;0;281939.571428571;3086.5;97.2857142857143
22104;2023;6;6;0;100;0;135583.333333333;1428;98.5
22105;2023;10;10;0;100;0;239237.1;2146.2;110.4
22106;2023;78;60;18;76.9230769230769;23.0769230769231;220672.974358974;2542.69230769231;94.5769230769231
22107;2023;26;25;1;96.1538461538462;3.84615384615385;108891.384615385;1500.30769230769;70.3846153846154
22109;2023;11;11;0;100;0;215054.545454545;2124.72727272727;101.909090909091
22110;2023;3;3;0;100;0;206666.666666667;2016;103
22111;2023;2;2;0;100;0;280304;4367;74
22112;2023;7;7;0;100;0;143200;1369.85714285714;107.285714285714
22113;2023;285;195;90;68.4210526315789;31.5789473684211;183649.761403509;2156.05614035088;85.3649122807018
22114;2023;8;8;0;100;0;162312.5;2108.375;87.625
22115;2023;6;6;0;100;0;119844.5;1136.66666666667;119
22116;2023;14;14;0;100;0;199883.785714286;2026;103.857142857143
22117;2023;16;16;0;100;0;232693.75;2540.125;93.1875
22118;2023;62;54;8;87.0967741935484;12.9032258064516;245295.096774194;2586.11290322581;95.5483870967742
22119;2023;17;17;0;100;0;181176.470588235;2205.11764705882;91.5882352941177
22121;2023;26;22;4;84.6153846153846;15.3846153846154;201348.461538462;2673.76923076923;88.6923076923077
22122;2023;19;19;0;100;0;104882.052631579;1379.94736842105;86.7368421052632
22124;2023;4;4;0;100;0;76250;796.25;93
22126;2023;4;4;0;100;0;178500;1444;116
22127;2023;23;22;1;95.6521739130435;4.34782608695652;212026.086956522;2327.26086956522;95.7391304347826
22128;2023;8;8;0;100;0;106153.75;1426.25;74.75
22129;2023;2;2;0;100;0;82000;2180;61
22131;2023;21;21;0;100;0;115954.761904762;1303.33333333333;93.7142857142857
22132;2023;6;6;0;100;0;95086.6666666667;1725.16666666667;65.8333333333333
22133;2023;1;1;0;100;0;105000;1167;90
22134;2023;36;35;1;97.2222222222222;2.77777777777778;365103.333333333;3397.97222222222;109.722222222222
22135;2023;41;41;0;100;0;152035.43902439;1638.17073170732;95.2682926829268
22136;2023;119;88;31;73.9495798319328;26.0504201680672;144757;1670.94117647059;91.7310924369748
22137;2023;41;41;0;100;0;106933.43902439;1281.85365853659;81.4146341463415
22138;2023;11;11;0;100;0;83291.3636363636;1102.90909090909;74.8181818181818
22139;2023;5;5;0;100;0;72800;973.4;82
22140;2023;5;5;0;100;0;179000;1714;105
22141;2023;3;3;0;100;0;190833.333333333;1088;158
22143;2023;44;36;8;81.8181818181818;18.1818181818182;234726.590909091;2721.13636363636;89.6136363636364
22144;2023;8;8;0;100;0;219403;2260.625;99.5
22145;2023;10;10;0;100;0;214459;1838.5;118.4
22146;2023;12;12;0;100;0;106880.833333333;1208.5;88.3333333333333
22147;2023;32;28;4;87.5;12.5;133862.65625;1621.15625;88.15625
22148;2023;2;2;0;100;0;235700;1547;147.5
22149;2023;11;11;0;100;0;114897.272727273;1167.81818181818;98.3636363636364
22150;2023;15;15;0;100;0;187280;2128.8;90
22152;2023;15;15;0;100;0;201665.933333333;1951.46666666667;103.8
22153;2023;16;16;0;100;0;155175;1444.625;115.75
22155;2023;25;25;0;100;0;138250;1269.84;108.48
22156;2023;14;14;0;100;0;144276.5;1671;91.5
22157;2023;6;6;0;100;0;157083.333333333;1464.33333333333;105.666666666667
22158;2023;44;44;0;100;0;126468.181818182;1426.84090909091;95.7045454545455
22160;2023;7;7;0;100;0;192712.428571429;1921.28571428571;103.714285714286
22161;2023;34;34;0;100;0;180251.470588235;1740.88235294118;113.529411764706
22162;2023;112;79;33;70.5357142857143;29.4642857142857;290440.098214286;3412.72321428571;85.9642857142857
22163;2023;11;11;0;100;0;99376.3636363636;1275.90909090909;82.5454545454545
22164;2023;26;26;0;100;0;157526.192307692;1676.26923076923;95.4230769230769
22165;2023;5;5;0;100;0;190444.2;1714.4;106.4
22166;2023;34;32;2;94.1176470588235;5.88235294117647;293967.411764706;3203.38235294118;98.2058823529412
22168;2023;170;103;67;60.5882352941176;39.4117647058824;317732.205882353;3979.58235294118;81.2470588235294
22169;2023;1;1;0;100;0;61000;953;64
22170;2023;13;13;0;100;0;147834.615384615;2072.15384615385;74
22171;2023;62;61;1;98.3870967741936;1.61290322580645;204156.709677419;1952.11290322581;107.5
22172;2023;51;33;18;64.7058823529412;35.2941176470588;164748.62745098;2178.98039215686;77.8235294117647
22174;2023;12;12;0;100;0;180586.25;1819.25;103.416666666667
22175;2023;19;19;0;100;0;150170.842105263;1566.21052631579;99.6315789473684
22176;2023;76;67;9;88.1578947368421;11.8421052631579;194629.223684211;2000.10526315789;94.9736842105263
22177;2023;12;12;0;100;0;243750;2202.58333333333;110.333333333333
22178;2023;14;14;0;100;0;186430.142857143;1845.57142857143;100
22179;2023;40;25;15;62.5;37.5;264531;3622.75;74.825
22180;2023;26;26;0;100;0;202060.307692308;2141.26923076923;100.423076923077
22181;2023;20;20;0;100;0;137883.75;1322.45;94.15
22182;2023;27;27;0;100;0;173714.111111111;1907.40740740741;93
22183;2023;40;40;0;100;0;113866.85;1302.3;89.25
22184;2023;20;19;1;95;5;144075;1552.5;91.75
22185;2023;31;31;0;100;0;158884.677419355;1715.22580645161;97.6129032258064
22186;2023;106;58;48;54.7169811320755;45.2830188679245;365838.745283019;4409.98113207547;83.8490566037736
22187;2023;193;149;44;77.2020725388601;22.7979274611399;259096.533678756;2964.17616580311;90.4663212435233
22188;2023;5;5;0;100;0;186306;2030.4;91.4
22189;2023;5;5;0;100;0;110084.2;1798;59.2
22190;2023;53;51;2;96.2264150943396;3.77358490566038;261054.283018868;2572.90566037736;106.471698113208
22193;2023;20;16;4;80;20;143509.55;1537.1;90.9
22194;2023;74;66;8;89.1891891891892;10.8108108108108;211915.635135135;2316.24324324324;93.1216216216216
22195;2023;56;54;2;96.4285714285714;3.57142857142857;218351.053571429;2725.92857142857;84.8214285714286
22196;2023;18;18;0;100;0;182656.611111111;2050.27777777778;100.611111111111
22197;2023;35;35;0;100;0;332676.285714286;3161.82857142857;108.057142857143
22198;2023;46;43;3;93.4782608695652;6.52173913043478;358073.456521739;3224.5652173913;110.565217391304
22199;2023;18;18;0;100;0;176723.333333333;1817.11111111111;97.4444444444444
22200;2023;5;5;0;100;0;199930;2180.6;93.2
22201;2023;9;8;1;88.8888888888889;11.1111111111111;396555.555555556;4208.77777777778;102.777777777778
22202;2023;15;15;0;100;0;90771.9333333333;1106;81.8666666666667
22203;2023;52;51;1;98.0769230769231;1.92307692307692;141032.423076923;1643.63461538462;87.6153846153846
22204;2023;17;17;0;100;0;134535.647058824;1532.47058823529;94.0588235294118
22205;2023;8;8;0;100;0;176312.5;1665.375;107.125
22206;2023;49;47;2;95.9183673469388;4.08163265306122;156406.734693878;1576.38775510204;98.469387755102
22207;2023;32;32;0;100;0;166256.25;1778.78125;94.71875
22208;2023;21;20;1;95.2380952380952;4.76190476190476;129833.857142857;1602.2380952381;83.8571428571429
22209;2023;63;53;10;84.1269841269841;15.8730158730159;293575.079365079;3175.31746031746;92.3968253968254
22210;2023;46;45;1;97.8260869565217;2.17391304347826;356902.239130435;3556.95652173913;105.760869565217
22211;2023;65;60;5;92.3076923076923;7.69230769230769;201285.661538462;2200.21538461538;91.4153846153846
22212;2023;24;24;0;100;0;156501.208333333;1704.33333333333;94.875
22213;2023;53;51;2;96.2264150943396;3.77358490566038;329274.377358491;2941.66037735849;111.792452830189
22214;2023;61;61;0;100;0;213581.967213115;2358.96721311475;91.8360655737705
22215;2023;134;123;11;91.7910447761194;8.2089552238806;193692.02238806;2026.14179104478;97.2686567164179
22216;2023;16;16;0;100;0;147832.625;1588.125;96.6875
22217;2023;12;12;0;100;0;98553.8333333333;1348;77.0833333333333
22218;2023;24;24;0;100;0;271316.708333333;3257.5;88.2916666666667
22219;2023;25;25;0;100;0;127393.6;1265.28;102.28
22220;2023;22;22;0;100;0;108539.772727273;1053.59090909091;103.409090909091
22221;2023;28;28;0;100;0;202964.5;2179.57142857143;92.7857142857143
22222;2023;101;88;13;87.1287128712871;12.8712871287129;217833.504950495;2522.18811881188;89.970297029703
22223;2023;29;29;0;100;0;189899.551724138;1755.89655172414;108.655172413793
22224;2023;17;17;0;100;0;262511.470588235;2433.58823529412;107.176470588235
22225;2023;90;77;13;85.5555555555556;14.4444444444444;159275.377777778;1766.3;92.1777777777778
22226;2023;28;28;0;100;0;216771.857142857;1955.14285714286;113.392857142857
22227;2023;20;20;0;100;0;99511.6;1524.2;67.05
22228;2023;16;16;0;100;0;168118.5625;1825.0625;97.8125
22229;2023;12;12;0;100;0;75405;926.416666666667;87.8333333333333
22231;2023;17;17;0;100;0;103275.294117647;1126.35294117647;87.5882352941177
22232;2023;30;30;0;100;0;204146.633333333;2130.9;95.8666666666667
22233;2023;28;28;0;100;0;179087.678571429;1693;101.857142857143
22234;2023;13;13;0;100;0;219116.076923077;2112.46153846154;103.923076923077
22235;2023;5;5;0;100;0;132400;1859.6;73.8
22236;2023;4;4;0;100;0;166250;1664.5;101.5
22237;2023;26;26;0;100;0;238524.615384615;2089.30769230769;118.038461538462
22238;2023;14;14;0;100;0;160696.428571429;1975.71428571429;84.6428571428571
22239;2023;20;20;0;100;0;171728.85;1673.6;101.3
22240;2023;24;24;0;100;0;112641.333333333;1323.54166666667;96.9583333333333
22241;2023;12;12;0;100;0;104559.583333333;1200;86.0833333333333
22242;2023;30;30;0;100;0;286976.566666667;3268.33333333333;91.2666666666667
22243;2023;14;14;0;100;0;94625.7142857143;1086.42857142857;90.1428571428571
22244;2023;11;11;0;100;0;110236.363636364;1141.36363636364;95.9090909090909
22245;2023;18;18;0;100;0;120372.944444444;1439.5;87.7222222222222
22246;2023;23;23;0;100;0;185848.652173913;2016.34782608696;94.3913043478261
22248;2023;21;21;0;100;0;159592.857142857;1591.33333333333;104.142857142857
22249;2023;17;17;0;100;0;110344.117647059;1270.05882352941;91.8823529411765
22250;2023;31;23;8;74.1935483870968;25.8064516129032;144989.516129032;1642.35483870968;87.4193548387097
22251;2023;89;85;4;95.5056179775281;4.49438202247191;268327.898876405;2628.32584269663;105.516853932584
22254;2023;13;13;0;100;0;150189.923076923;1568.15384615385;95.6153846153846
22255;2023;17;17;0;100;0;149363.058823529;1784.17647058824;102.235294117647
22256;2023;17;17;0;100;0;178310.882352941;1730.70588235294;101.764705882353
22257;2023;5;5;0;100;0;124618;1577.2;88
22258;2023;47;46;1;97.8723404255319;2.12765957446809;182745.531914894;1996.04255319149;93.8085106382979
22259;2023;40;38;2;95;5;233734.25;2406.05;95.525
22260;2023;13;13;0;100;0;160651.307692308;1377.15384615385;118.923076923077
22261;2023;1;1;0;100;0;150000;962;156
22262;2023;35;34;1;97.1428571428571;2.85714285714286;201434.257142857;2065.94285714286;111.828571428571
22263;2023;5;5;0;100;0;206322.4;1822.6;113
22264;2023;40;39;1;97.5;2.5;157668.3;1639.175;100.625
22265;2023;21;21;0;100;0;191297.619047619;2120.42857142857;91.9047619047619
22266;2023;59;59;0;100;0;109200.084745763;1243.03389830508;86.6949152542373
22267;2023;8;8;0;100;0;116660;1436.875;81.25
22268;2023;8;8;0;100;0;247354.25;2249;112.625
22269;2023;1;1;0;100;0;37000;1121;33
22271;2023;5;5;0;100;0;102560;1077.8;96
22272;2023;18;16;2;88.8888888888889;11.1111111111111;196308.333333333;2343.66666666667;93.1111111111111
22273;2023;18;17;1;94.4444444444444;5.55555555555556;295330.444444444;2495.61111111111;118.944444444444
22274;2023;6;6;0;100;0;282500;1917.33333333333;146.5
22275;2023;15;15;0;100;0;145126.266666667;1565.26666666667;94.4
22276;2023;1;1;0;100;0;125000;1374;91
22277;2023;35;32;3;91.4285714285714;8.57142857142857;153402.228571429;1666.6;91.1428571428571
22278;2023;949;354;595;37.3024236037935;62.6975763962065;138332.761854584;1882.78714436249;73.7671232876712
22279;2023;21;21;0;100;0;135369.904761905;1379.14285714286;96.7142857142857
22280;2023;12;12;0;100;0;283537.083333333;2632.33333333333;111.25
22281;2023;17;17;0;100;0;181309.411764706;1626.82352941176;113.941176470588
22282;2023;111;62;49;55.8558558558559;44.1441441441441;396738.09009009;4733.94594594595;84.4054054054054
22283;2023;23;23;0;100;0;134130.434782609;1655.91304347826;86.695652173913
22284;2023;8;8;0;100;0;113015;1294.625;85
22286;2023;9;9;0;100;0;184538.444444444;1663;109.222222222222
22287;2023;15;14;1;93.3333333333333;6.66666666666667;191586.666666667;1861.06666666667;103.666666666667
22288;2023;3;3;0;100;0;148289.666666667;942;154
22289;2023;5;5;0;100;0;69800;1149.8;54.6
22291;2023;4;4;0;100;0;167625;1834.5;96
22293;2023;10;10;0;100;0;145300;1452.1;100.9
22294;2023;8;8;0;100;0;87000;1044.75;87.5
22295;2023;10;10;0;100;0;123097.9;1091.3;116.6
22296;2023;4;4;0;100;0;180400;1553.25;110
22299;2023;17;17;0;100;0;203725.882352941;2155.76470588235;101.647058823529
22300;2023;10;10;0;100;0;147450;1175.5;128.9
22302;2023;35;30;5;85.7142857142857;14.2857142857143;408555.485714286;4344.34285714286;100.714285714286
22304;2023;3;3;0;100;0;216500;2746.66666666667;83.3333333333333
22305;2023;8;8;0;100;0;116475;1413.75;81.125
22306;2023;4;4;0;100;0;212450;2120.75;100.75
22307;2023;12;12;0;100;0;210787.5;2010.5;102.333333333333
22308;2023;12;12;0;100;0;99333.3333333333;1179.33333333333;81.8333333333333
22309;2023;4;4;0;100;0;188220.5;2517.25;82
22310;2023;9;9;0;100;0;125766.666666667;1384.55555555556;86
22311;2023;13;13;0;100;0;278148.230769231;2570.61538461538;106.307692307692
22312;2023;4;4;0;100;0;118025;1633.5;76.25
22313;2023;7;7;0;100;0;153714.285714286;1230.71428571429;123.571428571429
22314;2023;2;2;0;100;0;157900;1527.5;106
22315;2023;8;8;0;100;0;169437.5;1778.875;99.375
22316;2023;19;19;0;100;0;88547.8947368421;1164.15789473684;78.2105263157895
22317;2023;1;1;0;100;0;175000;1535;114
22318;2023;7;7;0;100;0;171381.428571429;2026.71428571429;84.7142857142857
22319;2023;8;7;1;87.5;12.5;289268.75;2437.5;115.625
22320;2023;2;2;0;100;0;171500;2586;75
22321;2023;49;48;1;97.9591836734694;2.04081632653061;96242.1836734694;1166.81632653061;85.3877551020408
22322;2023;3;3;0;100;0;151100;1411.33333333333;104.666666666667
22323;2023;11;11;0;100;0;197954.545454545;2130.27272727273;99.8181818181818
22324;2023;21;21;0;100;0;234482.428571429;2384.14285714286;99.9047619047619
22325;2023;80;51;29;63.75;36.25;310580.35;3939.6375;81.2125
22326;2023;4;4;0;100;0;224187.5;1820.25;121.25
22327;2023;16;16;0;100;0;261044.9375;2631.8125;104.1875
22328;2023;11;11;0;100;0;96119.5454545455;1298.81818181818;79
22330;2023;6;6;0;100;0;128831.666666667;1613.16666666667;93.8333333333333
22331;2023;2;2;0;100;0;102750;1131;84
22332;2023;2;2;0;100;0;316050;2336;131
22333;2023;14;14;0;100;0;129432.785714286;1346.71428571429;106.642857142857
22335;2023;5;4;1;80;20;90713;1322.2;76
22337;2023;10;10;0;100;0;125350;1158.5;105.3
22338;2023;5;5;0;100;0;131000;1654.8;79.6
22339;2023;43;37;6;86.046511627907;13.953488372093;211125.953488372;2172.76744186047;99.0697674418605
22340;2023;10;10;0;100;0;197770;1921.3;100.5
22341;2023;12;12;0;100;0;147741.666666667;1745.75;84.4166666666667
22342;2023;5;5;0;100;0;218985.2;2665.8;81.8
22343;2023;75;47;28;62.6666666666667;37.3333333333333;297480.946666667;3439.84;81.5733333333333
22344;2023;12;12;0;100;0;115359.583333333;1441.16666666667;81.25
22345;2023;11;11;0;100;0;134697.272727273;1615;88
22346;2023;6;6;0;100;0;147766.666666667;1778.5;84.3333333333333
22347;2023;17;17;0;100;0;205523.529411765;1701.11764705882;114.470588235294
22348;2023;5;5;0;100;0;148500;1600;94.6
22349;2023;24;24;0;100;0;267055.875;2799.58333333333;97.9583333333333
22350;2023;2;2;0;100;0;228000;2729;82.5
22351;2023;6;6;0;100;0;131811.666666667;1250;103.833333333333
22352;2023;5;5;0;100;0;100885.8;1117.4;88.4
22353;2023;38;30;8;78.9473684210526;21.0526315789474;291924.342105263;3726.28947368421;83.0263157894737
22354;2023;15;15;0;100;0;190800;1718.06666666667;115.866666666667
22356;2023;9;8;1;88.8888888888889;11.1111111111111;210872.222222222;1738.88888888889;118
22358;2023;10;10;0;100;0;174250;1897.3;100.3
22359;2023;6;6;0;100;0;216291.666666667;1956.66666666667;106.333333333333
22360;2023;106;92;14;86.7924528301887;13.2075471698113;205119.698113208;2353.61320754717;92.9150943396226
22361;2023;4;4;0;100;0;214578.75;2232;95.75
22362;2023;45;28;17;62.2222222222222;37.7777777777778;150592.222222222;1941.66666666667;78.4444444444444
22363;2023;22;21;1;95.4545454545455;4.54545454545455;402704.045454545;3458.59090909091;115.318181818182
22364;2023;37;34;3;91.8918918918919;8.10810810810811;213454.081081081;2379.78378378378;89.9189189189189
22365;2023;1;1;0;100;0;35000;1000;35
22366;2023;6;6;0;100;0;127100;1349.33333333333;87.3333333333333
22368;2023;8;8;0;100;0;306875;3541.25;87.375
22369;2023;10;9;1;90;10;211967.1;1990;104
22370;2023;8;8;0;100;0;156687.5;1659.625;96
22371;2023;18;18;0;100;0;128244.444444444;1543.88888888889;93.2222222222222
22372;2023;28;27;1;96.4285714285714;3.57142857142857;200939.285714286;2047.03571428571;97.1071428571429
22373;2023;2;2;0;100;0;38050;772;60.5
22375;2023;7;7;0;100;0;170157.142857143;2185.14285714286;80.7142857142857
22376;2023;13;13;0;100;0;152176.923076923;1218.92307692308;128.230769230769
22377;2023;14;14;0;100;0;336671.428571429;2889.21428571429;116.785714285714
22379;2023;30;25;5;83.3333333333333;16.6666666666667;231924.833333333;4126.76666666667;62.8333333333333
22380;2023;8;7;1;87.5;12.5;181162.5;2173.875;83.375
22381;2023;3;3;0;100;0;229916.666666667;1884.66666666667;119
22383;2023;2;2;0;100;0;76000;1210.5;58.5
22384;2023;15;14;1;93.3333333333333;6.66666666666667;128200;1109.13333333333;113.733333333333
22385;2023;16;16;0;100;0;257340.375;2716.875;96.6875
22386;2023;4;4;0;100;0;145537.5;1651.25;105.25
22387;2023;26;26;0;100;0;165794.192307692;1905.15384615385;89.9615384615385
22388;2023;10;10;0;100;0;154820;1861.4;84.8
22389;2023;58;49;9;84.4827586206897;15.5172413793103;207467.155172414;2211.6724137931;95.8103448275862
22390;2023;12;12;0;100;0;251087.5;2134.58333333333;111.916666666667
22391;2023;25;25;0;100;0;133589.2;1553.8;90.32
23001;2023;15;13;2;86.6666666666667;13.3333333333333;118027.6;1307.33333333333;89.8666666666667
23002;2023;11;11;0;100;0;101310.818181818;1018.45454545455;94.5454545454545
23003;2023;1;1;0;100;0;47500;565;84
23004;2023;7;7;0;100;0;90269.2857142857;806.714285714286;113
23006;2023;4;4;0;100;0;80675;1663;53.75
23007;2023;3;3;0;100;0;127000;1201.66666666667;116
23008;2023;50;36;14;72;28;89518.46;1111.58;83.42
23009;2023;3;3;0;100;0;39000;704.666666666667;54.6666666666667
23010;2023;4;4;0;100;0;196500;2429;74
23011;2023;2;2;0;100;0;89375;1165;62
23012;2023;2;2;0;100;0;136750;985;115
23013;2023;5;5;0;100;0;70390;803.8;91.4
23014;2023;1;1;0;100;0;35000;593;59
23015;2023;25;25;0;100;0;92396.4;888.52;99.36
23016;2023;2;2;0;100;0;168000;2650;62
23018;2023;1;1;0;100;0;78000;1560;50
23019;2023;3;3;0;100;0;144833.333333333;1069;150
23020;2023;3;3;0;100;0;68666.6666666667;724.666666666667;96
23021;2023;14;14;0;100;0;88905;988.357142857143;88.5714285714286
23022;2023;9;9;0;100;0;86388.8888888889;1227.11111111111;74.2222222222222
23023;2023;2;2;0;100;0;118500;1306;83
23024;2023;4;4;0;100;0;119062.5;1271.75;90.25
23025;2023;17;16;1;94.1176470588235;5.88235294117647;89058.8235294118;1125;82.4117647058823
23026;2023;10;10;0;100;0;80025;1304.4;62.3
23027;2023;4;4;0;100;0;84500;1199.25;69
23028;2023;1;1;0;100;0;70000;875;80
23029;2023;8;8;0;100;0;66937.5;855.75;77.875
23030;2023;32;27;5;84.375;15.625;93670.4375;1010.1875;99.15625
23031;2023;10;10;0;100;0;105800;1005.4;105.8
23032;2023;4;4;0;100;0;101975;1063;96.25
23033;2023;3;2;1;66.6666666666667;33.3333333333333;153333.333333333;1480.66666666667;100
23035;2023;6;6;0;100;0;77416.6666666667;845.333333333333;86
23036;2023;12;12;0;100;0;94134.5833333333;968.083333333333;93.0833333333333
23038;2023;12;12;0;100;0;79495.8333333333;946.833333333333;79.25
23039;2023;10;10;0;100;0;74600;800.8;95.2
23040;2023;3;3;0;100;0;63352;698.333333333333;95.6666666666667
23041;2023;10;10;0;100;0;89635;1004.9;95.3
23042;2023;3;3;0;100;0;92500;819.333333333333;109
23043;2023;4;4;0;100;0;45000;746.75;61.5
23044;2023;1;1;0;100;0;57225;1272;45
23045;2023;11;11;0;100;0;92818.1818181818;1125.09090909091;84.7272727272727
23046;2023;1;1;0;100;0;15000;429;35
23047;2023;6;6;0;100;0;93241.6666666667;1153;74.6666666666667
23048;2023;6;6;0;100;0;70778.3333333333;797.5;94.6666666666667
23049;2023;1;1;0;100;0;37420;1336;28
23050;2023;4;4;0;100;0;104250;1291.25;79.75
23051;2023;1;1;0;100;0;58000;829;70
23052;2023;9;9;0;100;0;95719.7777777778;894.444444444444;102
23053;2023;2;2;0;100;0;112663.5;1330;83.5
23054;2023;6;6;0;100;0;177576.666666667;1778.66666666667;102.833333333333
23056;2023;10;10;0;100;0;131583.9;1245.1;113.4
23057;2023;14;14;0;100;0;89878.5714285714;1019.28571428571;99.4285714285714
23058;2023;4;4;0;100;0;70885;821.75;86.25
23059;2023;1;1;0;100;0;50000;1190;42
23060;2023;6;6;0;100;0;93250.5;775.5;119.666666666667
23061;2023;8;8;0;100;0;81700;869.75;89.125
23062;2023;14;14;0;100;0;73517.0714285714;990.571428571429;76.4285714285714
23063;2023;1;1;0;100;0;62000;517;120
23064;2023;12;12;0;100;0;101333.333333333;1428.91666666667;79.8333333333333
23065;2023;6;6;0;100;0;78152.5;887;94
23066;2023;3;3;0;100;0;63500;711;93
23067;2023;4;4;0;100;0;47425;629.5;75.75
23068;2023;11;11;0;100;0;77322.2727272727;876.909090909091;94.5454545454545
23069;2023;3;3;0;100;0;89833.3333333333;688.333333333333;120
23070;2023;8;8;0;100;0;96035.125;1021.25;95.625
23071;2023;4;4;0;100;0;110250;1335.5;85
23072;2023;14;13;1;92.8571428571429;7.14285714285714;63257.1428571429;793.785714285714;82.6428571428571
23073;2023;4;4;0;100;0;114026;1262;101.5
23074;2023;2;2;0;100;0;44000;666.5;70
23075;2023;12;12;0;100;0;133429.166666667;1212.75;106.5
23076;2023;24;23;1;95.8333333333333;4.16666666666667;78957.0833333333;878.75;90.625
23077;2023;8;8;0;100;0;92342.5;1038.375;84.125
23078;2023;3;3;0;100;0;117833.333333333;1394;86.3333333333333
23079;2023;20;17;3;85;15;94313.75;1216.05;89.85
23081;2023;1;1;0;100;0;227450;3446;66
23082;2023;5;4;1;80;20;100436;1292.2;81.4
23083;2023;4;4;0;100;0;50642.25;601;86.75
23084;2023;3;3;0;100;0;36666.6666666667;793;44
23086;2023;5;5;0;100;0;115000;948;122.4
23087;2023;13;13;0;100;0;115525.307692308;1119.23076923077;98.8461538461538
23088;2023;2;2;0;100;0;54000;636;96.5
23089;2023;7;7;0;100;0;108668.857142857;1060.42857142857;99.8571428571429
23090;2023;6;6;0;100;0;112088.333333333;1193.16666666667;96.8333333333333
23091;2023;1;1;0;100;0;282453;1267;223
23092;2023;6;5;1;83.3333333333333;16.6666666666667;121916.666666667;1479;91
23093;2023;22;22;0;100;0;92193.1818181818;916.681818181818;106.181818181818
23095;2023;14;14;0;100;0;137089.285714286;1408.57142857143;93.8571428571429
23096;2023;166;106;60;63.855421686747;36.144578313253;99194.0722891566;1211.8734939759;84.7530120481928
23097;2023;6;6;0;100;0;71500;747.333333333333;103.5
23098;2023;1;1;0;100;0;48000;600;80
23099;2023;7;7;0;100;0;70571.4285714286;879.428571428571;80.8571428571429
23100;2023;6;3;3;50;50;52250;667.166666666667;77.3333333333333
23101;2023;8;8;0;100;0;120987.5;996.375;117.25
23102;2023;3;3;0;100;0;96000;965.666666666667;91
23103;2023;10;10;0;100;0;97458;1091;88.4
23104;2023;4;4;0;100;0;110750;1246.5;86
23105;2023;9;9;0;100;0;68068.8888888889;712.333333333333;97.1111111111111
23106;2023;3;3;0;100;0;88333.3333333333;921.333333333333;94.3333333333333
23107;2023;3;3;0;100;0;109263.333333333;1442;76.3333333333333
23108;2023;2;2;0;100;0;473742;4823.5;101
23109;2023;5;5;0;100;0;71062;1240.2;58.2
23111;2023;2;2;0;100;0;117150;1146;104.5
23112;2023;6;6;0;100;0;102520.666666667;1449.5;71.8333333333333
23113;2023;6;6;0;100;0;83616.6666666667;720.166666666667;115.166666666667
23114;2023;7;7;0;100;0;198013.714285714;2405;74.5714285714286
23115;2023;4;4;0;100;0;96972.5;862.5;106
23116;2023;8;8;0;100;0;91674.25;1110.125;80.25
23117;2023;2;2;0;100;0;54950;817.5;67.5
23118;2023;1;1;0;100;0;40000;769;52
23119;2023;2;2;0;100;0;114000;1231;93
23120;2023;1;1;0;100;0;86000;544;158
23123;2023;2;2;0;100;0;85340;668.5;131
23124;2023;8;8;0;100;0;102501.25;997.25;108.875
23127;2023;4;4;0;100;0;135975;1287.25;106.75
23129;2023;1;1;0;100;0;90000;750;120
23130;2023;8;8;0;100;0;92010.875;1092.625;85.125
23131;2023;6;5;1;83.3333333333333;16.6666666666667;107008.333333333;1571.83333333333;85.5
23132;2023;6;6;0;100;0;86666.6666666667;1011.33333333333;95.8333333333333
23133;2023;4;4;0;100;0;81055.75;898.25;85.5
23134;2023;1;1;0;100;0;112500;1223;92
23136;2023;4;4;0;100;0;96467.25;893;112
23137;2023;6;6;0;100;0;137809.166666667;1327;107.5
23138;2023;3;2;1;66.6666666666667;33.3333333333333;57683.3333333333;1025;61.3333333333333
23139;2023;14;14;0;100;0;103960.071428571;1376.14285714286;76.7857142857143
23140;2023;6;6;0;100;0;85475.3333333333;997.5;87.5
23141;2023;9;9;0;100;0;116422.222222222;964.777777777778;112.555555555556
23142;2023;2;2;0;100;0;85250;739;163.5
23143;2023;3;3;0;100;0;74166.6666666667;1075.33333333333;65.6666666666667
23144;2023;5;5;0;100;0;76736;780.2;96.4
23145;2023;2;2;0;100;0;86250;1163.5;72
23146;2023;10;10;0;100;0;99750;1445;76.8
23147;2023;2;2;0;100;0;58500;897.5;66.5
23148;2023;5;5;0;100;0;63400;832.2;79.2
23149;2023;15;15;0;100;0;96724.1333333333;978.066666666667;98.8
23151;2023;8;8;0;100;0;111712.5;945.25;114.125
23152;2023;1;1;0;100;0;64000;719;89
23154;2023;11;11;0;100;0;84263.6363636364;975;87.5454545454545
23155;2023;5;5;0;100;0;93100;838.6;119.8
23156;2023;2;2;0;100;0;55974.5;632.5;82.5
23158;2023;2;2;0;100;0;87500;1007.5;87
23159;2023;4;4;0;100;0;53316.25;681.25;82.75
23160;2023;3;3;0;100;0;89685;974;97.3333333333333
23162;2023;3;3;0;100;0;73333.3333333333;665.666666666667;108.666666666667
23164;2023;8;8;0;100;0;52317.5;749.75;73.625
23165;2023;17;16;1;94.1176470588235;5.88235294117647;123445.294117647;1079.70588235294;117.352941176471
23166;2023;1;1;0;100;0;53400;568;94
23167;2023;5;5;0;100;0;67000;690.8;98.2
23168;2023;7;7;0;100;0;135171.428571429;1231.14285714286;104.571428571429
23169;2023;4;4;0;100;0;92937.5;996.25;91.5
23170;2023;4;4;0;100;0;147153.25;1385.5;104.75
23171;2023;4;4;0;100;0;59735;749.75;71.25
23172;2023;3;3;0;100;0;106670;1075;108
23173;2023;3;3;0;100;0;47500;826.333333333333;59.3333333333333
23174;2023;7;7;0;100;0;77377.1428571429;811.428571428571;94.1428571428571
23175;2023;1;1;0;100;0;70600;552;128
23176;2023;62;57;5;91.9354838709677;8.06451612903226;118403.387096774;1269.43548387097;93.758064516129
23177;2023;11;11;0;100;0;123127.272727273;1164;104.181818181818
23178;2023;4;4;0;100;0;102137.5;1005;99.75
23179;2023;3;3;0;100;0;78166.6666666667;810;98.6666666666667
23180;2023;5;5;0;100;0;101600;1139.6;90.4
23181;2023;4;4;0;100;0;83973.75;861.5;100.25
23182;2023;1;1;0;100;0;444870;1483;300
23183;2023;1;1;0;100;0;60000;800;75
23185;2023;8;8;0;100;0;115962.5;1100.25;126.75
23186;2023;1;1;0;100;0;95000;905;105
23187;2023;4;4;0;100;0;61443.75;757;77
23188;2023;2;2;0;100;0;111800;1030.5;123.5
23189;2023;20;19;1;95;5;113664.5;1023.2;111.6
23190;2023;2;2;0;100;0;113238.5;1551.5;72
23191;2023;2;2;0;100;0;36500;846;45.5
23192;2023;17;17;0;100;0;126835.764705882;1087.23529411765;118.352941176471
23193;2023;32;32;0;100;0;122145.03125;1303.90625;93.34375
23194;2023;3;3;0;100;0;70500;965;78
23195;2023;9;9;0;100;0;99611.1111111111;1188.66666666667;94.1111111111111
23196;2023;3;3;0;100;0;103559.333333333;1097.66666666667;93.3333333333333
23197;2023;12;12;0;100;0;94867.5;998.5;93.3333333333333
23198;2023;3;3;0;100;0;146583.333333333;1459.66666666667;94
23199;2023;7;7;0;100;0;82721.7142857143;782.285714285714;98
23200;2023;2;2;0;100;0;111071;1012.5;105
23201;2023;2;2;0;100;0;172500;1090.5;144.5
23202;2023;4;4;0;100;0;119773.5;971.25;95
23203;2023;3;3;0;100;0;55000;797.666666666667;72.6666666666667
23204;2023;3;3;0;100;0;88666.6666666667;1031.33333333333;83
23205;2023;1;1;0;100;0;15000;500;30
23206;2023;3;3;0;100;0;140417;1197.33333333333;116.333333333333
23207;2023;3;3;0;100;0;81433.3333333333;1125.33333333333;76.3333333333333
23208;2023;6;6;0;100;0;64655.5;767.333333333333;84
23209;2023;7;7;0;100;0;92785.7142857143;834.142857142857;111.428571428571
23210;2023;3;3;0;100;0;112000;1029;118.333333333333
23211;2023;4;4;0;100;0;87112.5;1135.25;74.25
23212;2023;2;2;0;100;0;101050;1479.5;70
23213;2023;3;3;0;100;0;49666.6666666667;633;96
23214;2023;5;5;0;100;0;74180;982;77.6
23215;2023;2;2;0;100;0;126970;2017;63
23216;2023;2;2;0;100;0;39000;1300;30
23217;2023;6;6;0;100;0;81560.1666666667;828;89.6666666666667
23218;2023;4;4;0;100;0;84892.5;874.75;104.5
23219;2023;16;16;0;100;0;130343.75;1121.4375;100.9375
23220;2023;9;9;0;100;0;98777.7777777778;906.333333333333;112.111111111111
23221;2023;4;4;0;100;0;142286.25;1227.75;101
23222;2023;1;1;0;100;0;52860;637;83
23223;2023;6;6;0;100;0;55000;862.166666666667;61.6666666666667
23224;2023;4;4;0;100;0;87500;1270;74
23225;2023;1;1;0;100;0;25000;543;46
23227;2023;2;2;0;100;0;50700;713.5;70.5
23228;2023;1;1;0;100;0;35280;452;78
23229;2023;5;5;0;100;0;51400;742.8;74
23230;2023;2;2;0;100;0;72500;990;103.5
23232;2023;9;9;0;100;0;98211.1111111111;926.333333333333;104.111111111111
23233;2023;2;2;0;100;0;59000;1120.5;69
23234;2023;1;1;0;100;0;76000;905;84
23235;2023;9;9;0;100;0;98670;1103.77777777778;91.4444444444444
23236;2023;4;4;0;100;0;52410.75;724.25;63.5
23237;2023;1;1;0;100;0;120000;896;134
23238;2023;3;3;0;100;0;120766.666666667;801.333333333333;118.666666666667
23239;2023;14;14;0;100;0;88571.7857142857;983;91.7857142857143
23240;2023;6;6;0;100;0;68750;1032.66666666667;63.3333333333333
23241;2023;4;4;0;100;0;102225;1294;94.75
23242;2023;3;3;0;100;0;76000;765;102.333333333333
23243;2023;4;4;0;100;0;92415;1017;100
23244;2023;12;12;0;100;0;86781.75;945.666666666667;93.3333333333333
23245;2023;17;17;0;100;0;119127.647058824;1223.11764705882;94.7647058823529
23246;2023;2;2;0;100;0;148550;2419.5;61
23247;2023;30;30;0;100;0;95327.6666666667;1096.43333333333;87.7333333333333
23248;2023;7;7;0;100;0;141500;1633.14285714286;98.4285714285714
23249;2023;4;4;0;100;0;49325;638;75.25
23250;2023;5;5;0;100;0;102980;1184.8;82.6
23251;2023;1;1;0;100;0;1,00E+05;1333;75
23252;2023;4;4;0;100;0;90000;1031.75;83.75
23253;2023;5;5;0;100;0;322918;1759.8;138.4
23254;2023;8;8;0;100;0;91500;796.125;103.5
23255;2023;2;2;0;100;0;69100;674;103.5
23257;2023;13;13;0;100;0;107367.153846154;1047.53846153846;103
23258;2023;10;10;0;100;0;109277;1072.3;94.4
23260;2023;4;4;0;100;0;82780.5;645.25;131.25
23261;2023;2;2;0;100;0;49750;586;90.5
23263;2023;4;4;0;100;0;118066.5;1211;111
23266;2023;1;1;0;100;0;53000;736;72
24001;2023;11;11;0;100;0;123197;1299.09090909091;88.3636363636364
24002;2023;15;15;0;100;0;155864.533333333;1508.6;100.733333333333
24004;2023;4;4;0;100;0;185925;1366;116
24005;2023;4;4;0;100;0;209250;2005.75;97
24006;2023;3;3;0;100;0;160000;1840.66666666667;80
24007;2023;6;6;0;100;0;179150;1560.5;115.166666666667
24008;2023;3;3;0;100;0;77666.6666666667;989.666666666667;78
24009;2023;8;8;0;100;0;98190;1140;76.75
24010;2023;14;14;0;100;0;180859.714285714;1758.64285714286;106.714285714286
24011;2023;7;7;0;100;0;186357.142857143;1760.28571428571;107.428571428571
24012;2023;7;7;0;100;0;297030;3206.42857142857;108
24014;2023;5;5;0;100;0;174842;1832.4;97.4
24015;2023;1;1;0;100;0;195305;1177;166
24016;2023;9;9;0;100;0;132028.333333333;1526.33333333333;99.6666666666667
24018;2023;7;7;0;100;0;186237.857142857;1936.42857142857;99.5714285714286
24019;2023;5;5;0;100;0;144600;2172.8;70.4
24020;2023;13;13;0;100;0;213336.461538462;2094.61538461538;96.6153846153846
24021;2023;8;8;0;100;0;134371.875;1816.125;81
24022;2023;4;4;0;100;0;283750;1969;142
24023;2023;6;6;0;100;0;215941.666666667;1657.83333333333;117
24024;2023;1;1;0;100;0;480000;3429;140
24025;2023;9;9;0;100;0;182384.444444444;1775.44444444444;96.1111111111111
24026;2023;40;40;0;100;0;194009.425;1888.4;103.5
24027;2023;2;2;0;100;0;166500;1793;96.5
24028;2023;38;38;0;100;0;218401.394736842;2181.02631578947;104.578947368421
24029;2023;5;5;0;100;0;170154;2807.2;80.6
24030;2023;6;6;0;100;0;128105;1392;95.8333333333333
24031;2023;3;3;0;100;0;181333.333333333;2077.66666666667;83.6666666666667
24032;2023;6;6;0;100;0;112583.333333333;1081.5;105.5
24035;2023;21;21;0;100;0;198460.047619048;1826.80952380952;113.047619047619
24037;2023;522;350;172;67.0498084291188;32.9501915708812;154114.545977011;1862.58045977011;82.7394636015326
24038;2023;2;2;0;100;0;85400;800;102.5
24040;2023;5;5;0;100;0;255600;2448.8;100
24042;2023;6;6;0;100;0;197666.666666667;1769.16666666667;117
24043;2023;2;2;0;100;0;584466;8259;69
24045;2023;3;3;0;100;0;174916.666666667;1425;125
24046;2023;5;5;0;100;0;130300;1333.8;110
24048;2023;4;4;0;100;0;158500;1444.25;115.75
24050;2023;7;7;0;100;0;190627;1752;106.714285714286
24051;2023;1;1;0;100;0;27000;540;50
24052;2023;4;4;0;100;0;181875;1455;127.5
24053;2023;104;83;21;79.8076923076923;20.1923076923077;192383.442307692;1953.22115384615;98.1057692307692
24054;2023;4;4;0;100;0;172930;1809.75;93.75
24055;2023;12;12;0;100;0;183035.75;1790.25;101.333333333333
24056;2023;1;1;0;100;0;141500;990;143
24057;2023;1;1;0;100;0;58000;1568;37
24058;2023;2;2;0;100;0;129584;1361.5;86
24059;2023;5;5;0;100;0;176510;1861.8;95.4
24060;2023;1;1;0;100;0;262500;2169;121
24062;2023;3;3;0;100;0;247703.333333333;1363;190.666666666667
24063;2023;3;3;0;100;0;223666.666666667;1868.33333333333;105
24064;2023;43;41;2;95.3488372093023;4.65116279069767;148864.255813953;1599.86046511628;99
24066;2023;4;4;0;100;0;237390;2069;122.5
24067;2023;55;53;2;96.3636363636364;3.63636363636364;188002.545454545;1899.14545454545;91.4545454545455
24068;2023;29;29;0;100;0;187540;1834.13793103448;102.965517241379
24069;2023;4;4;0;100;0;86250;1109.75;74.25
24070;2023;14;14;0;100;0;146865;1153.21428571429;116.785714285714
24071;2023;7;7;0;100;0;174907.571428571;1845.14285714286;111.428571428571
24073;2023;8;8;0;100;0;163937.5;1636.625;98.625
24074;2023;5;5;0;100;0;181980;1596;110
24075;2023;3;3;0;100;0;203333.333333333;1521.66666666667;131
24076;2023;4;4;0;100;0;139875;1956.25;82
24077;2023;4;4;0;100;0;232169;1984.5;117
24080;2023;4;4;0;100;0;176050;1718.25;105.75
24081;2023;9;8;1;88.8888888888889;11.1111111111111;186693.222222222;2118;93.3333333333333
24082;2023;23;23;0;100;0;224462.826086957;2195.82608695652;109.086956521739
24083;2023;4;4;0;100;0;197325;1753.5;111.75
24084;2023;2;2;0;100;0;150000;2257;68
24085;2023;4;4;0;100;0;83125;1851;57.25
24086;2023;8;8;0;100;0;332806.875;2518.875;139
24087;2023;9;9;0;100;0;207666.666666667;2304.33333333333;88.6666666666667
24088;2023;3;3;0;100;0;238000;2217;108
24090;2023;3;3;0;100;0;214506.666666667;1726.66666666667;121.666666666667
24091;2023;20;19;1;95;5;248108.75;2113.15;124
24094;2023;5;5;0;100;0;201150;1807.6;109.2
24095;2023;6;6;0;100;0;70377;919;78
24096;2023;6;6;0;100;0;127325;1259.5;104.5
24097;2023;8;7;1;87.5;12.5;235206.25;1374.75;171.25
24098;2023;52;38;14;73.0769230769231;26.9230769230769;189588.5;2149.69230769231;86.1730769230769
24100;2023;7;7;0;100;0;191132;1626.14285714286;113.571428571429
24101;2023;6;6;0;100;0;187856.666666667;1045.16666666667;134.166666666667
24102;2023;48;43;5;89.5833333333333;10.4166666666667;169648.916666667;1815.10416666667;93.8958333333333
24104;2023;12;10;2;83.3333333333333;16.6666666666667;131449.666666667;1213.66666666667;108.833333333333
24105;2023;1;1;0;100;0;185000;2256;82
24106;2023;4;4;0;100;0;225150;2035.5;108
24107;2023;6;6;0;100;0;144133.333333333;1886.66666666667;74.8333333333333
24108;2023;9;9;0;100;0;179832.222222222;1909.44444444444;95.8888888888889
24109;2023;1;1;0;100;0;35000;761;46
24113;2023;3;3;0;100;0;241748.333333333;1893.66666666667;124
24114;2023;2;2;0;100;0;258907;1853;140
24115;2023;15;15;0;100;0;154293.333333333;1471.53333333333;103.666666666667
24116;2023;1;1;0;100;0;190000;1180;161
24117;2023;4;4;0;100;0;200047;1842;110.25
24119;2023;4;4;0;100;0;179859.25;1612.5;117.25
24120;2023;7;7;0;100;0;165435.714285714;1991.85714285714;84.4285714285714
24122;2023;1;1;0;100;0;285000;2850;100
24123;2023;1;1;0;100;0;187700;1514;124
24124;2023;6;6;0;100;0;186166.666666667;2214.5;113.666666666667
24126;2023;3;3;0;100;0;219583.333333333;2408.33333333333;98.3333333333333
24128;2023;3;3;0;100;0;93201.3333333333;1260.66666666667;76.3333333333333
24129;2023;9;9;0;100;0;90111.1111111111;1009.11111111111;85.3333333333333
24130;2023;6;6;0;100;0;175038.333333333;2594.83333333333;78.8333333333333
24131;2023;2;2;0;100;0;132000;2350.5;58.5
24132;2023;4;4;0;100;0;183000;1330.25;131
24133;2023;29;29;0;100;0;94383.3103448276;1255.79310344828;75.6896551724138
24134;2023;10;10;0;100;0;87120.8;1126.2;77
24135;2023;4;4;0;100;0;173687.5;1550.25;112
24136;2023;2;2;0;100;0;152125;956.5;134.5
24137;2023;9;9;0;100;0;171050.444444444;1434;122.777777777778
24138;2023;119;100;19;84.0336134453782;15.9663865546218;156840.56302521;1772.52100840336;88.546218487395
24139;2023;16;16;0;100;0;237420;2176.5625;108.125
24140;2023;20;20;0;100;0;266650.5;2315.5;110.8
24141;2023;6;6;0;100;0;246547.666666667;1665.66666666667;138.166666666667
24142;2023;16;16;0;100;0;229209.5625;2057.4375;118.625
24143;2023;16;16;0;100;0;153596.875;1716.5;84.875
24144;2023;1;1;0;100;0;138000;1302;106
24145;2023;24;24;0;100;0;156392.166666667;1733;92.125
24146;2023;1;1;0;100;0;220000;2000;110
24147;2023;18;18;0;100;0;158301.555555556;1467.88888888889;118.777777777778
24148;2023;3;3;0;100;0;220666.666666667;1921.33333333333;113.333333333333
24150;2023;6;6;0;100;0;238171.833333333;2105;109.833333333333
24151;2023;1;1;0;100;0;170000;1889;90
24152;2023;16;14;2;87.5;12.5;234522;2365.4375;99.9375
24153;2023;2;2;0;100;0;145000;1460;100
24154;2023;5;5;0;100;0;159200;1490.2;104.8
24155;2023;8;8;0;100;0;131437.5;1659.75;83.5
24156;2023;13;13;0;100;0;217880.846153846;2330.07692307692;101
24157;2023;11;11;0;100;0;116726.818181818;1232.63636363636;101.454545454545
24158;2023;4;4;0;100;0;169535;1028.5;139
24159;2023;7;7;0;100;0;108071.428571429;1340.57142857143;84.4285714285714
24160;2023;5;5;0;100;0;176600;1768.6;97
24161;2023;1;1;0;100;0;205000;820;250
24163;2023;3;3;0;100;0;45666.6666666667;720.666666666667;67.6666666666667
24164;2023;20;20;0;100;0;164837.5;1288.7;122.45
24165;2023;9;9;0;100;0;128398.666666667;1477.33333333333;90.4444444444444
24167;2023;67;63;4;94.0298507462687;5.97014925373134;185699.28358209;1801.79104477612;100.731343283582
24168;2023;8;8;0;100;0;215290.125;1580.125;132.875
24171;2023;4;4;0;100;0;75509;1157.75;66.5
24172;2023;33;30;3;90.9090909090909;9.09090909090909;147110.909090909;1709.0303030303;83.4545454545455
24175;2023;3;3;0;100;0;54558.3333333333;890;60
24177;2023;6;6;0;100;0;246223.333333333;2071.5;122.5
24179;2023;7;7;0;100;0;203371.428571429;1987.57142857143;106.285714285714
24180;2023;4;4;0;100;0;116550;1109.25;94.75
24182;2023;19;19;0;100;0;118744.315789474;1248.73684210526;94.2105263157895
24183;2023;6;6;0;100;0;238248.5;4887.66666666667;56.6666666666667
24184;2023;5;5;0;100;0;195520.2;1595;119
24186;2023;3;3;0;100;0;211166.666666667;1464.33333333333;146.666666666667
24188;2023;9;9;0;100;0;143000;1492.55555555556;117.222222222222
24189;2023;4;4;0;100;0;342106.25;1906;155.5
24190;2023;1;1;0;100;0;226500;2178;104
24191;2023;3;3;0;100;0;188166.666666667;1620;113.666666666667
24192;2023;1;1;0;100;0;346000;3681;94
24193;2023;9;9;0;100;0;463703.777777778;2753.44444444444;204.555555555556
24194;2023;15;15;0;100;0;159773.333333333;1641.46666666667;102.533333333333
24195;2023;1;1;0;100;0;62000;785;79
24196;2023;10;10;0;100;0;142895;1488.3;106.2
24197;2023;11;11;0;100;0;251870.454545455;2090.45454545455;122.272727272727
24199;2023;5;5;0;100;0;165929.2;1316.4;120.4
24200;2023;6;6;0;100;0;133066.666666667;1626.16666666667;86
24202;2023;2;2;0;100;0;62100;838;94
24205;2023;5;5;0;100;0;201130;2019.2;118.8
24207;2023;11;11;0;100;0;151870;1858;81.7272727272727
24208;2023;3;3;0;100;0;150800;1583.66666666667;95
24209;2023;1;1;0;100;0;205000;1881;109
24210;2023;14;14;0;100;0;113442.857142857;1238.07142857143;93.8571428571429
24211;2023;4;4;0;100;0;203000;1590.25;116.5
24212;2023;15;14;1;93.3333333333333;6.66666666666667;251381;2681.06666666667;99.3333333333333
24213;2023;1;1;0;100;0;215000;1581;136
24214;2023;4;4;0;100;0;171500;1437.25;118.75
24216;2023;2;2;0;100;0;317640;1847;150
24217;2023;1;1;0;100;0;140000;2222;63
24218;2023;24;24;0;100;0;153133.416666667;1711.83333333333;95.9583333333333
24220;2023;5;5;0;100;0;172780;1999.8;89.8
24221;2023;2;2;0;100;0;121000;1633;65.5
24222;2023;28;27;1;96.4285714285714;3.57142857142857;186419.571428571;1840.92857142857;101.857142857143
24223;2023;48;48;0;100;0;190054.375;1823.08333333333;100.4375
24224;2023;5;5;0;100;0;236554;2048.6;113
24225;2023;27;27;0;100;0;202192;1815.25925925926;112
24226;2023;15;15;0;100;0;145814.8;2094.66666666667;69.1333333333333
24227;2023;12;11;1;91.6666666666667;8.33333333333333;139411.583333333;1885.16666666667;86.4166666666667
24228;2023;9;9;0;100;0;165623.666666667;1706.11111111111;106.444444444444
24229;2023;23;23;0;100;0;135398.956521739;1425.95652173913;106.652173913043
24230;2023;2;2;0;100;0;106000;953;110.5
24231;2023;1;1;0;100;0;335000;3160;106
24234;2023;3;3;0;100;0;126866.666666667;1373.33333333333;89.6666666666667
24236;2023;5;5;0;100;0;221960;1426.4;171
24237;2023;20;20;0;100;0;254573.75;2073.3;127.35
24238;2023;2;2;0;100;0;227000;2418;113.5
24240;2023;6;6;0;100;0;240666.666666667;2749.16666666667;90.6666666666667
24241;2023;6;6;0;100;0;150983.333333333;1393.5;108.333333333333
24242;2023;3;3;0;100;0;197733.333333333;1639.33333333333;115.333333333333
24243;2023;13;13;0;100;0;151154.615384615;1759.38461538462;88.2307692307692
24245;2023;3;3;0;100;0;193083.333333333;2386.33333333333;98.6666666666667
24246;2023;6;6;0;100;0;211076.833333333;1700.83333333333;129
24247;2023;3;2;1;66.6666666666667;33.3333333333333;127566.333333333;1016.66666666667;132
24248;2023;2;2;0;100;0;155000;1742;87
24251;2023;6;6;0;100;0;211166.666666667;1815.83333333333;115.666666666667
24252;2023;6;6;0;100;0;206098.666666667;2054.33333333333;97.6666666666667
24253;2023;38;38;0;100;0;182211.815789474;1590.36842105263;117.210526315789
24254;2023;2;2;0;100;0;157000;2577;63.5
24255;2023;7;7;0;100;0;284393.571428571;3196.71428571429;92.8571428571429
24256;2023;54;40;14;74.0740740740741;25.9259259259259;173244.166666667;1944.22222222222;88.3148148148148
24257;2023;2;2;0;100;0;243454;1973;125
24259;2023;21;21;0;100;0;182112.142857143;1782.7619047619;110.333333333333
24260;2023;6;6;0;100;0;330508.333333333;2282.66666666667;150.666666666667
24261;2023;6;6;0;100;0;303500;2132.33333333333;144
24262;2023;6;6;0;100;0;109151;1547.83333333333;68.6666666666667
24263;2023;6;6;0;100;0;120777.833333333;1067.16666666667;106.333333333333
24264;2023;16;16;0;100;0;200736.5625;1810.625;113.6875
24266;2023;15;15;0;100;0;206413.866666667;1883.73333333333;112.066666666667
24267;2023;2;2;0;100;0;231133.5;2155;107.5
24268;2023;13;13;0;100;0;348748.461538462;2984.07692307692;132.923076923077
24269;2023;14;14;0;100;0;133694.428571429;1512.07142857143;93.2142857142857
24271;2023;7;7;0;100;0;198462.857142857;1605.85714285714;117.857142857143
24272;2023;6;6;0;100;0;261869.166666667;2176.83333333333;130.666666666667
24273;2023;7;7;0;100;0;337285.714285714;2702.28571428571;114
24274;2023;10;10;0;100;0;324401.3;2123.4;153.9
24276;2023;6;6;0;100;0;263720.833333333;2496.66666666667;120.166666666667
24277;2023;3;3;0;100;0;169000;1640.33333333333;116
24278;2023;4;4;0;100;0;219000;1510.75;133.5
24279;2023;1;1;0;100;0;367000;2566;143
24280;2023;10;10;0;100;0;165779;1823.7;93.2
24281;2023;1;1;0;100;0;2,00E+05;3279;61
24282;2023;2;2;0;100;0;167500;986.5;177
24284;2023;1;1;0;100;0;140000;1217;115
24285;2023;3;3;0;100;0;297469.666666667;2009.33333333333;157.666666666667
24286;2023;9;9;0;100;0;203076.777777778;1596.33333333333;145.888888888889
24287;2023;2;2;0;100;0;515775;6711.5;102.5
24288;2023;3;3;0;100;0;508000;3132;170
24289;2023;16;16;0;100;0;176696.9375;1693.5625;112.0625
24290;2023;2;2;0;100;0;370952;3192.5;120
24291;2023;58;52;6;89.6551724137931;10.3448275862069;143373.775862069;1793.81034482759;80.7931034482759
24292;2023;7;7;0;100;0;221635.714285714;2129.85714285714;102.571428571429
24293;2023;2;2;0;100;0;184625;1472;116.5
24294;2023;99;97;2;97.979797979798;2.02020202020202;164200.373737374;1693.25252525253;98.4545454545455
24295;2023;11;11;0;100;0;156580.909090909;1511.18181818182;106.727272727273
24296;2023;17;17;0;100;0;151717.647058824;1505.47058823529;102.823529411765
24297;2023;13;11;2;84.6153846153846;15.3846153846154;141537.307692308;1504.84615384615;92.1538461538462
24299;2023;51;44;7;86.2745098039216;13.7254901960784;117853.62745098;1341.25490196078;90.6666666666667
24300;2023;6;6;0;100;0;345988.833333333;4128.83333333333;110.666666666667
24301;2023;6;6;0;100;0;193445;1654.66666666667;102.666666666667
24302;2023;8;8;0;100;0;232186.25;2092;117.75
24303;2023;4;4;0;100;0;181629.25;1396.5;121.75
24304;2023;19;19;0;100;0;115209.578947368;1163.15789473684;100.210526315789
24307;2023;1;1;0;100;0;407800;3516;116
24308;2023;4;4;0;100;0;74250;926.25;94.5
24309;2023;34;34;0;100;0;134458.5;1474.5;92.1176470588235
24311;2023;47;46;1;97.8723404255319;2.12765957446809;122615.936170213;1195.91489361702;91.6808510638298
24312;2023;51;43;8;84.3137254901961;15.6862745098039;209892.784313725;2073.17647058824;98.7058823529412
24313;2023;2;2;0;100;0;155250;1613.5;97
24316;2023;17;17;0;100;0;131952.941176471;1481;95.8235294117647
24317;2023;1;1;0;100;0;92000;920;100
24318;2023;4;4;0;100;0;279327.25;2376.5;118.5
24319;2023;4;3;1;75;25;98750;899.75;109.5
24320;2023;15;15;0;100;0;109781.8;1516.13333333333;76.4
24321;2023;7;6;1;85.7142857142857;14.2857142857143;114953.571428571;1617.28571428571;70.8571428571429
24322;2023;559;216;343;38.6404293381038;61.3595706618962;147369.559928444;1995.1717352415;74.2254025044723
24323;2023;5;5;0;100;0;141561.2;1278.4;108.6
24324;2023;7;7;0;100;0;145435.142857143;1727;87.1428571428571
24325;2023;8;8;0;100;0;194750.625;1760.375;113.375
24326;2023;2;2;0;100;0;157500;1352.5;110
24327;2023;5;5;0;100;0;183602;1743;114.8
24328;2023;23;20;3;86.9565217391304;13.0434782608696;98656.2173913044;1165.65217391304;82.6086956521739
24329;2023;11;10;1;90.9090909090909;9.09090909090909;141667.272727273;1361.81818181818;98.6363636363636
24330;2023;7;7;0;100;0;196648.571428571;2287.14285714286;85.2857142857143
24331;2023;5;5;0;100;0;134350;1406.2;96.4
24334;2023;2;2;0;100;0;155720;1313.5;118.5
24335;2023;33;20;13;60.6060606060606;39.3939393939394;119856.818181818;1305;88.0606060606061
24336;2023;3;3;0;100;0;270600;1308.33333333333;193.333333333333
24338;2023;6;6;0;100;0;190416.666666667;1730.16666666667;114.666666666667
24339;2023;5;5;0;100;0;179841.2;2208;85.2
24340;2023;45;45;0;100;0;218807.555555556;1990.48888888889;113.155555555556
24341;2023;7;7;0;100;0;236428.571428571;2300.28571428571;112.857142857143
24345;2023;7;7;0;100;0;265820;1923.85714285714;147.428571428571
24347;2023;2;2;0;100;0;90250;997.5;103
24348;2023;6;6;0;100;0;267900;1694.66666666667;178
24349;2023;2;2;0;100;0;186625;2044;107
24350;2023;22;22;0;100;0;183194.545454545;1976.27272727273;97.3636363636364
24351;2023;6;6;0;100;0;136111.666666667;1423.5;94.8333333333333
24352;2023;46;46;0;100;0;156920.739130435;1670.52173913043;95.6304347826087
24353;2023;8;8;0;100;0;125196.875;1128.125;115.125
24354;2023;31;31;0;100;0;126630.580645161;1405.41935483871;90.0645161290323
24355;2023;5;5;0;100;0;297000;2876.6;106.2
24356;2023;24;24;0;100;0;166579.5;1734.125;100.791666666667
24357;2023;2;2;0;100;0;247000;2229;106
24360;2023;4;4;0;100;0;146875;1658;90.25
24361;2023;5;5;0;100;0;204500;1953.2;104
24362;2023;22;21;1;95.4545454545455;4.54545454545455;210658.045454545;1937.54545454545;121.681818181818
24364;2023;2;2;0;100;0;64900;1245.5;51
24365;2023;2;2;0;100;0;349400;2097.5;167
24366;2023;8;8;0;100;0;293162.5;3282.25;100.75
24367;2023;4;4;0;100;0;190000;2652;77.25
24370;2023;25;25;0;100;0;187384.16;2028.76;112.68
24371;2023;3;3;0;100;0;132175;1384.33333333333;87.3333333333333
24372;2023;76;62;14;81.5789473684211;18.4210526315789;143186.065789474;1596.30263157895;89.75
24373;2023;6;6;0;100;0;235585;2204.33333333333;110.333333333333
24374;2023;10;10;0;100;0;152976.5;1389.6;111
24375;2023;4;4;0;100;0;147250;1590.25;96
24376;2023;19;18;1;94.7368421052632;5.26315789473684;136693.421052632;1329.21052631579;96
24377;2023;3;3;0;100;0;218833.333333333;2246.33333333333;97.3333333333333
24378;2023;1;1;0;100;0;186840;1730;108
24379;2023;6;6;0;100;0;241179.166666667;2489.83333333333;90.5
24380;2023;9;9;0;100;0;141068.888888889;1420.44444444444;94.5555555555556
24381;2023;5;5;0;100;0;173000;1495.8;118.4
24382;2023;13;12;1;92.3076923076923;7.69230769230769;142611.538461538;1537.30769230769;102.923076923077
24383;2023;1;1;0;100;0;335000;1603;209
24385;2023;5;5;0;100;0;341800;2643.8;122.4
24386;2023;1;1;0;100;0;70000;1556;45
24388;2023;5;5;0;100;0;222800;2012.8;106.6
24390;2023;2;2;0;100;0;266320;2157.5;119
24392;2023;6;6;0;100;0;212116.666666667;1825.83333333333;113
24394;2023;2;2;0;100;0;99500;788;113.5
24395;2023;6;6;0;100;0;196750;2532.83333333333;88.3333333333333
24396;2023;34;32;2;94.1176470588235;5.88235294117647;217792.264705882;2099.38235294118;96.3529411764706
24397;2023;1;1;0;100;0;122500;2988;41
24398;2023;8;8;0;100;0;198366.5;2003.125;105.875
24399;2023;1;1;0;100;0;110500;837;132
24401;2023;6;6;0;100;0;149124.833333333;1869.16666666667;75.5
24403;2023;1;1;0;100;0;170000;1717;99
24404;2023;2;2;0;100;0;180000;1480.5;121
24405;2023;4;4;0;100;0;156360;1683.5;100.75
24406;2023;1;1;0;100;0;115000;1643;70
24407;2023;5;5;0;100;0;122001.2;1057;105.6
24408;2023;3;3;0;100;0;80333.3333333333;1102.33333333333;72.3333333333333
24409;2023;18;18;0;100;0;132535.555555556;1400;94.3333333333333
24410;2023;11;11;0;100;0;111184.454545455;1227.27272727273;91.3636363636364
24411;2023;1;1;0;100;0;55000;1774;31
24412;2023;15;11;4;73.3333333333333;26.6666666666667;210315.666666667;1954.2;104.8
24413;2023;2;2;0;100;0;210428.5;1539.5;134.5
24414;2023;4;4;0;100;0;160002.25;1563;93.25
24415;2023;2;2;0;100;0;249215;1768.5;134.5
24416;2023;4;4;0;100;0;184455;1862.25;118.25
24417;2023;7;7;0;100;0;161824.857142857;1699.42857142857;110.285714285714
24418;2023;14;14;0;100;0;159853.571428571;1640.42857142857;97.0714285714286
24419;2023;12;12;0;100;0;183247.083333333;1563.5;115.25
24420;2023;2;2;0;100;0;90000;1338;69.5
24421;2023;4;4;0;100;0;153800;1438.25;106.75
24422;2023;2;2;0;100;0;91500;1088.5;81.5
24423;2023;4;4;0;100;0;346910;2707.5;123
24424;2023;2;2;0;100;0;102250;1369;82
24425;2023;11;11;0;100;0;139636.363636364;1639.18181818182;94.3636363636364
24426;2023;1;1;0;100;0;153500;1146;134
24428;2023;9;9;0;100;0;162173.888888889;2224.33333333333;80.2222222222222
24429;2023;4;4;0;100;0;117403.75;820.25;121
24432;2023;17;17;0;100;0;210846.235294118;2146.82352941176;105.941176470588
24434;2023;1;1;0;100;0;70000;2188;32
24436;2023;12;12;0;100;0;175322.583333333;2016.58333333333;99.3333333333333
24437;2023;15;15;0;100;0;260457.133333333;2113.86666666667;123.333333333333
24438;2023;3;3;0;100;0;410066.666666667;3136.66666666667;113.666666666667
24441;2023;3;3;0;100;0;134403.333333333;1371.66666666667;96
24442;2023;25;25;0;100;0;144869.04;1556.44;89.16
24443;2023;7;7;0;100;0;278397.142857143;2779.71428571429;110
24444;2023;4;4;0;100;0;187571.25;1409.25;134.5
24445;2023;4;4;0;100;0;354347.5;2519.5;144
24448;2023;4;4;0;100;0;109275;1489.5;80.75
24449;2023;19;19;0;100;0;145619.473684211;1535.21052631579;95.4210526315789
24450;2023;12;12;0;100;0;200322.5;1828.5;114.416666666667
24451;2023;6;6;0;100;0;105666.666666667;1153.33333333333;87.8333333333333
24452;2023;2;2;0;100;0;188500;1399;131.5
24453;2023;2;2;0;100;0;137500;1345;118
24454;2023;3;3;0;100;0;157766.666666667;1610.33333333333;102.333333333333
24455;2023;8;8;0;100;0;205784.375;2073.25;96.875
24456;2023;1;1;0;100;0;325000;2500;130
24457;2023;2;2;0;100;0;162845;1286.5;119
24458;2023;4;4;0;100;0;124907.5;1101;118
24459;2023;7;7;0;100;0;237133;1821.71428571429;112.571428571429
24460;2023;8;8;0;100;0;145716.625;1206.875;125.625
24461;2023;12;12;0;100;0;204904.166666667;1825.5;119.666666666667
24462;2023;16;16;0;100;0;222215.625;1849.25;104.25
24463;2023;2;2;0;100;0;89000;1565;61
24464;2023;4;4;0;100;0;206307;2237;85.75
24465;2023;1;1;0;100;0;75000;543;138
24466;2023;10;10;0;100;0;279518.2;2184.4;125.4
24468;2023;3;3;0;100;0;121866.666666667;1084.33333333333;123.666666666667
24470;2023;1;1;0;100;0;145000;2101;69
24471;2023;5;5;0;100;0;246540;2057;123.8
24472;2023;13;13;0;100;0;270739.230769231;2347.15384615385;109.923076923077
24473;2023;8;8;0;100;0;156125;2129.125;84.875
24474;2023;1;1;0;100;0;50000;676;74
24476;2023;2;2;0;100;0;67500;647;95.5
24477;2023;3;3;0;100;0;81866.6666666667;1011.33333333333;81.3333333333333
24478;2023;1;1;0;100;0;320000;2500;128
24479;2023;20;19;1;95;5;105523.75;1227.05;90.2
24481;2023;8;8;0;100;0;169550;1863.375;101.125
24482;2023;6;6;0;100;0;187166.666666667;1629.16666666667;122
24484;2023;11;11;0;100;0;164948.727272727;1542.63636363636;112
24485;2023;6;6;0;100;0;121887.833333333;1273.66666666667;98.1666666666667
24486;2023;12;12;0;100;0;161208.333333333;1677;95.8333333333333
24487;2023;12;12;0;100;0;154883.333333333;1824.5;86.75
24488;2023;8;8;0;100;0;151646.25;1961.5;76.875
24489;2023;12;12;0;100;0;123035;1129.33333333333;108.166666666667
24490;2023;14;14;0;100;0;171598.285714286;1583.57142857143;116.428571428571
24491;2023;9;9;0;100;0;135502.888888889;1360.11111111111;98.3333333333333
24492;2023;3;3;0;100;0;163333.333333333;1401;120
24493;2023;3;3;0;100;0;113163;1413.33333333333;95.6666666666667
24494;2023;7;7;0;100;0;274963.571428571;2215.28571428571;126
24496;2023;4;4;0;100;0;103750;1235.75;95
24498;2023;21;21;0;100;0;147148.714285714;1645.85714285714;106
24499;2023;13;13;0;100;0;256618.461538462;2349.30769230769;108.692307692308
24501;2023;5;5;0;100;0;275874;1967.2;129.2
24504;2023;5;5;0;100;0;186826;1781.4;104.4
24505;2023;5;5;0;100;0;178633.2;1763;91.8
24507;2023;3;3;0;100;0;74200;1595;39.3333333333333
24508;2023;4;4;0;100;0;186370.5;1303.25;137.75
24509;2023;5;5;0;100;0;192580;1868.2;105.4
24510;2023;6;6;0;100;0;390166.666666667;3789.66666666667;107.333333333333
24511;2023;3;3;0;100;0;133590;1354;99
24512;2023;6;6;0;100;0;267643;2396;119.666666666667
24513;2023;1;1;0;100;0;160000;1616;99
24514;2023;3;3;0;100;0;119666.666666667;1014;125
24515;2023;7;7;0;100;0;136120.714285714;1354.57142857143;101
24516;2023;16;15;1;93.75;6.25;224730.8125;2612.5625;92.0625
24518;2023;3;3;0;100;0;146500;1412.33333333333;104.333333333333
24519;2023;8;8;0;100;0;114928.125;1617.125;70.625
24520;2023;203;125;78;61.576354679803;38.423645320197;172389.246305419;2194.17733990148;79.2660098522168
24521;2023;12;12;0;100;0;165719.083333333;1765.5;91.0833333333333
24522;2023;8;7;1;87.5;12.5;146662.5;1587.25;85.5
24523;2023;7;7;0;100;0;192881;1945.57142857143;101.714285714286
24524;2023;3;3;0;100;0;133006.666666667;1411.66666666667;83
24525;2023;6;6;0;100;0;114812.5;1791.5;78.1666666666667
24526;2023;16;16;0;100;0;108937.25;1342.9375;87.375
24527;2023;21;20;1;95.2380952380952;4.76190476190476;168831.571428571;1627.52380952381;113.047619047619
24529;2023;1;1;0;100;0;205000;1367;150
24531;2023;2;2;0;100;0;196650;1419;139
24532;2023;3;3;0;100;0;146333.333333333;1401.33333333333;105.666666666667
24533;2023;1;1;0;100;0;213520;1841;116
24534;2023;17;16;1;94.1176470588235;5.88235294117647;200355.882352941;1797.41176470588;115.941176470588
24535;2023;1;1;0;100;0;190600;2576;74
24537;2023;3;3;0;100;0;335950;3194.66666666667;85.3333333333333
24538;2023;20;20;0;100;0;191965;1788.45;109.5
24540;2023;16;16;0;100;0;150293;1390.75;110.5
24541;2023;1;1;0;100;0;99400;2259;44
24542;2023;3;3;0;100;0;217250;1781.66666666667;110.333333333333
24543;2023;11;11;0;100;0;152331.818181818;1853.54545454545;90.1818181818182
24544;2023;3;3;0;100;0;152766.666666667;2208.66666666667;71.6666666666667
24547;2023;91;67;24;73.6263736263736;26.3736263736264;125455.274725275;1590.06593406593;82.2087912087912
24548;2023;8;8;0;100;0;140486.75;1259.625;102.625
24549;2023;4;4;0;100;0;504557.5;2587.75;200.25
24550;2023;19;18;1;94.7368421052632;5.26315789473684;119238.315789474;1445.26315789474;99.3157894736842
24551;2023;35;35;0;100;0;108856.085714286;1226.31428571429;97.0857142857143
24552;2023;2;2;0;100;0;195750;2100.5;85.5
24553;2023;22;22;0;100;0;150103.5;1204.36363636364;130.090909090909
24554;2023;15;15;0;100;0;162506.333333333;1633.26666666667;97
24555;2023;9;9;0;100;0;123233.333333333;1315.66666666667;100.222222222222
24557;2023;124;78;46;62.9032258064516;37.0967741935484;158039.177419355;1885.49193548387;84.5725806451613
24558;2023;15;15;0;100;0;162264.133333333;1622.46666666667;103
24559;2023;1;1;0;100;0;340000;3301;103
24560;2023;3;3;0;100;0;194008.333333333;1480.66666666667;127.666666666667
24562;2023;1;1;0;100;0;172000;1654;104
24563;2023;4;4;0;100;0;243825;1877.25;128.25
24564;2023;1;1;0;100;0;135085;1876;72
24565;2023;8;8;0;100;0;112356.25;1462;80.875
24566;2023;2;2;0;100;0;178000;2155;81.5
24567;2023;6;6;0;100;0;153400;1503.33333333333;96.6666666666667
24568;2023;10;10;0;100;0;170506;1628.8;101.1
24569;2023;3;3;0;100;0;129313.333333333;1178.66666666667;115.333333333333
24571;2023;28;27;1;96.4285714285714;3.57142857142857;156772.178571429;1605.32142857143;95.8214285714286
24572;2023;3;3;0;100;0;240952;1979.33333333333;123.333333333333
24573;2023;11;11;0;100;0;128170.090909091;1249.18181818182;120.454545454545
24574;2023;4;4;0;100;0;237612.5;2291.5;106.5
24575;2023;1;1;0;100;0;320000;2909;110
24576;2023;2;2;0;100;0;311100;1899;165
24577;2023;6;6;0;100;0;338740.833333333;2891.16666666667;108.166666666667
24580;2023;4;4;0;100;0;111125;1144;101.25
24581;2023;12;12;0;100;0;140266.666666667;1415.83333333333;104.833333333333
24582;2023;11;11;0;100;0;109227.272727273;1094.72727272727;98.1818181818182
24584;2023;15;15;0;100;0;161415.4;1423.86666666667;116.333333333333
24585;2023;7;7;0;100;0;108857.142857143;1143.85714285714;85.5714285714286
24586;2023;5;5;0;100;0;138040;2394.8;58
24587;2023;12;11;1;91.6666666666667;8.33333333333333;318583.75;2900.5;107.916666666667
25002;2023;3;3;0;100;0;329083.333333333;2525;123
25003;2023;1;1;0;100;0;94000;1022;92
25004;2023;14;9;5;64.2857142857143;35.7142857142857;201178.571428571;1466.57142857143;125.571428571429
25005;2023;1;1;0;100;0;90414;457;198
25008;2023;7;6;1;85.7142857142857;14.2857142857143;182607.142857143;1574.57142857143;110
25011;2023;5;4;1;80;20;159372;1611.2;100.2
25012;2023;2;2;0;100;0;317220;2821;111.5
25013;2023;3;2;1;66.6666666666667;33.3333333333333;123100;1147.66666666667;103.666666666667
25014;2023;7;7;0;100;0;185263.571428571;1666.85714285714;105
25015;2023;5;3;2;60;40;214920;2133.2;119.2
25016;2023;1;1;0;100;0;154000;1588;97
25017;2023;1;1;0;100;0;260000;2321;112
25018;2023;10;10;0;100;0;146858.6;1246.1;116.2
25019;2023;2;2;0;100;0;113000;1313;84
25020;2023;9;4;5;44.4444444444444;55.5555555555556;95355.5555555556;1327.44444444444;72.3333333333333
25021;2023;13;13;0;100;0;192509.230769231;1682.69230769231;129.461538461538
25022;2023;10;10;0;100;0;163995;1631.6;98.3
25024;2023;7;2;5;28.5714285714286;71.4285714285714;275396.714285714;2370;126.428571428571
25025;2023;10;10;0;100;0;230597.2;2109.4;120.5
25026;2023;1;1;0;100;0;312000;2400;130
25029;2023;3;3;0;100;0;187333.333333333;2048.66666666667;134.666666666667
25030;2023;4;3;1;75;25;210775;1999;106.25
25031;2023;152;92;60;60.5263157894737;39.4736842105263;118415.697368421;1332.54605263158;88.6842105263158
25032;2023;1;1;0;100;0;85800;572;150
25033;2023;3;3;0;100;0;168166.666666667;1900.66666666667;89.3333333333333
25035;2023;24;20;4;83.3333333333333;16.6666666666667;294110.416666667;2661.75;110.208333333333
25036;2023;23;17;6;73.9130434782609;26.0869565217391;250806.52173913;2385.26086956522;104
25038;2023;3;3;0;100;0;201866.666666667;2198.66666666667;95.6666666666667
25039;2023;10;8;2;80;20;158542.8;1462;109
25040;2023;6;4;2;66.6666666666667;33.3333333333333;177916.666666667;2007.5;91.3333333333333
25041;2023;1;1;0;100;0;405000;3092;131
25043;2023;26;21;5;80.7692307692308;19.2307692307692;157065.038461538;1755.15384615385;89.9230769230769
25047;2023;54;27;27;50;50;158559.333333333;1885.92592592593;85.6481481481482
25048;2023;36;28;8;77.7777777777778;22.2222222222222;135013.888888889;1538.77777777778;88.6111111111111
25050;2023;2;2;0;100;0;462500;3097;148
25051;2023;3;3;0;100;0;175000;1618.33333333333;102
25052;2023;2;2;0;100;0;269975;4499.5;60
25053;2023;1;1;0;100;0;64029;640;100
25054;2023;2;1;1;50;50;145231;1940;67
25055;2023;5;5;0;100;0;301290;2470.2;123.6
25056;2023;1741;166;1575;9.53475014359563;90.4652498564044;147131.172889144;2294.2533026996;65.2843193566916
25057;2023;59;50;9;84.7457627118644;15.2542372881356;114440.745762712;1221.32203389831;96.3559322033898
25058;2023;13;6;7;46.1538461538462;53.8461538461538;137433;1813.38461538462;78.8461538461538
25059;2023;2;2;0;100;0;80000;1037;78
25060;2023;10;4;6;40;60;164357.5;2082.5;67.5
25061;2023;2;2;0;100;0;100500;686.5;148.5
25062;2023;2;2;0;100;0;352100;2440.5;146
25063;2023;5;4;1;80;20;153360;1737;89.6
25066;2023;2;2;0;100;0;117500;1605;72.5
25067;2023;5;5;0;100;0;183300;1512.8;121.2
25070;2023;3;3;0;100;0;213076.666666667;1508;164
25071;2023;4;4;0;100;0;161250;1580.5;100
25073;2023;6;5;1;83.3333333333333;16.6666666666667;226300;1803.5;127.833333333333
25074;2023;12;11;1;91.6666666666667;8.33333333333333;227670.833333333;2343.25;104.666666666667
25075;2023;2;2;0;100;0;421975;2810;151.5
25078;2023;5;5;0;100;0;195401;1839.2;106.2
25079;2023;6;6;0;100;0;286980.833333333;2472.83333333333;118.166666666667
25082;2023;3;3;0;100;0;185666.666666667;1898.33333333333;102
25083;2023;1;1;0;100;0;85000;773;110
25084;2023;7;7;0;100;0;235785.714285714;2365.42857142857;100.857142857143
25085;2023;6;5;1;83.3333333333333;16.6666666666667;255873;2570.5;102.5
25086;2023;1;1;0;100;0;260000;3059;85
25087;2023;2;2;0;100;0;134300;1680.5;82
25089;2023;4;4;0;100;0;218275;2058.25;110.25
25091;2023;3;1;2;33.3333333333333;66.6666666666667;192821.666666667;2814;69.3333333333333
25092;2023;2;2;0;100;0;115650;928;124.5
25095;2023;4;3;1;75;25;146400;970.5;139
25097;2023;6;6;0;100;0;186535;1603.16666666667;121.333333333333
25100;2023;6;4;2;66.6666666666667;33.3333333333333;268158.333333333;2481;110.166666666667
25101;2023;3;2;1;66.6666666666667;33.3333333333333;189470;1909.33333333333;97.6666666666667
25103;2023;6;6;0;100;0;205758.333333333;1660.5;129.333333333333
25105;2023;10;9;1;90;10;193998;1803.6;107.3
25106;2023;3;3;0;100;0;132333.333333333;1466.33333333333;85.3333333333333
25107;2023;3;3;0;100;0;161666.666666667;1318.66666666667;115.666666666667
25109;2023;1;1;0;100;0;155500;884;176
25110;2023;8;5;3;62.5;37.5;319880;3405.625;96.625
25111;2023;4;4;0;100;0;225625;2137.5;117
25112;2023;18;6;12;33.3333333333333;66.6666666666667;212533.611111111;2440.05555555556;86.0555555555556
25114;2023;5;5;0;100;0;160500;1592.4;107
25116;2023;1;1;0;100;0;228890;2515;91
25119;2023;3;3;0;100;0;151543.333333333;1340.66666666667;108
25120;2023;1;1;0;100;0;245000;2094;117
25121;2023;1;1;0;100;0;205300;1866;110
25122;2023;2;2;0;100;0;317330;2213;143.5
25124;2023;3;3;0;100;0;222200;2322;98.3333333333333
25125;2023;4;4;0;100;0;145750;1206.5;127.25
25126;2023;4;4;0;100;0;202589.5;1600.25;127.25
25127;2023;49;22;27;44.8979591836735;55.1020408163265;227744.693877551;2310.38775510204;94.1632653061225
25130;2023;1;1;0;100;0;180000;1406;128
25133;2023;22;19;3;86.3636363636364;13.6363636363636;304674.636363636;2696.68181818182;111.636363636364
25136;2023;8;6;2;75;25;234580;1938.25;134.125
25138;2023;2;2;0;100;0;127400;1149;113
25139;2023;3;2;1;66.6666666666667;33.3333333333333;195033.333333333;1712;109
25141;2023;1;1;0;100;0;176000;1600;110
25142;2023;9;8;1;88.8888888888889;11.1111111111111;305050;3798.88888888889;88.1111111111111
25143;2023;1;1;0;100;0;138180;818;169
25147;2023;17;12;5;70.5882352941177;29.4117647058824;222282.352941176;2410.82352941176;97.2941176470588
25148;2023;2;2;0;100;0;362875;3547;103.5
25149;2023;4;4;0;100;0;139075;1474.25;95.75
25150;2023;4;4;0;100;0;185540;1744;106.5
25151;2023;1;1;0;100;0;175000;1458;120
25153;2023;1;1;0;100;0;283950;2868;99
25154;2023;5;5;0;100;0;155417;2061.6;81.4
25156;2023;12;12;0;100;0;113950;1124.75;95.6666666666667
25157;2023;24;10;14;41.6666666666667;58.3333333333333;282081.25;3167.20833333333;96
25159;2023;9;7;2;77.7777777777778;22.2222222222222;126830;1419.77777777778;86.3333333333333
25160;2023;5;5;0;100;0;267500;2422.2;109.8
25162;2023;2;2;0;100;0;198150;1509.5;140.5
25163;2023;3;3;0;100;0;214650;1654;125
25164;2023;1;1;0;100;0;80000;696;115
25170;2023;17;12;5;70.5882352941177;29.4117647058824;188607.823529412;1905.29411764706;99.1764705882353
25172;2023;3;3;0;100;0;179258.333333333;2052.33333333333;95
25173;2023;4;4;0;100;0;202562.5;1934;121
25174;2023;3;3;0;100;0;191666.666666667;1408;144
25176;2023;3;1;2;33.3333333333333;66.6666666666667;209233.333333333;3507;68.3333333333333
25177;2023;3;3;0;100;0;193533.333333333;1272.66666666667;175.333333333333
25179;2023;1;1;0;100;0;335000;2913;115
25180;2023;2;2;0;100;0;342575;2667;133.5
25181;2023;2;2;0;100;0;141510;1403;104
25182;2023;2;2;0;100;0;132000;900;140.5
25183;2023;1;1;0;100;0;44100;1764;25
25184;2023;2;1;1;50;50;150720;1297.5;115
25186;2023;10;8;2;80;20;257203.3;2527.5;108.8
25187;2023;4;4;0;100;0;148750;1320.25;111.25
25188;2023;5;4;1;80;20;227270;2152.8;106
25189;2023;1;1;0;100;0;157900;1224;129
25190;2023;19;14;5;73.6842105263158;26.3157894736842;147375.263157895;1664.63157894737;85.9473684210526
25191;2023;4;3;1;75;25;134442.5;1616.25;83.5
25193;2023;16;7;9;43.75;56.25;156515.8125;1826.6875;85
25195;2023;12;11;1;91.6666666666667;8.33333333333333;268149.5;2448.75;110
25196;2023;14;11;3;78.5714285714286;21.4285714285714;116407.142857143;1456.07142857143;82.2142857142857
25197;2023;9;6;3;66.6666666666667;33.3333333333333;163053.333333333;1768;88.7777777777778
25198;2023;5;5;0;100;0;146268;1526.4;95.2
25199;2023;5;3;2;60;40;165932;1480.8;114.4
25200;2023;6;6;0;100;0;325083.333333333;2716.83333333333;117
25201;2023;9;3;6;33.3333333333333;66.6666666666667;308772.222222222;3089.55555555556;105.888888888889
25204;2023;32;17;15;53.125;46.875;288284.28125;3086.40625;96.1875
25207;2023;6;5;1;83.3333333333333;16.6666666666667;219016.666666667;1461.66666666667;136.333333333333
25209;2023;2;2;0;100;0;248000;2099;125
25210;2023;1;1;0;100;0;209000;2090;100
25211;2023;3;3;0;100;0;162000;1986.66666666667;86
25212;2023;20;17;3;85;15;260939.9;2490.45;103.8
25213;2023;6;5;1;83.3333333333333;16.6666666666667;246655;2321.16666666667;103.166666666667
25214;2023;5;5;0;100;0;228100;1730.2;127.4
25215;2023;1;1;0;100;0;70000;745;94
25216;2023;1;1;0;100;0;180000;1682;107
25217;2023;7;6;1;85.7142857142857;14.2857142857143;197628.571428571;1972.71428571429;105
25218;2023;1;1;0;100;0;55000;688;80
25219;2023;6;6;0;100;0;305347.5;2632.16666666667;119.666666666667
25220;2023;2;2;0;100;0;216962.5;1995;109
25222;2023;15;13;2;86.6666666666667;13.3333333333333;213529.333333333;2005.66666666667;114.666666666667
25224;2023;10;9;1;90;10;192497;1744.1;103.4
25226;2023;2;2;0;100;0;71000;683.5;105
25227;2023;7;7;0;100;0;221114.285714286;2163.85714285714;109.857142857143
25228;2023;31;25;6;80.6451612903226;19.3548387096774;171958.580645161;1814.03225806452;93.4516129032258
25229;2023;8;4;4;50;50;214495;2651.5;78.625
25230;2023;28;25;3;89.2857142857143;10.7142857142857;143282.142857143;1750.21428571429;81.4642857142857
25232;2023;2;0;2;0;100;95000;1075;87.5
25233;2023;1;1;0;100;0;78000;867;90
25234;2023;1;1;0;100;0;345000;2654;130
25235;2023;3;3;0;100;0;262500;2120.66666666667;126
25236;2023;3;3;0;100;0;250800;2033.33333333333;148
25237;2023;24;16;8;66.6666666666667;33.3333333333333;146889.708333333;1708.91666666667;86.9166666666667
25238;2023;2;2;0;100;0;159722;2460.5;80
25239;2023;1;1;0;100;0;228000;2018;113
25240;2023;35;22;13;62.8571428571429;37.1428571428571;321169.142857143;3149.91428571429;103.342857142857
25242;2023;1;1;0;100;0;260000;5200;50
25243;2023;8;8;0;100;0;265337.5;2026.5;128.125
25244;2023;3;3;0;100;0;217858.333333333;2041.33333333333;110
25245;2023;15;14;1;93.3333333333333;6.66666666666667;284501.8;2440.26666666667;116.2
25246;2023;3;3;0;100;0;96000;973;99
25248;2023;4;4;0;100;0;264237.5;2308.5;116.25
25249;2023;1;1;0;100;0;200500;2359;85
25254;2023;26;7;19;26.9230769230769;73.0769230769231;189167.038461538;2979;64.5
25255;2023;4;1;3;25;75;99941.5;1623.75;69.25
25256;2023;13;9;4;69.2307692307692;30.7692307692308;223387.846153846;2197.15384615385;102.769230769231
25257;2023;3;3;0;100;0;240500;2307;107.333333333333
25258;2023;21;16;5;76.1904761904762;23.8095238095238;253870.476190476;2548.57142857143;101.619047619048
25259;2023;35;20;15;57.1428571428571;42.8571428571429;241762.028571429;2443.82857142857;100.2
25263;2023;1;1;0;100;0;290000;5000;58
25264;2023;1;1;0;100;0;85000;680;125
25265;2023;13;9;4;69.2307692307692;30.7692307692308;282352.076923077;2308.92307692308;115.307692307692
25266;2023;1;1;0;100;0;182000;968;188
25267;2023;4;4;0;100;0;304575;2451.25;122.5
25268;2023;2;2;0;100;0;140155;1206;114.5
25269;2023;2;2;0;100;0;135965;1507.5;100
25270;2023;2;2;0;100;0;149750;1246;112.5
25271;2023;19;7;12;36.8421052631579;63.1578947368421;233453.684210526;2346.94736842105;100.105263157895
25273;2023;1;1;0;100;0;416000;1953;213
25274;2023;6;4;2;66.6666666666667;33.3333333333333;137783.333333333;1304.33333333333;96.5
25275;2023;6;6;0;100;0;99583.3333333333;1098;88.3333333333333
25276;2023;2;2;0;100;0;152500;1636.5;97.5
25278;2023;5;5;0;100;0;233455;1720;138.4
25279;2023;1;1;0;100;0;65000;542;120
25280;2023;2;2;0;100;0;214270;4164;59.5
25281;2023;1;0;1;0;100;90600;1208;75
25282;2023;2;2;0;100;0;199000;1984.5;99
25283;2023;1;1;0;100;0;145000;1318;110
25284;2023;66;34;32;51.5151515151515;48.4848484848485;118640.212121212;1399.01515151515;83.6969696969697
25285;2023;9;7;2;77.7777777777778;22.2222222222222;321546.666666667;2808.33333333333;108.888888888889
25286;2023;2;2;0;100;0;295750;3265;91
25287;2023;14;11;3;78.5714285714286;21.4285714285714;253298.714285714;2190.5;117.714285714286
25288;2023;5;4;1;80;20;271990;2012.6;140
25289;2023;2;2;0;100;0;191500;2060;74.5
25293;2023;14;8;6;57.1428571428571;42.8571428571429;283942.857142857;3221.92857142857;89.0714285714286
25295;2023;6;2;4;33.3333333333333;66.6666666666667;314135;4724.83333333333;74.3333333333333
25296;2023;12;7;5;58.3333333333333;41.6666666666667;213055.833333333;2445.41666666667;96.8333333333333
25299;2023;2;2;0;100;0;130250;1450;85
25300;2023;1;1;0;100;0;135000;1311;103
25301;2023;7;7;0;100;0;204818.571428571;1937.57142857143;112.714285714286
25303;2023;1;1;0;100;0;350000;2574;136
25304;2023;41;24;17;58.5365853658537;41.4634146341463;118010.731707317;1356.26829268293;84.9024390243902
25305;2023;4;4;0;100;0;251600;2040.75;124.25
25307;2023;32;12;20;37.5;62.5;234350.4375;3362.09375;73
25308;2023;3;1;2;33.3333333333333;66.6666666666667;275000;4878;58.3333333333333
25309;2023;14;7;7;50;50;284563;3251.28571428571;88.5714285714286
25310;2023;3;3;0;100;0;214983.333333333;1796.66666666667;140
25311;2023;4;4;0;100;0;137725;1486.75;97
25312;2023;4;4;0;100;0;98480;2044.75;59.25
25313;2023;1;1;0;100;0;74390;1127;66
25315;2023;35;31;4;88.5714285714286;11.4285714285714;113906.685714286;1194.08571428571;97.9428571428571
25316;2023;3;3;0;100;0;143333.333333333;1647;85.6666666666667
25317;2023;2;2;0;100;0;107750;1361;107.5
25318;2023;36;16;20;44.4444444444444;55.5555555555556;236026.5;3548.36111111111;67.4444444444444
25320;2023;18;2;16;11.1111111111111;88.8888888888889;204882.5;3289.33333333333;65.4444444444444
25321;2023;77;37;40;48.0519480519481;51.9480519480519;255666.480519481;2839.07792207792;89.8441558441558
25322;2023;3;3;0;100;0;210960;2416.66666666667;87.6666666666667
25323;2023;4;4;0;100;0;72562.5;1167.5;63.75
25324;2023;2;2;0;100;0;141750;1208;120
25325;2023;1;0;1;0;100;38000;691;55
25326;2023;1;1;0;100;0;155000;969;160
25327;2023;1;1;0;100;0;75000;1000;75
25328;2023;10;9;1;90;10;279612;2693.3;106.8
25329;2023;1;1;0;100;0;150000;1765;85
25330;2023;2;2;0;100;0;226075;1857.5;123
25331;2023;1;1;0;100;0;95000;792;120
25332;2023;3;3;0;100;0;192000;2020;94
25334;2023;16;12;4;75;25;255139.375;2356.5;111.375
25335;2023;1;1;0;100;0;95000;664;143
25336;2023;4;4;0;100;0;136585;1451.75;96.5
25338;2023;1;1;0;100;0;286100;1635;175
25339;2023;5;1;4;20;80;150444;4441;73.6
25340;2023;4;4;0;100;0;131950;1329.5;101.25
25341;2023;1;1;0;100;0;153450;2192;70
25342;2023;2;2;0;100;0;175000;1889.5;100.5
25343;2023;1;1;0;100;0;170000;829;205
25345;2023;3;3;0;100;0;121366.666666667;1181;101.666666666667
25346;2023;1;1;0;100;0;109000;1282;85
25347;2023;8;7;1;87.5;12.5;250727.875;2401.375;105.75
25348;2023;8;5;3;62.5;37.5;331763.625;3403.5;107.5
25349;2023;5;5;0;100;0;179790;1063;164.8
25350;2023;8;8;0;100;0;149259.875;1510.375;101.375
25351;2023;1;1;0;100;0;70500;860;82
25356;2023;65;34;31;52.3076923076923;47.6923076923077;186837.753846154;2155.16923076923;88.4615384615385
25357;2023;9;5;4;55.5555555555556;44.4444444444444;270866.666666667;2628.77777777778;100
25360;2023;1;1;0;100;0;324900;3094;105
25361;2023;24;2;22;8.33333333333333;91.6666666666667;196920.833333333;3610.25;58.0416666666667
25362;2023;7;3;4;42.8571428571429;57.1428571428571;248778.571428571;3300;83.2857142857143
25364;2023;7;6;1;85.7142857142857;14.2857142857143;215766.428571429;2219.85714285714;102.428571428571
25365;2023;1;1;0;100;0;80000;1067;75
25367;2023;41;27;14;65.8536585365854;34.1463414634146;112436.365853659;1325.36585365854;80.8780487804878
25368;2023;10;10;0;100;0;229272.5;2176.4;106.5
25370;2023;18;12;6;66.6666666666667;33.3333333333333;143468.888888889;1643.44444444444;90.9444444444444
25371;2023;1;1;0;100;0;295540;2570;115
25372;2023;2;2;0;100;0;85000;666.5;120
25374;2023;3;3;0;100;0;145000;1383.33333333333;146.666666666667
25375;2023;4;4;0;100;0;167700;1648.25;103.75
25376;2023;1;0;1;0;100;53030;408;130
25377;2023;1;1;0;100;0;59000;656;90
25378;2023;4;3;1;75;25;111000;1445.75;73
25380;2023;104;36;68;34.6153846153846;65.3846153846154;159397.663461538;3749.61538461538;44.7115384615385
25381;2023;25;22;3;88;12;306738.2;2946.84;105.56
25382;2023;6;6;0;100;0;199667;2193.5;89
25383;2023;1;1;0;100;0;244200;2840;86
25386;2023;1;1;0;100;0;88000;2200;40
25387;2023;9;8;1;88.8888888888889;11.1111111111111;289233.333333333;2273.88888888889;135.111111111111
25388;2023;302;64;238;21.1920529801325;78.8079470198676;93582.7086092715;1215.31125827815;75.2781456953642
25389;2023;1;1;0;100;0;280000;2222;126
25390;2023;4;3;1;75;25;277675;3007;95.25
25391;2023;1;1;0;100;0;297600;2522;118
25392;2023;1;1;0;100;0;193400;2579;75
25393;2023;7;7;0;100;0;133392.857142857;1500;90
25394;2023;14;14;0;100;0;149380.357142857;1509.5;99.3571428571429
25395;2023;6;6;0;100;0;416275;2962.5;135.5
25397;2023;21;15;6;71.4285714285714;28.5714285714286;222215.714285714;2406.14285714286;93.3809523809524
25400;2023;3;3;0;100;0;106800;1843.33333333333;81
25403;2023;25;8;17;32;68;269173.04;3305.28;81.72
25404;2023;2;2;0;100;0;130500;2023.5;64.5
25405;2023;8;7;1;87.5;12.5;371568.75;3483.125;106.5
25406;2023;4;4;0;100;0;181750;2042.25;91.25
25410;2023;14;11;3;78.5714285714286;21.4285714285714;246160.642857143;2243.92857142857;107.071428571429
25411;2023;127;21;106;16.5354330708661;83.4645669291339;210558.220472441;2974.89763779528;72.5511811023622
25413;2023;19;4;15;21.0526315789474;78.9473684210526;170444.736842105;2520.47368421053;65.3157894736842
25414;2023;2;2;0;100;0;290750;2118.5;137
25415;2023;7;6;1;85.7142857142857;14.2857142857143;129435.714285714;1357;100.142857142857
25416;2023;5;5;0;100;0;227874;1674.6;133.2
25417;2023;2;2;0;100;0;249125;2366.5;105
25418;2023;10;9;1;90;10;236563.3;1965.1;123
25419;2023;1;1;0;100;0;69610;616;113
25420;2023;3;3;0;100;0;267750.666666667;1704.33333333333;167.333333333333
25421;2023;2;2;0;100;0;366800;2401;155
25422;2023;1;1;0;100;0;263500;2534;104
25424;2023;15;13;2;86.6666666666667;13.3333333333333;248614.4;2103;118.466666666667
25425;2023;5;5;0;100;0;346080;3071;114.2
25426;2023;3;1;2;33.3333333333333;66.6666666666667;146833.333333333;1402;105
25427;2023;2;2;0;100;0;96500;942;105
25428;2023;18;14;4;77.7777777777778;22.2222222222222;166462.722222222;1762.61111111111;99
25429;2023;7;4;3;57.1428571428571;42.8571428571429;126481.714285714;1544;76.2857142857143
25431;2023;3;3;0;100;0;216700;1720.66666666667;142.333333333333
25432;2023;13;8;5;61.5384615384615;38.4615384615385;216630.769230769;2295.61538461538;98.6923076923077
25433;2023;2;2;0;100;0;204175;2729;85
25434;2023;55;26;29;47.2727272727273;52.7272727272727;137389.090909091;1852.78181818182;74.2727272727273
25435;2023;3;3;0;100;0;143666.666666667;1734.66666666667;82.6666666666667
25436;2023;1;1;0;100;0;58800;511;115
25437;2023;5;5;0;100;0;221630;1805.4;131.4
25438;2023;8;6;2;75;25;235908.75;2191.25;110.875
25439;2023;3;3;0;100;0;155633.333333333;1738.66666666667;91.3333333333333
25440;2023;1;1;0;100;0;247550;1781;139
25441;2023;1;1;0;100;0;34800;1200;29
25442;2023;10;4;6;40;60;281865.5;2938.4;94.7
25444;2023;2;2;0;100;0;240400;2277;105
25447;2023;1;1;0;100;0;331000;2331;142
25448;2023;11;8;3;72.7272727272727;27.2727272727273;302815.909090909;2777.81818181818;108.454545454545
25452;2023;7;4;3;57.1428571428571;42.8571428571429;132057.142857143;1709.14285714286;79
25453;2023;13;11;2;84.6153846153846;15.3846153846154;219853.384615385;1911.30769230769;114.384615384615
25454;2023;15;9;6;60;40;267186;2860.86666666667;107.8
25456;2023;2;2;0;100;0;256710;1891.5;135.5
25457;2023;1;1;0;100;0;247000;1544;160
25459;2023;1;1;0;100;0;163938;1197;137
25460;2023;1;1;0;100;0;225000;2446;92
25461;2023;3;2;1;66.6666666666667;33.3333333333333;55000;1328;48.6666666666667
25462;2023;277;40;237;14.4404332129964;85.5595667870036;189794.33935018;2785.37184115523;69.0216606498195
25463;2023;33;22;11;66.6666666666667;33.3333333333333;126022.515151515;1378.60606060606;88.4242424242424
25465;2023;1;1;0;100;0;205000;1752;117
25466;2023;6;6;0;100;0;214116.666666667;2243.33333333333;103.333333333333
25467;2023;22;12;10;54.5454545454545;45.4545454545455;194439.545454545;2368.68181818182;85.8636363636364
25468;2023;6;5;1;83.3333333333333;16.6666666666667;229331.666666667;2106.5;111.166666666667
25469;2023;3;3;0;100;0;313500;1838.66666666667;174.333333333333
25470;2023;1;1;0;100;0;54000;545;99
25472;2023;1;1;0;100;0;189000;1181;160
25473;2023;2;2;0;100;0;178500;2434;75
25475;2023;8;5;3;62.5;37.5;160231.25;1614;102.125
25477;2023;2;1;1;50;50;326150;2827;115
25479;2023;6;5;1;83.3333333333333;16.6666666666667;94060;1090.66666666667;80.3333333333333
25481;2023;1;1;0;100;0;239500;1736;138
25482;2023;3;2;1;66.6666666666667;33.3333333333333;184166.666666667;1342;137.666666666667
25483;2023;1;1;0;100;0;485000;5160;94
25485;2023;1;1;0;100;0;246380;2324;106
25486;2023;4;2;2;50;50;227637.5;2712.5;83.5
25488;2023;2;2;0;100;0;112000;1869.5;69
25489;2023;5;5;0;100;0;192434;1883.2;110.4
25490;2023;2;2;0;100;0;244500;1596.5;203.5
25493;2023;12;11;1;91.6666666666667;8.33333333333333;319810;2775.75;120.916666666667
25494;2023;15;8;7;53.3333333333333;46.6666666666667;295111;3084.33333333333;93.2666666666667
25495;2023;25;20;5;80;20;212162.6;2037.08;105.6
25496;2023;1;1;0;100;0;147000;2450;60
25497;2023;3;3;0;100;0;306069.333333333;1904.33333333333;160.666666666667
25502;2023;5;5;0;100;0;246424;2198.2;119.4
25503;2023;1;1;0;100;0;215200;1145;188
25504;2023;3;3;0;100;0;191716.666666667;2466;98.6666666666667
25505;2023;11;11;0;100;0;130030;1244.27272727273;107
25508;2023;9;7;2;77.7777777777778;22.2222222222222;148055.555555556;1348.11111111111;114.333333333333
25510;2023;3;1;2;33.3333333333333;66.6666666666667;243900;2348.33333333333;105
25511;2023;3;3;0;100;0;138166.666666667;1412;96
25512;2023;22;14;8;63.6363636363636;36.3636363636364;191855;2132.72727272727;91.5
25513;2023;1;1;0;100;0;508500;5085;100
25514;2023;3;0;3;0;100;225666.666666667;4382;48.6666666666667
25515;2023;10;4;6;40;60;294070;2768;108.1
25517;2023;1;1;0;100;0;3,00E+05;1562;192
25518;2023;1;1;0;100;0;2,00E+05;833;240
25519;2023;11;7;4;63.6363636363636;36.3636363636364;144003.181818182;1349.18181818182;104
25520;2023;3;3;0;100;0;144470;1032;131
25521;2023;1;1;0;100;0;250000;2525;99
25523;2023;5;5;0;100;0;164920;1677.6;99.6
25524;2023;4;4;0;100;0;209000;1524.5;137.5
25525;2023;4;2;2;50;50;209947.5;3790;75.75
25526;2023;25;8;17;32;68;95069.2;1282.16;74.6
25527;2023;44;37;7;84.0909090909091;15.9090909090909;208222.954545455;2349.86363636364;95.6363636363636
25528;2023;1;1;0;100;0;188500;1346;140
25529;2023;5;5;0;100;0;262807;1948.2;140.4
25532;2023;32;22;10;68.75;31.25;231511.8125;2493;93.21875
25533;2023;1;1;0;100;0;210000;1780;118
25534;2023;1;1;0;100;0;260317;2002;130
25535;2023;1;1;0;100;0;157047;1378;114
25537;2023;1;1;0;100;0;122000;1008;121
25538;2023;1;1;0;100;0;106000;746;142
25539;2023;69;44;25;63.768115942029;36.231884057971;141252.753623188;1568.79710144928;85.8115942028985
25540;2023;2;1;1;50;50;63850;822.5;75
25541;2023;5;5;0;100;0;316000;2522.4;124
25542;2023;23;20;3;86.9565217391304;13.0434782608696;294796.956521739;2857.69565217391;105.304347826087
25544;2023;1;1;0;100;0;114500;1316;87
25545;2023;2;2;0;100;0;181585;1820.5;110.5
25547;2023;27;7;20;25.9259259259259;74.0740740740741;95695.3703703704;1185.66666666667;79.5925925925926
25548;2023;3;3;0;100;0;197716.666666667;1576;118.666666666667
25551;2023;2;2;0;100;0;235700;1898.5;132.5
25552;2023;1;1;0;100;0;160240;1178;136
25553;2023;5;5;0;100;0;87543.6;1113;80
25554;2023;1;1;0;100;0;165000;1774;93
25555;2023;15;6;9;40;60;159336.666666667;1604.6;100.133333333333
25557;2023;4;4;0;100;0;314925;3251.5;98.25
25558;2023;8;8;0;100;0;257283.75;2559.5;102.625
25559;2023;3;3;0;100;0;268100;1681.33333333333;160
25560;2023;26;21;5;80.7692307692308;19.2307692307692;227011.923076923;2294.84615384615;100.5
25561;2023;3;3;0;100;0;250350;2765.33333333333;96.3333333333333
25562;2023;3;3;0;100;0;185000;2042.33333333333;91.6666666666667
25563;2023;1;1;0;100;0;142000;1365;104
25564;2023;7;6;1;85.7142857142857;14.2857142857143;220803.571428571;2260.28571428571;96.8571428571429
25565;2023;1;1;0;100;0;427000;2847;150
25566;2023;2;2;0;100;0;211575;1832;126
25569;2023;3;2;1;66.6666666666667;33.3333333333333;211703.333333333;1725.33333333333;114.333333333333
25570;2023;1;1;0;100;0;1,00E+05;1000;100
25571;2023;9;8;1;88.8888888888889;11.1111111111111;212752.444444444;1883.88888888889;114.222222222222
25574;2023;1;1;0;100;0;40000;563;71
25575;2023;2;1;1;50;50;173050;1666.5;109.5
25578;2023;57;19;38;33.3333333333333;66.6666666666667;184801.666666667;2435.21052631579;79.6491228070175
25579;2023;3;3;0;100;0;250525.333333333;2081.33333333333;121.333333333333
25580;2023;121;66;55;54.5454545454545;45.4545454545455;109131.652892562;1272.13223140496;86.9669421487603
25582;2023;2;2;0;100;0;93500;1569;64
25583;2023;1;1;0;100;0;230000;2233;103
25584;2023;3;3;0;100;0;180533.333333333;2545.66666666667;73.3333333333333
25586;2023;5;5;0;100;0;191764;1987;90
25588;2023;2;2;0;100;0;123500;2629;47.5
25591;2023;2;2;0;100;0;200950;2260.5;98.5
25592;2023;6;3;3;50;50;201585;2633.83333333333;73
25595;2023;1;1;0;100;0;105000;963;109
25596;2023;1;1;0;100;0;155000;1722;90
25597;2023;1;1;0;100;0;165000;2260;73
25598;2023;3;3;0;100;0;228666.666666667;2052.66666666667;116.666666666667
25599;2023;1;0;1;0;100;95000;2159;44
25600;2023;1;1;0;100;0;360000;2880;125
25601;2023;15;11;4;73.3333333333333;26.6666666666667;244823.333333333;2364.13333333333;96.9333333333333
25602;2023;1;1;0;100;0;90300;951;95
25604;2023;1;1;0;100;0;135000;1452;93
25605;2023;2;1;1;50;50;194200;1440.5;134
25608;2023;1;1;0;100;0;170000;1298;131
25609;2023;6;5;1;83.3333333333333;16.6666666666667;273900;2654.33333333333;97
25611;2023;4;4;0;100;0;410475;2395.25;166.75
25612;2023;4;4;0;100;0;214550;1890.25;116.5
25614;2023;35;27;8;77.1428571428572;22.8571428571429;146516.942857143;1666.77142857143;92.0285714285714
25615;2023;6;6;0;100;0;194625;2054.83333333333;95.8333333333333
25616;2023;1;1;0;100;0;300700;1280;235
25617;2023;1;1;0;100;0;90000;882;102
25618;2023;3;3;0;100;0;139866.666666667;1713.33333333333;81.3333333333333
25619;2023;9;2;7;22.2222222222222;77.7777777777778;171023.333333333;2998.55555555556;57.1111111111111
25620;2023;1;0;1;0;100;113000;1242;91
25621;2023;1;1;0;100;0;220000;1679;131
25622;2023;2;2;0;100;0;243525;2457.5;100.5
25624;2023;2;1;1;50;50;143750;1719.5;84.5
25626;2023;1;1;0;100;0;170000;1141;149
25627;2023;2;2;0;100;0;169750;2291;77
25629;2023;1;1;0;100;0;63000;741;85
25630;2023;1;1;0;100;0;130000;1008;129
25631;2023;6;6;0;100;0;345630.5;4289.16666666667;80
25632;2023;25;17;8;68;32;126765;1504.52;88.32
25633;2023;7;7;0;100;0;136450;1221.71428571429;110
25634;2023;4;3;1;75;25;296250;3089.75;93.25
25635;2023;3;3;0;100;0;73666.6666666667;915.333333333333;92
26001;2023;3;3;0;100;0;179333.333333333;2562.66666666667;78.3333333333333
26002;2023;15;14;1;93.3333333333333;6.66666666666667;216236.666666667;2206.06666666667;104.533333333333
26003;2023;2;2;0;100;0;445000;2424.5;187
26004;2023;15;13;2;86.6666666666667;13.3333333333333;283587;2452.93333333333;113.466666666667
26005;2023;16;16;0;100;0;430640.625;3453.875;127
26006;2023;19;17;2;89.4736842105263;10.5263157894737;282608.947368421;2474.05263157895;112.105263157895
26008;2023;23;23;0;100;0;184731.956521739;2111.17391304348;90.4347826086957
26009;2023;8;7;1;87.5;12.5;198250;1713.625;121.5
26010;2023;45;27;18;60;40;207579.777777778;2292.62222222222;93.5777777777778
26011;2023;15;15;0;100;0;255635.333333333;2904.53333333333;91.4666666666667
26013;2023;2;2;0;100;0;359000;3681;102.5
26014;2023;6;5;1;83.3333333333333;16.6666666666667;332095.333333333;2502.5;132.833333333333
26016;2023;2;2;0;100;0;361250;4304;82.5
26019;2023;1;1;0;100;0;33000;2062;16
26021;2023;1;1;0;100;0;580000;2775;209
26022;2023;2;2;0;100;0;97500;927.5;108
26023;2023;10;9;1;90;10;254700;2835.9;88.5
26024;2023;3;3;0;100;0;244536.666666667;1536.66666666667;127
26025;2023;4;4;0;100;0;275102.5;2213.75;125.5
26026;2023;3;3;0;100;0;206333.333333333;2312;99.6666666666667
26028;2023;3;3;0;100;0;297706.666666667;3138.66666666667;95.3333333333333
26031;2023;14;13;1;92.8571428571429;7.14285714285714;222338.928571429;2360.92857142857;96.4285714285714
26032;2023;2;2;0;100;0;293800;2061.5;123
26033;2023;11;11;0;100;0;335896.363636364;2732.54545454545;104.454545454545
26034;2023;5;4;1;80;20;211038.8;1853;116
26035;2023;5;5;0;100;0;393914;2881.4;136.4
26036;2023;1;1;0;100;0;620000;2696;230
26037;2023;31;30;1;96.7741935483871;3.2258064516129;304514.870967742;2772.06451612903;113.935483870968
26038;2023;6;6;0;100;0;328233.333333333;2527.5;133
26039;2023;11;10;1;90.9090909090909;9.09090909090909;262509.090909091;2323.27272727273;115.727272727273
26040;2023;1;0;1;0;100;46000;767;60
26041;2023;13;11;2;84.6153846153846;15.3846153846154;177134.615384615;1863.76923076923;98.0769230769231
26042;2023;14;13;1;92.8571428571429;7.14285714285714;275678.714285714;2905.14285714286;96.0714285714286
26045;2023;15;11;4;73.3333333333333;26.6666666666667;258864.733333333;2899.66666666667;102.866666666667
26047;2023;1;1;0;100;0;108210;1482;73
26048;2023;1;1;0;100;0;66500;1583;42
26049;2023;13;8;5;61.5384615384615;38.4615384615385;233041.538461538;2672.23076923077;90.1538461538462
26052;2023;4;4;0;100;0;210730;2402.5;86.75
26054;2023;18;18;0;100;0;294612.833333333;2668.83333333333;112.777777777778
26055;2023;2;1;1;50;50;101750;2171.5;47
26056;2023;9;7;2;77.7777777777778;22.2222222222222;211168.888888889;2780;85.7777777777778
26057;2023;147;73;74;49.6598639455782;50.3401360544218;164003.836734694;2162.93197278912;76.1904761904762
26058;2023;285;108;177;37.8947368421053;62.1052631578947;180913.849122807;2263.03157894737;78.3228070175439
26059;2023;8;7;1;87.5;12.5;168117.25;1828.75;97.125
26061;2023;4;4;0;100;0;338512.5;2686.5;135.5
26063;2023;37;33;4;89.1891891891892;10.8108108108108;286829.216216216;3123.48648648649;96.8648648648649
26064;2023;69;53;16;76.8115942028985;23.1884057971014;260801.304347826;2821.3768115942;94.6521739130435
26065;2023;8;8;0;100;0;341286.25;4028.375;110
26066;2023;1;1;0;100;0;135000;2500;54
26067;2023;3;3;0;100;0;263666.666666667;3859.66666666667;77
26068;2023;1;1;0;100;0;395000;3292;120
26069;2023;1;1;0;100;0;397000;3308;120
26070;2023;4;3;1;75;25;342187.5;2748;109
26071;2023;13;10;3;76.9230769230769;23.0769230769231;280405.153846154;2711.38461538462;107.538461538462
26072;2023;9;9;0;100;0;264788.555555556;2619.22222222222;100
26073;2023;2;2;0;100;0;474850;2913.5;157.5
26074;2023;16;9;7;56.25;43.75;210421.3125;2561.25;81.75
26075;2023;1;1;0;100;0;85000;2361;36
26076;2023;1;1;0;100;0;185310;1425;130
26077;2023;8;7;1;87.5;12.5;224006.25;2742.5;86.125
26078;2023;5;5;0;100;0;218678;2412;85.2
26079;2023;12;12;0;100;0;401510.833333333;3549.75;119.416666666667
26081;2023;5;5;0;100;0;410792.2;3284.4;125.4
26082;2023;1;1;0;100;0;290000;6905;42
26083;2023;13;12;1;92.3076923076923;7.69230769230769;237650;2280.92307692308;117.923076923077
26084;2023;26;26;0;100;0;330888.846153846;2879.84615384615;119.615384615385
26085;2023;25;23;2;92;8;234888.44;2436.6;96.6
26086;2023;14;10;4;71.4285714285714;28.5714285714286;164999.285714286;2302.92857142857;82
26087;2023;15;12;3;80;20;224183.2;2085.06666666667;111
26088;2023;53;47;6;88.6792452830189;11.3207547169811;267938.075471698;2760.1320754717;102.11320754717
26090;2023;1;1;0;100;0;266693;2381;112
26092;2023;11;6;5;54.5454545454545;45.4545454545455;213615.454545455;2024.09090909091;105.545454545455
26093;2023;5;3;2;60;40;410081;2945.8;146
26094;2023;5;5;0;100;0;273186;3061;88.4
26095;2023;5;5;0;100;0;269693;3098.8;99
26096;2023;26;23;3;88.4615384615385;11.5384615384615;225811.923076923;2250.26923076923;102.115384615385
26097;2023;8;8;0;100;0;273500;3127.375;95.375
26098;2023;2;2;0;100;0;643146.5;4747.5;127.5
26099;2023;8;8;0;100;0;329624.375;3276.75;98.25
26100;2023;6;6;0;100;0;282508.333333333;2384;132.166666666667
26102;2023;1;1;0;100;0;320000;3810;84
26103;2023;2;2;0;100;0;322250;3269;99
26104;2023;5;5;0;100;0;129272;2415;58.2
26105;2023;1;1;0;100;0;65000;1083;60
26106;2023;10;9;1;90;10;233778.5;2259.5;104.1
26107;2023;7;7;0;100;0;220628.571428571;1878.28571428571;113.285714285714
26108;2023;114;64;50;56.140350877193;43.859649122807;204894.263157895;2404.00877192982;83.9649122807018
26110;2023;2;2;0;100;0;262500;2335;114
26112;2023;2;2;0;100;0;171250;2877;60.5
26113;2023;54;32;22;59.2592592592593;40.7407407407407;208973.166666667;2474.44444444444;82.8703703703704
26114;2023;47;37;10;78.7234042553192;21.2765957446809;275116.70212766;3064.72340425532;92.0425531914894
26115;2023;6;6;0;100;0;241116.666666667;2137.66666666667;112.5
26116;2023;54;43;11;79.6296296296296;20.3703703703704;206904.055555556;2216.44444444444;93.1666666666667
26118;2023;11;11;0;100;0;217909.090909091;2228.27272727273;97.1818181818182
26119;2023;16;14;2;87.5;12.5;146048.4375;1911.0625;76.25
26121;2023;17;14;3;82.3529411764706;17.6470588235294;255880.470588235;2799.11764705882;91.3529411764706
26122;2023;3;3;0;100;0;233066;3442.33333333333;65.6666666666667
26124;2023;43;40;3;93.0232558139535;6.97674418604651;286582.558139535;2889.79069767442;101.860465116279
26125;2023;15;14;1;93.3333333333333;6.66666666666667;315041.6;2950;112.866666666667
26126;2023;2;2;0;100;0;150000;1799.5;68
26127;2023;2;2;0;100;0;360000;3777;93
26128;2023;1;1;0;100;0;185000;1968;94
26129;2023;7;6;1;85.7142857142857;14.2857142857143;148485.714285714;1711.28571428571;83.4285714285714
26131;2023;1;1;0;100;0;70000;2000;35
26133;2023;1;1;0;100;0;380000;3193;119
26134;2023;1;1;0;100;0;180000;1667;108
26135;2023;1;1;0;100;0;165000;2012;82
26136;2023;2;2;0;100;0;134500;2097;61.5
26137;2023;1;1;0;100;0;208500;3475;60
26138;2023;10;10;0;100;0;317996.5;2770.4;136.9
26139;2023;12;11;1;91.6666666666667;8.33333333333333;275681.666666667;2747.08333333333;98.5
26140;2023;6;6;0;100;0;356968.333333333;2867.83333333333;127
26141;2023;1;1;0;100;0;120000;706;170
26142;2023;2;2;0;100;0;307895;3429;65
26143;2023;16;16;0;100;0;161528.125;1651.625;93.875
26144;2023;19;19;0;100;0;363418.684210526;2948.89473684211;125.315789473684
26145;2023;5;5;0;100;0;240832.6;2376;107
26146;2023;18;16;2;88.8888888888889;11.1111111111111;417382.777777778;3591.22222222222;118.5
26148;2023;11;11;0;100;0;224563.636363636;2738.27272727273;82.6363636363636
26149;2023;13;9;4;69.2307692307692;30.7692307692308;252497.153846154;2594.69230769231;96.0769230769231
26152;2023;1;1;0;100;0;160000;1416;113
26154;2023;6;6;0;100;0;136171.666666667;1812.66666666667;86.1666666666667
26155;2023;8;8;0;100;0;256490;2704.625;98.125
26156;2023;5;5;0;100;0;273528;2530;108.2
26157;2023;4;4;0;100;0;178675;2095.75;85.25
26159;2023;4;4;0;100;0;186500;2556;70.25
26160;2023;14;12;2;85.7142857142857;14.2857142857143;219692.142857143;2361;90.1428571428571
26161;2023;1;1;0;100;0;52520;1221;43
26162;2023;5;4;1;80;20;172660;1386.4;126.8
26164;2023;1;1;0;100;0;150000;1500;100
26165;2023;106;72;34;67.9245283018868;32.0754716981132;196594.547169811;2207.52830188679;85.9528301886792
26166;2023;57;49;8;85.9649122807018;14.0350877192982;244937.912280702;2194.36842105263;110.438596491228
26167;2023;11;11;0;100;0;139013.636363636;1804.09090909091;78.9090909090909
26168;2023;14;8;6;57.1428571428571;42.8571428571429;150204.285714286;1974.35714285714;80.2142857142857
26169;2023;9;9;0;100;0;269672.222222222;2450;114.444444444444
26170;2023;25;25;0;100;0;295327.2;2577.76;114.2
26171;2023;5;5;0;100;0;175200;2441.2;75.6
26172;2023;8;7;1;87.5;12.5;159742.625;1752;91.75
26173;2023;4;4;0;100;0;295650;2984.75;98.5
26174;2023;11;10;1;90.9090909090909;9.09090909090909;278136;2522.36363636364;111.545454545455
26175;2023;2;2;0;100;0;302500;1873;162
26176;2023;12;12;0;100;0;281250.916666667;2875.66666666667;99.1666666666667
26177;2023;3;3;0;100;0;280166.666666667;2592.66666666667;107.333333333333
26178;2023;4;4;0;100;0;207422.5;2282.5;91.25
26179;2023;12;12;0;100;0;261505.416666667;2898.75;94.3333333333333
26180;2023;3;3;0;100;0;545916.666666667;4425;111.666666666667
26181;2023;5;5;0;100;0;131520;1617;76.6
26182;2023;15;14;1;93.3333333333333;6.66666666666667;430729;3471.2;122.6
26183;2023;5;5;0;100;0;272204;3262.4;81.6
26185;2023;8;7;1;87.5;12.5;380577.625;2832.75;135.625
26186;2023;1;1;0;100;0;75000;1500;50
26188;2023;35;26;9;74.2857142857143;25.7142857142857;242273.714285714;2856.57142857143;83.3428571428571
26189;2023;1;1;0;100;0;276385;1843;150
26190;2023;2;2;0;100;0;327500;2966.5;110
26191;2023;25;18;7;72;28;249899.04;2699.28;91.64
26192;2023;4;4;0;100;0;461512.5;2735.75;183.75
26193;2023;37;10;27;27.027027027027;72.972972972973;129396.459459459;2152.91891891892;58.3243243243243
26194;2023;4;4;0;100;0;311830;2910.5;106.75
26195;2023;3;3;0;100;0;427243.333333333;3567.33333333333;110.333333333333
26196;2023;7;7;0;100;0;351461.428571429;3028.42857142857;118.285714285714
26197;2023;21;21;0;100;0;374096.095238095;2937.71428571429;131.238095238095
26198;2023;558;230;328;41.2186379928315;58.7813620071685;189334.059139785;2240.81541218638;81.4982078853047
26200;2023;3;3;0;100;0;116333.333333333;1374.33333333333;83.3333333333333
26202;2023;6;6;0;100;0;250683.333333333;2373.5;98.5
26203;2023;4;4;0;100;0;378550;2892.25;132.5
26204;2023;2;2;0;100;0;294500;2993;100
26206;2023;20;16;4;80;20;278800.5;2975.15;100.95
26207;2023;8;8;0;100;0;215207;2123.5;110.125
26208;2023;12;11;1;91.6666666666667;8.33333333333333;353885.833333333;2923.75;114.583333333333
26209;2023;3;3;0;100;0;245000;3430;75
26210;2023;10;9;1;90;10;143400;1438.8;96.4
26211;2023;10;9;1;90;10;316958.2;2956.4;107.3
26212;2023;8;7;1;87.5;12.5;306566.25;2082.875;163.875
26213;2023;8;7;1;87.5;12.5;187300;1837.875;111.625
26215;2023;3;2;1;66.6666666666667;33.3333333333333;140900;2181;60
26216;2023;7;7;0;100;0;221228.571428571;2116.14285714286;104.428571428571
26218;2023;39;32;7;82.051282051282;17.9487179487179;274720.205128205;2909.66666666667;94.6666666666667
26220;2023;105;46;59;43.8095238095238;56.1904761904762;200564.276190476;2738.4380952381;76.1428571428571
26221;2023;2;2;0;100;0;123500;1548.5;87.5
26223;2023;6;6;0;100;0;209400;2122.83333333333;96.5
26224;2023;2;2;0;100;0;443372.5;3565.5;130
26225;2023;4;4;0;100;0;225125;2211;103
26226;2023;2;2;0;100;0;373000;3266.5;115
26229;2023;2;2;0;100;0;374695;2890.5;145
26231;2023;24;23;1;95.8333333333333;4.16666666666667;278327.375;2757.41666666667;104.958333333333
26232;2023;6;5;1;83.3333333333333;16.6666666666667;320971.666666667;2980.16666666667;124.333333333333
26234;2023;9;9;0;100;0;244566.666666667;2777.55555555556;96.8888888888889
26235;2023;151;97;54;64.2384105960265;35.7615894039735;178963.973509934;1998.94701986755;89.5960264900662
26236;2023;4;4;0;100;0;186381.25;2698.5;83.75
26238;2023;4;3;1;75;25;94325;1418.5;60.25
26239;2023;1;1;0;100;0;130000;3023;43
26242;2023;1;1;0;100;0;625000;5682;110
26243;2023;12;10;2;83.3333333333333;16.6666666666667;361972.5;3233.75;108.75
26244;2023;1;1;0;100;0;481755;3233;149
26245;2023;1;1;0;100;0;2,00E+05;1739;115
26246;2023;1;1;0;100;0;230000;2556;90
26247;2023;5;5;0;100;0;112640;1411.6;78.2
26248;2023;1;1;0;100;0;145000;2302;63
26249;2023;8;8;0;100;0;227443.875;2892.75;88.875
26250;2023;33;30;3;90.9090909090909;9.09090909090909;252582.393939394;2546.27272727273;101.454545454545
26251;2023;4;4;0;100;0;298745;2919.5;97.25
26252;2023;98;61;37;62.2448979591837;37.7551020408163;208917.193877551;2411.04081632653;86.530612244898
26253;2023;4;3;1;75;25;129815;1943.25;65
26256;2023;4;4;0;100;0;218654.25;3126;73
26257;2023;7;7;0;100;0;309763.571428571;2995.71428571429;105.142857142857
26258;2023;15;15;0;100;0;271970.666666667;2367.53333333333;111.266666666667
26259;2023;3;3;0;100;0;341300;3523.66666666667;96.3333333333333
26261;2023;7;7;0;100;0;233641.428571429;2877.57142857143;79.1428571428571
26262;2023;3;3;0;100;0;276466.666666667;3614.33333333333;81.6666666666667
26263;2023;1;1;0;100;0;265000;2789;95
26264;2023;2;2;0;100;0;97500;1042;92.5
26269;2023;1;1;0;100;0;651000;3741;174
26271;2023;24;21;3;87.5;12.5;268340;2756.83333333333;96.0833333333333
26272;2023;2;2;0;100;0;165000;1665.5;96.5
26273;2023;10;10;0;100;0;231255.4;2374.6;92.7
26275;2023;16;16;0;100;0;365059.375;3482.5625;108.6875
26276;2023;6;6;0;100;0;308362.666666667;2808.16666666667;117.833333333333
26277;2023;2;2;0;100;0;348200;2933;115
26278;2023;4;4;0;100;0;319907.5;3311;91.5
26279;2023;1;1;0;100;0;105000;1082;97
26281;2023;519;199;320;38.3429672447013;61.6570327552986;163274.148362235;2091.40269749518;77.626204238921
26282;2023;2;1;1;50;50;109500;2400;47.5
26283;2023;2;2;0;100;0;216501;2174.5;95.5
26284;2023;1;1;0;100;0;490790;4587;107
26285;2023;2;2;0;100;0;428350;4570.5;93.5
26286;2023;1;1;0;100;0;504660;4852;104
26287;2023;8;8;0;100;0;309253.75;3192.75;104.875
26288;2023;6;6;0;100;0;289669;3286.66666666667;91.1666666666667
26289;2023;12;11;1;91.6666666666667;8.33333333333333;228058.833333333;2584.08333333333;84.5
26290;2023;16;5;11;31.25;68.75;84854.375;2163.3125;38.3125
26291;2023;1;1;0;100;0;515000;2309;223
26292;2023;3;3;0;100;0;108570;2147.33333333333;50.6666666666667
26293;2023;4;4;0;100;0;316275;3156.75;99.75
26294;2023;6;6;0;100;0;342195;3131.83333333333;108.666666666667
26295;2023;17;16;1;94.1176470588235;5.88235294117647;190349.705882353;2005.23529411765;95.7058823529412
26296;2023;1;1;0;100;0;454250;5221;87
26298;2023;4;4;0;100;0;191360;1864.75;107.25
26301;2023;47;37;10;78.7234042553192;21.2765957446809;253696.063829787;2467.42553191489;99.6595744680851
26302;2023;5;5;0;100;0;250053;2105.4;122.2
26303;2023;1;1;0;100;0;182150;1584;115
26304;2023;1;1;0;100;0;181730;2423;75
26305;2023;17;16;1;94.1176470588235;5.88235294117647;259919.882352941;2641.05882352941;98.2352941176471
26306;2023;4;4;0;100;0;103750;1320.5;84.75
26307;2023;38;25;13;65.7894736842105;34.2105263157895;189060.157894737;2082.15789473684;86.5263157894737
26308;2023;1;1;0;100;0;236500;2599;91
26309;2023;1;1;0;100;0;165000;1375;120
26311;2023;10;9;1;90;10;194116.2;1840.1;103.8
26312;2023;9;8;1;88.8888888888889;11.1111111111111;275813.333333333;2556.66666666667;112.888888888889
26313;2023;46;41;5;89.1304347826087;10.8695652173913;294600.695652174;2720.82608695652;109.130434782609
26314;2023;4;4;0;100;0;234925;5611;63
26315;2023;7;5;2;71.4285714285714;28.5714285714286;187012.857142857;2270.28571428571;83.4285714285714
26316;2023;2;2;0;100;0;213630;2309;90.5
26317;2023;11;9;2;81.8181818181818;18.1818181818182;169028.181818182;2009.90909090909;82.3636363636364
26318;2023;1;1;0;100;0;145000;3222;45
26319;2023;3;2;1;66.6666666666667;33.3333333333333;211533.333333333;2191;93
26320;2023;11;11;0;100;0;216354.545454545;2023.72727272727;111.181818181818
26321;2023;4;4;0;100;0;123250;1968.75;65.75
26322;2023;8;5;3;62.5;37.5;244518.75;2511.875;94.625
26323;2023;15;14;1;93.3333333333333;6.66666666666667;258003.466666667;2458.6;108.933333333333
26324;2023;92;67;25;72.8260869565217;27.1739130434783;235299.336956522;2327.38043478261;99.5
26325;2023;55;49;6;89.0909090909091;10.9090909090909;198579.218181818;2108.81818181818;92.8545454545455
26326;2023;11;10;1;90.9090909090909;9.09090909090909;421495.454545455;3189.09090909091;132.090909090909
26327;2023;1;1;0;100;0;227500;1806;126
26328;2023;1;1;0;100;0;245000;2722;90
26329;2023;1;1;0;100;0;86002;1433;60
26330;2023;16;16;0;100;0;178695.625;2188.125;86.3125
26331;2023;1;1;0;100;0;319000;2774;115
26332;2023;30;26;4;86.6666666666667;13.3333333333333;208073;1925.76666666667;108.966666666667
26333;2023;51;16;35;31.3725490196078;68.6274509803922;102493.215686275;1430.66666666667;72.3921568627451
26334;2023;2;2;0;100;0;410000;4103.5;106
26335;2023;3;3;0;100;0;213433.333333333;2428.33333333333;88.3333333333333
26336;2023;5;5;0;100;0;590660;5004.6;119.4
26337;2023;21;15;6;71.4285714285714;28.5714285714286;178630.476190476;2196.52380952381;83.1428571428571
26338;2023;14;13;1;92.8571428571429;7.14285714285714;351630.428571429;2830.14285714286;119
26339;2023;3;3;0;100;0;247480;2327.66666666667;113.666666666667
26340;2023;5;5;0;100;0;157500;1607.6;101.8
26341;2023;8;8;0;100;0;173512.5;1541.5;117.375
26342;2023;4;4;0;100;0;281155;2885;96.25
26343;2023;1;1;0;100;0;95730;791;121
26344;2023;2;2;0;100;0;831930;5214;115
26345;2023;20;20;0;100;0;276510;2187.8;118.95
26346;2023;1;1;0;100;0;616000;2865;215
26347;2023;90;38;52;42.2222222222222;57.7777777777778;211666.4;2649.56666666667;83.6555555555556
26348;2023;30;27;3;90;10;232477;2320.6;103.5
26349;2023;5;5;0;100;0;259795.2;2372.6;104.8
26350;2023;1;1;0;100;0;45000;750;60
26351;2023;2;2;0;100;0;475000;5278;90
26352;2023;4;4;0;100;0;368962.5;2717.75;140.75
26353;2023;15;11;4;73.3333333333333;26.6666666666667;186033.333333333;2050.93333333333;90.7333333333333
26355;2023;5;5;0;100;0;244000;3052.2;88.4
26356;2023;3;3;0;100;0;336666.666666667;2433;138.333333333333
26357;2023;23;21;2;91.304347826087;8.69565217391304;287981.347826087;3014.82608695652;96
26358;2023;9;8;1;88.8888888888889;11.1111111111111;270558.333333333;2352.66666666667;113.333333333333
26360;2023;3;3;0;100;0;628637.333333333;3988.66666666667;153.666666666667
26361;2023;4;4;0;100;0;107250;2120.75;51
26362;2023;959;216;743;22.5234619395203;77.4765380604797;165700.321167883;2283.4275286757;72.5578727841502
26363;2023;1;1;0;100;0;122100;1650;74
26364;2023;3;1;2;33.3333333333333;66.6666666666667;237333.333333333;5638.33333333333;54.3333333333333
26365;2023;4;4;0;100;0;250250;2995;84.25
26367;2023;6;5;1;83.3333333333333;16.6666666666667;328833.333333333;2248.66666666667;128.166666666667
26368;2023;3;3;0;100;0;403333.333333333;2441;166
26370;2023;1;1;0;100;0;251000;4183;60
26372;2023;1;1;0;100;0;162000;2382;68
26373;2023;3;2;1;66.6666666666667;33.3333333333333;211000;2958.66666666667;73.6666666666667
26376;2023;1;1;0;100;0;212500;5060;42
26377;2023;10;9;1;90;10;460185.8;3593.1;131
26379;2023;8;8;0;100;0;222707.125;2102.5;111
26380;2023;1;1;0;100;0;190000;880;216
26381;2023;3;3;0;100;0;309633.333333333;2419.33333333333;124.666666666667
26382;2023;7;7;0;100;0;185656.428571429;2112.28571428571;80.7142857142857
27001;2023;5;5;0;100;0;149600;1448.4;98.6
27002;2023;9;9;0;100;0;175383.333333333;1939.66666666667;97.1111111111111
27003;2023;19;17;2;89.4736842105263;10.5263157894737;198984.210526316;2177.73684210526;91.2631578947368
27004;2023;2;2;0;100;0;92500;1134;117
27005;2023;10;10;0;100;0;221120;1985.2;107.3
27006;2023;6;6;0;100;0;220558.333333333;2405.83333333333;90.1666666666667
27008;2023;13;13;0;100;0;202153.230769231;2436.92307692308;81.5384615384615
27009;2023;10;10;0;100;0;134735.5;1709.9;83.1
27010;2023;1;1;0;100;0;99000;3536;28
27011;2023;15;14;1;93.3333333333333;6.66666666666667;195846;2443.33333333333;83.2666666666667
27012;2023;5;5;0;100;0;247640;1777.8;140.2
27013;2023;6;6;0;100;0;139390;1689.33333333333;74.5
27014;2023;5;5;0;100;0;161100;2026.8;81.2
27015;2023;12;12;0;100;0;227995.833333333;2541.58333333333;98.6666666666667
27016;2023;81;65;16;80.2469135802469;19.7530864197531;163708.864197531;1910.34567901235;86.358024691358
27017;2023;15;15;0;100;0;187108.8;1992.26666666667;97
27018;2023;14;14;0;100;0;153886.428571429;2085.35714285714;75.5
27019;2023;4;4;0;100;0;229310;2148.25;113.75
27020;2023;19;19;0;100;0;199880.210526316;2016.63157894737;99.1052631578947
27021;2023;8;8;0;100;0;214164.25;2197.25;95.5
27022;2023;36;35;1;97.2222222222222;2.77777777777778;189386.111111111;2154.16666666667;90.3611111111111
27023;2023;5;5;0;100;0;216860;2399.2;95.4
27025;2023;12;12;0;100;0;241690.583333333;2328.66666666667;114.916666666667
27026;2023;3;2;1;66.6666666666667;33.3333333333333;237315;1990;126.333333333333
27027;2023;1;1;0;100;0;261900;2095;125
27028;2023;7;7;0;100;0;173098.571428571;1473.42857142857;115.714285714286
27031;2023;8;8;0;100;0;238375;2141.75;114.125
27032;2023;14;14;0;100;0;173953.571428571;1719.71428571429;103.214285714286
27033;2023;2;2;0;100;0;172000;1934;89
27034;2023;10;10;0;100;0;181544;2667;77.8
27035;2023;1;1;0;100;0;50000;1064;47
27036;2023;5;5;0;100;0;192200;2066.2;93.4
27037;2023;10;10;0;100;0;149185;1842.8;86.4
27038;2023;4;4;0;100;0;172125;2130.5;91.5
27039;2023;4;4;0;100;0;198300;1596.5;126.75
27040;2023;4;4;0;100;0;114837.5;1448.25;76.25
27043;2023;14;14;0;100;0;206460.714285714;1857.07142857143;109.857142857143
27044;2023;11;11;0;100;0;244131.818181818;1987.72727272727;119
27045;2023;8;8;0;100;0;183787.5;2254.625;84.875
27046;2023;5;5;0;100;0;240439;2170.6;119
27047;2023;4;4;0;100;0;204500;1472;137.25
27048;2023;3;3;0;100;0;288600;2552.33333333333;113.333333333333
27049;2023;81;81;0;100;0;149693.086419753;1709.50617283951;91.4938271604938
27050;2023;9;9;0;100;0;195166.666666667;1824.77777777778;100.888888888889
27051;2023;33;32;1;96.969696969697;3.03030303030303;161101.212121212;1694.09090909091;95.3636363636364
27052;2023;1;1;0;100;0;439850;2221;198
27054;2023;5;5;0;100;0;99200;1780.2;60
27055;2023;5;5;0;100;0;169818;1824.6;96
27056;2023;139;103;36;74.1007194244604;25.8992805755396;161751.086330935;2084.58273381295;78.7122302158273
27057;2023;3;3;0;100;0;220968.666666667;2357.33333333333;99.6666666666667
27058;2023;11;11;0;100;0;220082.727272727;2417.18181818182;96.5454545454545
27059;2023;3;3;0;100;0;206333.333333333;2570;86
27061;2023;7;7;0;100;0;146071.428571429;1689.14285714286;87
27062;2023;23;23;0;100;0;225453.913043478;1980.78260869565;116.652173913043
27063;2023;3;3;0;100;0;237500;1905.66666666667;112.333333333333
27064;2023;13;12;1;92.3076923076923;7.69230769230769;181461.538461538;1884.07692307692;92.3846153846154
27065;2023;86;56;30;65.1162790697674;34.8837209302326;192305.069767442;2190.24418604651;83.6046511627907
27066;2023;2;2;0;100;0;92750;2592;32
27067;2023;18;18;0;100;0;226018.388888889;2377.22222222222;94.5555555555556
27068;2023;1;1;0;100;0;92500;995;93
27069;2023;7;7;0;100;0;125335.714285714;1743.57142857143;74.7142857142857
27070;2023;13;13;0;100;0;295561.538461538;2416.07692307692;111.769230769231
27072;2023;3;3;0;100;0;212333.333333333;1930.66666666667;113
27073;2023;19;19;0;100;0;182049.473684211;1849.47368421053;100.526315789474
27074;2023;7;7;0;100;0;184285.714285714;1701;109.857142857143
27075;2023;2;2;0;100;0;157500;1532;97
27076;2023;5;5;0;100;0;197530;2629.6;80.6
27077;2023;9;9;0;100;0;173327.777777778;2194.44444444444;81.8888888888889
27078;2023;1;1;0;100;0;239000;1992;120
27079;2023;1;1;0;100;0;149500;1738;86
27081;2023;2;2;0;100;0;607307.5;4028;175
27082;2023;29;28;1;96.551724137931;3.44827586206897;164675.172413793;2211.37931034483;78.1724137931034
27083;2023;4;4;0;100;0;203000;1927.25;108.75
27085;2023;14;14;0;100;0;262935;1975.92857142857;137.071428571429
27089;2023;11;11;0;100;0;220730;1835;122.636363636364
27090;2023;36;36;0;100;0;217813.333333333;1985.86111111111;114.083333333333
27091;2023;8;8;0;100;0;244387.5;2742.125;98.875
27094;2023;3;3;0;100;0;226000;2867;71.3333333333333
27095;2023;10;10;0;100;0;197350;2118.8;94.3
27096;2023;12;12;0;100;0;187463.333333333;2153.58333333333;87
27097;2023;7;7;0;100;0;230621.428571429;2593.42857142857;96
27098;2023;2;2;0;100;0;192085;1951.5;100.5
27099;2023;8;8;0;100;0;231962.5;2329;100.375
27100;2023;11;8;3;72.7272727272727;27.2727272727273;242780.545454545;2256.72727272727;100.454545454545
27101;2023;3;3;0;100;0;136825;2216.33333333333;67
27102;2023;11;11;0;100;0;172124.545454545;1904.54545454545;93.8181818181818
27103;2023;36;34;2;94.4444444444444;5.55555555555556;220756.944444444;2440.19444444444;92.6388888888889
27104;2023;8;8;0;100;0;146700.625;1443.75;106
27105;2023;37;31;6;83.7837837837838;16.2162162162162;189936.486486486;2209.81081081081;90.3513513513514
27106;2023;11;11;0;100;0;200268.181818182;2330.18181818182;90.7272727272727
27107;2023;16;15;1;93.75;6.25;169537.5;1682.375;104.875
27108;2023;18;18;0;100;0;134916.111111111;1673;85
27109;2023;6;6;0;100;0;166566.666666667;2143.33333333333;76.5
27110;2023;7;7;0;100;0;170634.285714286;1964.28571428571;97.4285714285714
27111;2023;5;5;0;100;0;429108;3096.6;145
27112;2023;56;55;1;98.2142857142857;1.78571428571429;134649.928571429;1626.98214285714;84.1607142857143
27114;2023;14;13;1;92.8571428571429;7.14285714285714;220573.214285714;2264.92857142857;100.785714285714
27115;2023;5;5;0;100;0;225760;2457;99.4
27116;2023;52;47;5;90.3846153846154;9.61538461538462;140782.307692308;1600.42307692308;88.4807692307692
27117;2023;14;14;0;100;0;98535.7142857143;1478.92857142857;73.7142857142857
27118;2023;4;4;0;100;0;253445;2322.75;105.5
27119;2023;24;24;0;100;0;198627.333333333;2559.04166666667;79.75
27120;2023;3;3;0;100;0;161800;1478.66666666667;105.333333333333
27123;2023;8;6;2;75;25;352324.75;2694.25;122.875
27124;2023;2;2;0;100;0;187500;2346.5;79.5
27125;2023;5;5;0;100;0;209310;1884.8;97
27126;2023;23;23;0;100;0;205292.869565217;2024.4347826087;100.739130434783
27127;2023;5;5;0;100;0;229400;1920.4;126.8
27129;2023;5;5;0;100;0;238458;1866.2;117.2
27130;2023;3;3;0;100;0;122333.333333333;1317.33333333333;94.6666666666667
27132;2023;8;8;0;100;0;180064.5;1748.625;102
27133;2023;14;14;0;100;0;246542.071428571;1984.14285714286;120.428571428571
27134;2023;1;1;0;100;0;77200;1170;66
27135;2023;4;4;0;100;0;167500;1889;96.25
27136;2023;2;2;0;100;0;548490;2534;212.5
27137;2023;4;4;0;100;0;113750;1103.25;105
27138;2023;3;3;0;100;0;156666.666666667;1894.33333333333;96.6666666666667
27139;2023;3;3;0;100;0;65000;1085.66666666667;61.3333333333333
27140;2023;4;4;0;100;0;336345;3714.25;101.25
27142;2023;1;1;0;100;0;276500;2266;122
27144;2023;2;2;0;100;0;187500;1679;114.5
27146;2023;4;4;0;100;0;148125;1620;86.75
27147;2023;8;8;0;100;0;219012.5;2008.875;108.75
27148;2023;4;4;0;100;0;140093.75;1838.75;79.5
27149;2023;3;3;0;100;0;120000;1647.66666666667;75.6666666666667
27151;2023;14;14;0;100;0;163035.714285714;1696.5;98.8571428571429
27152;2023;8;4;4;50;50;226025;2364.625;104.5
27153;2023;2;2;0;100;0;229762;1947.5;119
27154;2023;13;13;0;100;0;169736.923076923;2073.38461538462;94.5384615384615
27155;2023;2;2;0;100;0;223000;2302;115.5
27156;2023;6;6;0;100;0;150573.333333333;1674.83333333333;94
27157;2023;12;12;0;100;0;154655;1699.33333333333;88.5
27158;2023;10;10;0;100;0;226460;2447.2;97.4
27161;2023;7;7;0;100;0;206414.285714286;1788.14285714286;117
27162;2023;2;2;0;100;0;134000;1744;72.5
27164;2023;13;13;0;100;0;191760.769230769;1937.92307692308;102.461538461538
27165;2023;56;49;7;87.5;12.5;153428.928571429;1819.60714285714;89.6071428571429
27167;2023;6;6;0;100;0;169515.666666667;1742.83333333333;90.3333333333333
27168;2023;2;2;0;100;0;290400;3835;77
27169;2023;17;17;0;100;0;269473.529411765;2387.88235294118;112.176470588235
27170;2023;20;19;1;95;5;188454.75;2195.05;90.65
27171;2023;4;4;0;100;0;222387.5;2285.75;102.75
27173;2023;1;1;0;100;0;115500;1627;71
27174;2023;14;14;0;100;0;179985.714285714;1692.28571428571;104
27176;2023;2;2;0;100;0;240940;4712;71
27177;2023;6;6;0;100;0;179750;1852.33333333333;107.833333333333
27179;2023;16;16;0;100;0;242934.375;2289.875;110.75
27180;2023;30;29;1;96.6666666666667;3.33333333333333;203698.4;2087.5;101.5
27181;2023;5;5;0;100;0;207636;2296.2;91.8
27183;2023;30;29;1;96.6666666666667;3.33333333333333;197069.2;2346.23333333333;88.2666666666667
27184;2023;2;2;0;100;0;247500;3465;81
27185;2023;8;8;0;100;0;202062.5;1821.25;114.625
27187;2023;4;4;0;100;0;205100.25;2146.5;95.75
27188;2023;13;13;0;100;0;233930.769230769;2094.76923076923;106.615384615385
27189;2023;3;3;0;100;0;189650;1958.33333333333;96.6666666666667
27190;2023;3;3;0;100;0;230333.333333333;2213;98.6666666666667
27191;2023;27;27;0;100;0;210357.407407407;2062.40740740741;102.37037037037
27192;2023;8;8;0;100;0;191385.125;2330.625;84.625
27193;2023;13;13;0;100;0;164250;1895;88
27194;2023;4;4;0;100;0;169500;2540;72.75
27196;2023;12;10;2;83.3333333333333;16.6666666666667;201500;2509.33333333333;82.0833333333333
27198;2023;72;69;3;95.8333333333333;4.16666666666667;166093.972222222;1738.77777777778;97.0555555555556
27199;2023;8;8;0;100;0;213379.625;2618.25;83.875
27200;2023;3;3;0;100;0;231666.666666667;2158.33333333333;112
27201;2023;1;1;0;100;0;60840;790;77
27202;2023;8;8;0;100;0;197093.75;2011.625;95.25
27203;2023;5;5;0;100;0;461000;5018.2;114.6
27204;2023;4;4;0;100;0;322073;2523.5;131.25
27205;2023;9;7;2;77.7777777777778;22.2222222222222;124222.222222222;1684.22222222222;80.3333333333333
27206;2023;8;8;0;100;0;152375;1681.5;92.375
27207;2023;3;3;0;100;0;123473.333333333;1512.66666666667;102
27208;2023;2;2;0;100;0;145000;1742.5;85.5
27209;2023;4;4;0;100;0;123992.5;1656.25;92.25
27210;2023;8;8;0;100;0;185187.5;2046.125;99.75
27213;2023;68;67;1;98.5294117647059;1.47058823529412;241429.382352941;2374.82352941176;104.573529411765
27214;2023;6;6;0;100;0;214166.666666667;2304.83333333333;84.8333333333333
27215;2023;3;3;0;100;0;194800;1763.66666666667;114
27216;2023;10;10;0;100;0;233693;2049.8;117.5
27217;2023;4;4;0;100;0;166375;1869.25;89.5
27218;2023;23;22;1;95.6521739130435;4.34782608695652;203126.913043478;2216.21739130435;92.6521739130435
27219;2023;6;6;0;100;0;146166.666666667;1791.16666666667;83.3333333333333
27220;2023;4;4;0;100;0;232362.5;2256.75;107.25
27222;2023;2;2;0;100;0;197400;1668.5;124.5
27224;2023;6;6;0;100;0;155450;1748.16666666667;98.3333333333333
27226;2023;39;36;3;92.3076923076923;7.69230769230769;171737.41025641;1992.35897435897;92.6410256410256
27227;2023;3;3;0;100;0;173150;1938.33333333333;90.6666666666667
27228;2023;4;4;0;100;0;214350;1844;124
27229;2023;604;233;371;38.5761589403974;61.4238410596026;137415.917218543;2013.17218543046;69.6639072847682
27230;2023;54;45;9;83.3333333333333;16.6666666666667;194546.055555556;2255.81481481481;94.7962962962963
27231;2023;5;5;0;100;0;339450;2682.8;126.2
27232;2023;5;5;0;100;0;154008;1915.4;75.2
27233;2023;12;12;0;100;0;327414.833333333;3058.66666666667;111.416666666667
27234;2023;4;4;0;100;0;173364.5;2119;80
27235;2023;1;1;0;100;0;135000;1125;120
27237;2023;2;2;0;100;0;176500;1807.5;96.5
27238;2023;10;10;0;100;0;241455.8;2069;117.1
27239;2023;7;7;0;100;0;212571.428571429;2092.42857142857;109
27240;2023;6;6;0;100;0;238250;2096.66666666667;114.5
27241;2023;3;3;0;100;0;187833.333333333;1707.33333333333;111.333333333333
27242;2023;19;19;0;100;0;167192.105263158;1786.42105263158;100.947368421053
27243;2023;7;7;0;100;0;290142.857142857;3535.14285714286;83.5714285714286
27245;2023;5;5;0;100;0;168900;1956.8;91.6
27246;2023;18;18;0;100;0;153444.444444444;1787.27777777778;95.4444444444444
27247;2023;4;4;0;100;0;139100;1763;78
27248;2023;3;3;0;100;0;130166.666666667;1931.66666666667;67.6666666666667
27249;2023;11;11;0;100;0;260818.181818182;2296;113.636363636364
27251;2023;7;7;0;100;0;151885.714285714;1858.71428571429;86.8571428571429
27252;2023;2;2;0;100;0;309000;1670.5;174
27254;2023;10;10;0;100;0;394135;2817.4;139.4
27256;2023;4;4;0;100;0;197431.25;1750.75;113.5
27258;2023;7;7;0;100;0;279919.714285714;3277.14285714286;95.7142857142857
27259;2023;4;4;0;100;0;180250;1541.25;118.5
27260;2023;4;4;0;100;0;235000;2347.75;100.75
27261;2023;3;3;0;100;0;164500;2495.33333333333;68
27263;2023;21;21;0;100;0;224802.142857143;1918.14285714286;119.238095238095
27266;2023;3;3;0;100;0;198333.333333333;1838.66666666667;111.666666666667
27267;2023;3;3;0;100;0;194633.333333333;1649.33333333333;112
27269;2023;3;3;0;100;0;116980;1736.33333333333;69.6666666666667
27273;2023;4;4;0;100;0;239313;2056;120
27275;2023;83;36;47;43.3734939759036;56.6265060240964;147210.975903614;1863.06024096386;75.7831325301205
27276;2023;6;6;0;100;0;155941.666666667;1504.83333333333;102.166666666667
27277;2023;8;8;0;100;0;210242.5;2064.875;106.25
27278;2023;19;19;0;100;0;214268.421052632;2230.47368421053;98
27279;2023;27;22;5;81.4814814814815;18.5185185185185;189433.888888889;2129.11111111111;86.8888888888889
27280;2023;11;11;0;100;0;170059.090909091;2089.45454545455;82.9090909090909
27281;2023;5;5;0;100;0;203700;2769.2;101.4
27282;2023;8;8;0;100;0;204000;1820.75;117.5
27284;2023;116;70;46;60.3448275862069;39.6551724137931;197872.887931034;2553.02586206897;79.8103448275862
27285;2023;5;5;0;100;0;373772.2;3485.6;113
27286;2023;1;1;0;100;0;214300;1948;110
27287;2023;7;7;0;100;0;207857.142857143;2088.28571428571;102
27288;2023;3;3;0;100;0;169000;1702.66666666667;92
27289;2023;3;3;0;100;0;273833.333333333;2983.66666666667;97.6666666666667
27290;2023;14;14;0;100;0;188581.071428571;1889.71428571429;103.857142857143
27291;2023;1;1;0;100;0;286500;1736;165
27294;2023;18;18;0;100;0;179886.111111111;1746.38888888889;108.833333333333
27295;2023;8;8;0;100;0;119187.5;1162.625;98.625
27298;2023;7;7;0;100;0;182142.857142857;1746.57142857143;114.857142857143
27299;2023;44;34;10;77.2727272727273;22.7272727272727;168233.181818182;2100.70454545455;79.75
27300;2023;8;8;0;100;0;123812.5;1582.375;81.125
27301;2023;11;11;0;100;0;219165.454545455;2153.54545454545;108
27302;2023;18;18;0;100;0;199941.666666667;2004.27777777778;103.111111111111
27306;2023;32;32;0;100;0;190069.59375;2093.15625;92.75
27307;2023;5;5;0;100;0;239800;2219.2;112.2
27309;2023;4;4;0;100;0;234137.5;2571;91.5
27310;2023;7;7;0;100;0;155814.285714286;2034.14285714286;82.5714285714286
27311;2023;5;5;0;100;0;133050;1953.4;62.6
27312;2023;5;5;0;100;0;268883.6;3061;92.8
27313;2023;4;4;0;100;0;236637.5;2445.75;97.75
27315;2023;4;4;0;100;0;146875;1627.75;91.75
27316;2023;12;12;0;100;0;236670.833333333;2473.41666666667;103.25
27317;2023;3;3;0;100;0;123800;1676.33333333333;73.6666666666667
27318;2023;1;1;0;100;0;177000;1416;125
27319;2023;5;5;0;100;0;197760;2327.2;87.4
27320;2023;5;5;0;100;0;195400;1890.4;117.2
27322;2023;17;17;0;100;0;182352.941176471;2356.23529411765;88.5882352941177
27323;2023;4;4;0;100;0;154500;1824.75;91
27324;2023;8;8;0;100;0;191825;2275.25;92.75
27326;2023;6;6;0;100;0;274215.166666667;2420.66666666667;114.666666666667
27327;2023;2;2;0;100;0;225000;1728.5;132
27329;2023;11;11;0;100;0;165981.818181818;1994;86.0909090909091
27330;2023;1;1;0;100;0;160000;2623;61
27331;2023;8;8;0;100;0;213201.25;1902;107.75
27332;2023;4;4;0;100;0;213737.5;2829.75;75.5
27333;2023;5;5;0;100;0;190501;1891.8;100.2
27334;2023;1;1;0;100;0;260000;3768;69
27335;2023;11;11;0;100;0;239272.727272727;2216.36363636364;109.272727272727
27336;2023;5;5;0;100;0;290372;2537.8;113.4
27337;2023;1;1;0;100;0;225100;2501;90
27338;2023;9;9;0;100;0;188932;2042.77777777778;90.5555555555556
27339;2023;11;11;0;100;0;217336.363636364;2210.45454545455;98.3636363636364
27340;2023;6;6;0;100;0;285983.333333333;2389.83333333333;119.333333333333
27343;2023;18;17;1;94.4444444444444;5.55555555555556;366737.055555556;2612.22222222222;138.722222222222
27345;2023;5;5;0;100;0;268341;2480.8;114.2
27346;2023;2;2;0;100;0;190500;2485.5;77
27347;2023;5;5;0;100;0;243500;2369.4;103.8
27348;2023;16;16;0;100;0;211037.5;2135.3125;99.375
27349;2023;9;9;0;100;0;211711.111111111;1719.11111111111;124.333333333333
27350;2023;14;14;0;100;0;244792.857142857;1890.92857142857;138
27351;2023;12;10;2;83.3333333333333;16.6666666666667;187966.666666667;2216.33333333333;86.1666666666667
27353;2023;3;3;0;100;0;316833.333333333;2225.33333333333;140.333333333333
27354;2023;3;3;0;100;0;164666.666666667;1539;108.666666666667
27355;2023;47;35;12;74.468085106383;25.531914893617;180895.446808511;2322.55319148936;79
27358;2023;2;2;0;100;0;270000;2912;104
27359;2023;6;6;0;100;0;146666.666666667;1847;84.6666666666667
27360;2023;5;5;0;100;0;192300;1996.2;91.4
27361;2023;5;5;0;100;0;200247.6;2349.2;84.8
27363;2023;2;2;0;100;0;122500;1427;85
27364;2023;3;3;0;100;0;111066.666666667;1405.66666666667;79.3333333333333
27365;2023;13;13;0;100;0;182615.384615385;1720.92307692308;120.692307692308
27367;2023;20;20;0;100;0;210241.15;2085.25;106
27368;2023;4;4;0;100;0;166750;1795;93.75
27369;2023;2;2;0;100;0;95000;1064;99
27370;2023;5;5;0;100;0;121200;1388.2;93.2
27371;2023;1;1;0;100;0;160000;1649;97
27372;2023;6;6;0;100;0;179366.666666667;2239.66666666667;76.3333333333333
27373;2023;4;4;0;100;0;264875;2267;115.25
27374;2023;4;4;0;100;0;266822.5;1586.75;161.75
27375;2023;207;139;68;67.1497584541063;32.8502415458937;165215.072463768;2177.33816425121;79.4154589371981
27376;2023;1;1;0;100;0;615800;5132;120
27377;2023;15;15;0;100;0;213057.666666667;2160.06666666667;87.2666666666667
27378;2023;15;15;0;100;0;167021.333333333;1965.33333333333;89.9333333333333
27379;2023;6;6;0;100;0;183353.333333333;2185;88.6666666666667
27380;2023;1;1;0;100;0;200500;2475;81
27381;2023;3;3;0;100;0;222666.666666667;2411;95.3333333333333
27382;2023;6;6;0;100;0;271608.333333333;2148.66666666667;130.833333333333
27383;2023;11;11;0;100;0;177859.090909091;1660.27272727273;117.181818181818
27384;2023;9;9;0;100;0;301555.555555556;2567.22222222222;122.555555555556
27385;2023;14;14;0;100;0;186492.642857143;1945.78571428571;95.7857142857143
27386;2023;14;14;0;100;0;142400;1894.64285714286;75.7857142857143
27388;2023;9;9;0;100;0;201757.777777778;1943.11111111111;103.111111111111
27389;2023;3;3;0;100;0;215000;1950.66666666667;102.333333333333
27390;2023;11;11;0;100;0;214212.727272727;1977;112.454545454545
27391;2023;18;18;0;100;0;182941.444444444;2005.5;99.6111111111111
27392;2023;6;6;0;100;0;222463.833333333;1985.66666666667;110.5
27393;2023;6;6;0;100;0;262983.333333333;2457.83333333333;109.333333333333
27394;2023;5;5;0;100;0;157420;1744.2;93.4
27395;2023;4;4;0;100;0;256450;1735.5;130.75
27396;2023;5;5;0;100;0;195600;1692.2;118.8
27397;2023;15;14;1;93.3333333333333;6.66666666666667;189500;2496.66666666667;81.6
27398;2023;22;22;0;100;0;194523.181818182;2022.63636363636;100.454545454545
27399;2023;2;2;0;100;0;161500;1800.5;91.5
27400;2023;9;9;0;100;0;401883.222222222;2712.66666666667;141.444444444444
27401;2023;2;2;0;100;0;147700;1661.5;90
27403;2023;2;2;0;100;0;158000;1625;93.5
27404;2023;1;1;0;100;0;150000;1579;95
27405;2023;1;1;0;100;0;115000;2614;44
27406;2023;17;15;2;88.2352941176471;11.7647058823529;200184.470588235;2537.94117647059;90.0588235294118
27407;2023;2;2;0;100;0;211000;2101;103.5
27408;2023;7;7;0;100;0;252142.857142857;2752.28571428571;99.8571428571429
27410;2023;3;3;0;100;0;287666.666666667;2973.33333333333;101
27411;2023;3;3;0;100;0;164666.666666667;1961.33333333333;88.3333333333333
27412;2023;15;15;0;100;0;263466.666666667;2127.66666666667;127.333333333333
27413;2023;9;8;1;88.8888888888889;11.1111111111111;167000;2140.77777777778;88.2222222222222
27414;2023;9;9;0;100;0;229322.222222222;2117.22222222222;117
27415;2023;6;5;1;83.3333333333333;16.6666666666667;285470;2870.33333333333;113.833333333333
27417;2023;12;12;0;100;0;198330.416666667;2174.08333333333;96.3333333333333
27419;2023;4;4;0;100;0;133800;1611;84.5
27420;2023;2;2;0;100;0;100130;3522;37
27421;2023;6;6;0;100;0;216550;2215.83333333333;97
27422;2023;8;8;0;100;0;180747.5;2685.75;72
27423;2023;9;9;0;100;0;236574.444444444;3034.11111111111;74.2222222222222
27424;2023;3;3;0;100;0;168333.333333333;1341;121
27425;2023;27;26;1;96.2962962962963;3.7037037037037;144990.814814815;1658.74074074074;86.8518518518518
27426;2023;18;17;1;94.4444444444444;5.55555555555556;215490.555555556;2452.66666666667;94.2222222222222
27427;2023;9;9;0;100;0;123055.555555556;1249;101.555555555556
27428;2023;44;32;12;72.7272727272727;27.2727272727273;186768.636363636;2260.40909090909;83.5909090909091
27429;2023;1;1;0;100;0;249900;1785;140
27430;2023;2;2;0;100;0;193200;1322;147
27431;2023;15;14;1;93.3333333333333;6.66666666666667;103466.666666667;1060.13333333333;98.4
27432;2023;7;7;0;100;0;188100;2063.71428571429;98.1428571428571
27433;2023;3;3;0;100;0;148900;1151.66666666667;137.666666666667
27435;2023;5;5;0;100;0;184000;2239.6;87.8
27436;2023;3;3;0;100;0;166100;1953;92.6666666666667
27437;2023;6;6;0;100;0;218345.833333333;1750.66666666667;133.166666666667
27438;2023;23;19;4;82.6086956521739;17.3913043478261;141922.173913043;1886.86956521739;75.7391304347826
27439;2023;12;12;0;100;0;258258.333333333;2607.33333333333;101.166666666667
27440;2023;8;8;0;100;0;296542;2186.875;141.625
27442;2023;8;8;0;100;0;87562.5;1599;57.625
27444;2023;4;4;0;100;0;194000;2147.25;98.25
27445;2023;2;2;0;100;0;211800;2538.5;86
27446;2023;3;3;0;100;0;166666.666666667;1794.33333333333;93.3333333333333
27447;2023;6;6;0;100;0;223125;1918.5;121.833333333333
27448;2023;49;46;3;93.8775510204082;6.12244897959184;258676.12244898;2836.32653061224;92.0408163265306
27451;2023;3;3;0;100;0;153333.333333333;2062;72.6666666666667
27453;2023;18;18;0;100;0;124588.888888889;1587.05555555556;81.5555555555556
27454;2023;8;8;0;100;0;174050;1808.25;95
27455;2023;2;2;0;100;0;366250;2357;150
27456;2023;12;12;0;100;0;199520.833333333;2191.83333333333;92.8333333333333
27457;2023;11;11;0;100;0;195669.454545455;1865.45454545455;111.090909090909
27458;2023;26;26;0;100;0;197878.461538462;2008.23076923077;102.461538461538
27460;2023;3;3;0;100;0;168333.333333333;1820;92.3333333333333
27462;2023;1;1;0;100;0;18000;409;44
27463;2023;11;11;0;100;0;201524.545454545;1972.90909090909;105.181818181818
27464;2023;12;12;0;100;0;232708.333333333;2035.25;116.833333333333
27465;2023;4;4;0;100;0;290912.5;2322.25;115.5
27466;2023;7;7;0;100;0;158857.142857143;1742.57142857143;91.5714285714286
27467;2023;137;99;38;72.2627737226277;27.7372262773723;166938.343065693;2135.84671532847;80.8248175182482
27468;2023;10;10;0;100;0;132312.5;1692.5;79.2
27469;2023;46;42;4;91.304347826087;8.69565217391304;186518.02173913;2134.52173913043;90.8913043478261
27470;2023;13;12;1;92.3076923076923;7.69230769230769;151353.846153846;1888.61538461538;80.9230769230769
27471;2023;1;1;0;100;0;250000;2232;112
27473;2023;14;14;0;100;0;212421.357142857;2188.21428571429;97.5
27474;2023;16;16;0;100;0;200337.5;2319.5625;82.5
27475;2023;3;3;0;100;0;98333.3333333333;1786.33333333333;55.6666666666667
27476;2023;1;1;0;100;0;324000;2700;120
27477;2023;5;5;0;100;0;360230;2753.2;141
27478;2023;7;7;0;100;0;216112;2394.57142857143;91.8571428571429
27480;2023;10;10;0;100;0;152060.5;1906.6;79.3
27481;2023;5;5;0;100;0;229400;2286.2;105.4
27483;2023;9;9;0;100;0;206744.444444444;1872.33333333333;115.111111111111
27485;2023;7;7;0;100;0;115431.428571429;1328;88.7142857142857
27486;2023;9;8;1;88.8888888888889;11.1111111111111;210590;2244.55555555556;97.1111111111111
27487;2023;12;12;0;100;0;202007.5;1939.16666666667;114.583333333333
27488;2023;2;2;0;100;0;208200;1992;105.5
27489;2023;7;7;0;100;0;262027.285714286;2200.42857142857;120.428571428571
27490;2023;4;4;0;100;0;112585;1364.75;88.25
27492;2023;3;3;0;100;0;244805.666666667;1705.33333333333;140.666666666667
27493;2023;37;36;1;97.2972972972973;2.7027027027027;170127.837837838;2059.16216216216;84.4054054054054
27495;2023;5;5;0;100;0;211800;2131;102.2
27496;2023;10;10;0;100;0;132000;1394.7;94.4
27497;2023;11;11;0;100;0;164970.909090909;1802.72727272727;97
27498;2023;4;4;0;100;0;189856.25;1736.5;110
27500;2023;24;22;2;91.6666666666667;8.33333333333333;167085.333333333;2302.41666666667;83.5416666666667
27501;2023;1;1;0;100;0;404500;2697;150
27502;2023;29;28;1;96.551724137931;3.44827586206897;124660.344827586;1381.62068965517;85.8965517241379
27504;2023;22;22;0;100;0;197488.954545455;2023.36363636364;101.727272727273
27505;2023;2;2;0;100;0;179500;1374;131
27507;2023;34;34;0;100;0;190293.235294118;2198.47058823529;93.9705882352941
27508;2023;4;4;0;100;0;174587.5;1432.25;114.5
27511;2023;6;6;0;100;0;151650;1793.66666666667;89
27512;2023;3;3;0;100;0;269400;2899.33333333333;103.666666666667
27514;2023;7;7;0;100;0;210735.714285714;1842.57142857143;118.285714285714
27516;2023;9;9;0;100;0;250072.222222222;2167.88888888889;123.333333333333
27517;2023;16;16;0;100;0;215425.6875;2169;104.375
27518;2023;8;8;0;100;0;142575;1594.375;94.125
27520;2023;3;3;0;100;0;105000;1184.66666666667;94.3333333333333
27521;2023;1;1;0;100;0;73250;610;120
27522;2023;6;6;0;100;0;231093.333333333;1747.83333333333;125
27524;2023;19;19;0;100;0;161567.631578947;1980;84.8421052631579
27525;2023;6;6;0;100;0;220166.666666667;1718;124.833333333333
27528;2023;47;39;8;82.9787234042553;17.0212765957447;242764.680851064;2333.55319148936;102.425531914894
27529;2023;5;5;0;100;0;411400;2458.2;171
27531;2023;3;3;0;100;0;222983.333333333;2110.66666666667;108.666666666667
27533;2023;4;4;0;100;0;222695;1925.5;113.5
27534;2023;13;13;0;100;0;211723.076923077;2361.69230769231;98.1538461538462
27535;2023;5;5;0;100;0;126000;1629;79.6
27536;2023;2;2;0;100;0;202440;2844.5;70.5
27537;2023;11;11;0;100;0;154181.818181818;1956.90909090909;81.8181818181818
27538;2023;4;4;0;100;0;256175;2375.25;102.5
27539;2023;3;3;0;100;0;270200;2845;96.6666666666667
27540;2023;6;6;0;100;0;159160;1856;85.6666666666667
27542;2023;11;11;0;100;0;157493.272727273;1774.09090909091;92.5454545454545
27543;2023;9;9;0;100;0;169222.222222222;2009.44444444444;84.2222222222222
27544;2023;1;1;0;100;0;358000;3284;109
27545;2023;1;1;0;100;0;370000;1989;186
27547;2023;20;20;0;100;0;177377.5;1502.95;120.55
27548;2023;11;11;0;100;0;218587.272727273;1722.72727272727;126
27550;2023;4;4;0;100;0;218775;1422.75;151
27552;2023;4;4;0;100;0;141025;1417.5;105.25
27553;2023;4;4;0;100;0;73750;1369;49.5
27554;2023;24;24;0;100;0;246136.958333333;2293.625;112.625
27555;2023;1;1;0;100;0;295000;2063;143
27557;2023;7;7;0;100;0;178485.714285714;2107.57142857143;89.5714285714286
27558;2023;4;4;0;100;0;150750;1475.75;108.25
27560;2023;1;1;0;100;0;190000;1900;100
27561;2023;4;4;0;100;0;168287.5;1774.5;100.25
27562;2023;65;45;20;69.2307692307692;30.7692307692308;210548.446153846;2344.8;87.6461538461539
27563;2023;6;6;0;100;0;216666.666666667;1946.16666666667;107.5
27564;2023;3;3;0;100;0;127666.666666667;1278;109
27565;2023;8;8;0;100;0;195575;1697.625;112.25
27567;2023;3;3;0;100;0;277000;2896;95.6666666666667
27568;2023;7;7;0;100;0;135342.857142857;1697.57142857143;88.2857142857143
27569;2023;2;2;0;100;0;123996;1878.5;70
27570;2023;1;1;0;100;0;135000;1929;70
27571;2023;4;4;0;100;0;157500;2192;82.75
27572;2023;1;1;0;100;0;173500;2169;80
27576;2023;6;6;0;100;0;297983.333333333;2354.16666666667;122.833333333333
27577;2023;9;9;0;100;0;132866.666666667;1830.55555555556;64
27578;2023;5;5;0;100;0;90790.8;1218.8;88.6
27579;2023;1;1;0;100;0;85000;1232;69
27580;2023;23;23;0;100;0;235036.086956522;2051.17391304348;115.478260869565
27582;2023;14;14;0;100;0;199507.5;1976.85714285714;98.8571428571429
27584;2023;3;3;0;100;0;196500;2432.33333333333;80.6666666666667
27587;2023;8;8;0;100;0;190981.25;1997.75;91.875
27589;2023;7;7;0;100;0;289785.714285714;2175.57142857143;133
27590;2023;2;2;0;100;0;114500;1593;73
27591;2023;12;12;0;100;0;263450;3545.5;93.4166666666667
27592;2023;7;7;0;100;0;328164.285714286;2941.14285714286;119
27593;2023;15;15;0;100;0;232916.666666667;2250.2;106.133333333333
27594;2023;6;6;0;100;0;134854.166666667;1752.83333333333;81.6666666666667
27595;2023;13;13;0;100;0;189551.307692308;1840.61538461538;105.384615384615
27597;2023;14;14;0;100;0;202982.857142857;2103;96.1428571428571
27598;2023;17;17;0;100;0;179205.882352941;2043;87.5294117647059
27599;2023;4;4;0;100;0;257587.5;2377.75;111
27601;2023;8;8;0;100;0;172875;2327;81.25
27602;2023;57;53;4;92.9824561403509;7.01754385964912;178627.438596491;1951.9649122807;94.1754385964912
27603;2023;3;3;0;100;0;307483.333333333;1951.66666666667;155.333333333333
27604;2023;3;3;0;100;0;218000;2952.33333333333;76.3333333333333
27605;2023;5;5;0;100;0;283100;2218.8;123.2
27606;2023;4;4;0;100;0;224225;2750.5;85
27608;2023;6;6;0;100;0;167833.333333333;1898.16666666667;91.8333333333333
27609;2023;4;4;0;100;0;185875;2874.5;103.5
27611;2023;2;2;0;100;0;233095.5;2918;79.5
27612;2023;3;3;0;100;0;221666.666666667;2051.66666666667;108.666666666667
27613;2023;5;5;0;100;0;166066.8;1890.2;84.8
27614;2023;2;2;0;100;0;329000;4306.5;73.5
27615;2023;4;4;0;100;0;266050;2033.75;131
27616;2023;23;23;0;100;0;239427;2159.5652173913;115.173913043478
27617;2023;8;8;0;100;0;193703.75;1779;115.25
27618;2023;11;11;0;100;0;185563.636363636;1776.27272727273;101.727272727273
27620;2023;5;5;0;100;0;194260;2126.6;93
27621;2023;2;2;0;100;0;105500;1725;63.5
27622;2023;22;22;0;100;0;130990.454545455;1628.95454545455;84
27623;2023;6;6;0;100;0;206566.666666667;2168.33333333333;99.3333333333333
27624;2023;11;11;0;100;0;208622.909090909;1931.18181818182;109.909090909091
27625;2023;3;3;0;100;0;184466.666666667;1784;104.333333333333
27627;2023;3;3;0;100;0;230345;3003.33333333333;86
27629;2023;25;25;0;100;0;176342.4;1826.16;97.52
27631;2023;4;4;0;100;0;139958.25;1762.75;86.75
27632;2023;6;6;0;100;0;214600;2149.5;107.166666666667
27633;2023;6;6;0;100;0;185200;2080.66666666667;91.6666666666667
27635;2023;1;1;0;100;0;168000;2000;84
27638;2023;46;46;0;100;0;246097.282608696;2215.23913043478;112.282608695652
27640;2023;4;4;0;100;0;150815;1632.75;99
27641;2023;1;1;0;100;0;330000;2025;163
27643;2023;20;14;6;70;30;99185.1;1199.7;80.7
27644;2023;5;5;0;100;0;182887;2316.8;83.4
27645;2023;3;3;0;100;0;209133.333333333;1949;102
27646;2023;6;6;0;100;0;427666.666666667;3922.33333333333;95
27649;2023;9;9;0;100;0;182750;1910.66666666667;95.7777777777778
27650;2023;2;2;0;100;0;290000;4295.5;97.5
27652;2023;2;2;0;100;0;251750;2317;107.5
27654;2023;8;8;0;100;0;179500;1927.5;97
27655;2023;5;5;0;100;0;314350.6;2216.6;136.4
27656;2023;13;13;0;100;0;183214.307692308;1929.07692307692;99
27658;2023;2;2;0;100;0;187500;1810;107
27659;2023;2;2;0;100;0;554725;2782;197.5
27660;2023;9;9;0;100;0;156255.555555556;1901.33333333333;97.2222222222222
27661;2023;4;4;0;100;0;234195;2376.75;106
27662;2023;6;6;0;100;0;208291.666666667;1972.16666666667;113.5
27663;2023;1;1;0;100;0;142000;2958;48
27664;2023;6;6;0;100;0;183153.333333333;2091.5;97.1666666666667
27665;2023;9;9;0;100;0;186547.555555556;2653.77777777778;78.7777777777778
27666;2023;2;2;0;100;0;182500;1176.5;165.5
27667;2023;1;1;0;100;0;203500;1454;140
27668;2023;5;5;0;100;0;241023.6;2910.8;82.4
27669;2023;2;2;0;100;0;123056.5;1591.5;78
27670;2023;15;15;0;100;0;230513.333333333;2125.06666666667;107.133333333333
27671;2023;1;1;0;100;0;110000;1897;58
27672;2023;9;9;0;100;0;305822.222222222;2162.11111111111;146.888888888889
27673;2023;3;3;0;100;0;212716.666666667;1912.66666666667;114
27674;2023;6;4;2;66.6666666666667;33.3333333333333;393938.5;2167.83333333333;147.5
27677;2023;3;3;0;100;0;157821.666666667;1520.66666666667;104.666666666667
27678;2023;10;10;0;100;0;196828.4;2098.3;93.6
27679;2023;93;74;19;79.5698924731183;20.4301075268817;153585.967741935;1715.48387096774;91.3333333333333
27680;2023;4;4;0;100;0;110750;1127.75;100.5
27681;2023;275;132;143;48;52;206008.661818182;2722.37454545455;78.0109090909091
27682;2023;5;5;0;100;0;241000;2749.8;89
27683;2023;3;3;0;100;0;150000;1773.66666666667;83.6666666666667
27684;2023;6;3;3;50;50;137835.833333333;1968.16666666667;68.6666666666667
27685;2023;11;11;0;100;0;159904.545454545;1775.63636363636;93
27689;2023;4;4;0;100;0;277420.5;2517.25;116.5
27690;2023;2;2;0;100;0;168500;1377.5;131
27691;2023;16;16;0;100;0;199374.375;2167.4375;94.875
27693;2023;20;20;0;100;0;210380;2088.9;104.55
27694;2023;4;4;0;100;0;277027.5;2521.75;110.75
27695;2023;4;4;0;100;0;191250;2144;92.75
27696;2023;14;14;0;100;0;211859.285714286;2410.28571428571;91.0714285714286
27697;2023;2;2;0;100;0;299800;2390;134
27698;2023;9;9;0;100;0;217516.666666667;2133.55555555556;109.666666666667
27700;2023;4;4;0;100;0;155000;1425.5;117.5
27701;2023;57;39;18;68.4210526315789;31.5789473684211;142748.192982456;1835.24561403509;78.0175438596491
28001;2023;26;22;4;84.6153846153846;15.3846153846154;268570.961538462;2630.53846153846;107.576923076923
28003;2023;2;2;0;100;0;224300;1426;152.5
28004;2023;2;2;0;100;0;151300;1523;99.5
28005;2023;5;5;0;100;0;90600;1344.4;70.2
28006;2023;28;28;0;100;0;209662;2201.57142857143;95.5714285714286
28007;2023;38;33;5;86.8421052631579;13.1578947368421;215210.5;2383.42105263158;93.2368421052632
28008;2023;1;1;0;100;0;45000;549;82
28009;2023;1;1;0;100;0;90000;1385;65
28010;2023;8;8;0;100;0;169100;1648.5;98.375
28012;2023;66;66;0;100;0;104619.787878788;1349.95454545455;81.5454545454545
28013;2023;18;18;0;100;0;209320.333333333;2407.38888888889;90.6666666666667
28014;2023;7;7;0;100;0;130521.428571429;1471.28571428571;90.1428571428571
28015;2023;55;43;12;78.1818181818182;21.8181818181818;212004.418181818;2547.14545454545;89.5636363636364
28016;2023;4;4;0;100;0;120750;1762.75;89.75
28018;2023;20;19;1;95;5;107760;1366.05;77.25
28019;2023;3;3;0;100;0;155333.333333333;1152.66666666667;134.666666666667
28021;2023;19;19;0;100;0;184332.894736842;1721.47368421053;119.263157894737
28022;2023;15;15;0;100;0;210469.333333333;1883.73333333333;108.933333333333
28023;2023;20;18;2;90;10;213505.75;2375.45;95.65
28024;2023;9;9;0;100;0;297367.888888889;3377.44444444444;97.1111111111111
28025;2023;2;2;0;100;0;147995;1770.5;77.5
28026;2023;2;2;0;100;0;183250;1628.5;108.5
28027;2023;24;23;1;95.8333333333333;4.16666666666667;125317.208333333;1423.125;90.0416666666667
28028;2023;6;6;0;100;0;185821.666666667;2229.5;99.3333333333333
28029;2023;4;4;0;100;0;72000;1273.25;55.75
28030;2023;7;7;0;100;0;153403.571428571;1607.28571428571;93.1428571428571
28031;2023;9;9;0;100;0;93666.6666666667;1164.22222222222;81.6666666666667
28032;2023;4;4;0;100;0;175665;1705;102.75
28033;2023;7;7;0;100;0;104445.714285714;1396;75.8571428571429
28034;2023;9;9;0;100;0;199422.222222222;1564.88888888889;133.444444444444
28035;2023;9;9;0;100;0;165060;1975;86.5555555555556
28036;2023;7;6;1;85.7142857142857;14.2857142857143;223284.285714286;2510.71428571429;86.5714285714286
28037;2023;12;12;0;100;0;191787.5;1789.08333333333;101.833333333333
28038;2023;7;7;0;100;0;142785.714285714;1807.42857142857;89.2857142857143
28039;2023;21;21;0;100;0;237896.238095238;2376.33333333333;99.6190476190476
28040;2023;1;1;0;100;0;160000;1684;95
28041;2023;4;4;0;100;0;83000;1184;71.75
28045;2023;2;2;0;100;0;140750;1097.5;123.5
28046;2023;4;4;0;100;0;219125;2156.75;96.5
28047;2023;7;7;0;100;0;175457.142857143;1982.42857142857;87.7142857142857
28048;2023;9;9;0;100;0;160722.222222222;1887.33333333333;89.7777777777778
28049;2023;3;3;0;100;0;138333.333333333;2195;74.3333333333333
28050;2023;4;4;0;100;0;186250;1715.75;115.5
28051;2023;54;51;3;94.4444444444444;5.55555555555556;139913.462962963;1738.92592592593;85.1481481481482
28052;2023;10;10;0;100;0;258200;2337.1;111.4
28053;2023;2;2;0;100;0;135000;1434.5;82
28054;2023;2;2;0;100;0;148000;1934;73.5
28055;2023;8;8;0;100;0;214943.75;1934.75;112.625
28056;2023;20;19;1;95;5;359418.15;2751.75;139.45
28057;2023;6;6;0;100;0;156900;1683.66666666667;96.3333333333333
28058;2023;5;5;0;100;0;286562;2566.8;114
28059;2023;17;16;1;94.1176470588235;5.88235294117647;143578.823529412;1443.58823529412;100.941176470588
28060;2023;2;2;0;100;0;211485;2628.5;80
28061;2023;54;53;1;98.1481481481482;1.85185185185185;148932.907407407;1499.61111111111;99.3888888888889
28062;2023;9;9;0;100;0;224555.555555556;2227.66666666667;102.444444444444
28064;2023;19;18;1;94.7368421052632;5.26315789473684;255551.052631579;2863.78947368421;91.5263157894737
28065;2023;3;3;0;100;0;153666.666666667;1414.66666666667;118
28068;2023;3;3;0;100;0;217808.333333333;1762.66666666667;125.333333333333
28070;2023;34;34;0;100;0;232075.794117647;2467.32352941176;96.3235294117647
28071;2023;9;9;0;100;0;145924.444444444;1815.88888888889;86.5555555555556
28072;2023;4;4;0;100;0;164500;1609;102.75
28073;2023;8;8;0;100;0;237612.5;2339.75;107.75
28074;2023;5;5;0;100;0;155454.4;1338.6;124.8
28075;2023;13;13;0;100;0;125111.615384615;1429.23076923077;91.4615384615385
28076;2023;3;3;0;100;0;294650;2310.33333333333;129
28077;2023;1;1;0;100;0;256755;1510;170
28078;2023;5;5;0;100;0;83500;1068.4;81.2
28079;2023;5;5;0;100;0;78580;1066.8;74.4
28080;2023;5;5;0;100;0;141000;1576.2;88
28081;2023;4;4;0;100;0;125125;1529.5;81.25
28082;2023;7;7;0;100;0;257831.428571429;2185.71428571429;120.714285714286
28084;2023;5;5;0;100;0;257730;2653.6;95.8
28085;2023;633;191;442;30.173775671406;69.826224328594;174960.786729858;2596.99526066351;68.0631911532385
28086;2023;8;8;0;100;0;88093.125;1288.875;67.625
28087;2023;4;4;0;100;0;218937;1951;111.25
28088;2023;139;108;31;77.6978417266187;22.3021582733813;118263.489208633;1416.22302158273;86.1870503597122
28089;2023;29;24;5;82.7586206896552;17.2413793103448;149772.24137931;1923.86206896552;80.2413793103448
28090;2023;1;1;0;100;0;190700;2724;70
28092;2023;4;4;0;100;0;159500;1839;89.5
28094;2023;24;24;0;100;0;243667.916666667;2436.66666666667;110.166666666667
28095;2023;1;1;0;100;0;242200;2182;111
28096;2023;22;22;0;100;0;237434.090909091;2705.36363636364;93.0909090909091
28098;2023;26;26;0;100;0;259419.615384615;2532.88461538462;107.076923076923
28099;2023;10;10;0;100;0;233452.6;2125.6;107.5
28100;2023;4;4;0;100;0;222715;2230;100.25
28102;2023;4;4;0;100;0;198206.25;1843;115
28103;2023;81;81;0;100;0;116117.530864198;1353.65432098765;86.1111111111111
28104;2023;13;13;0;100;0;202361.538461538;2157;95.9230769230769
28105;2023;7;7;0;100;0;139485.714285714;1806.57142857143;86
28106;2023;7;7;0;100;0;109907.142857143;1387.85714285714;82.7142857142857
28107;2023;8;8;0;100;0;160267.5;1674;95.625
28108;2023;3;3;0;100;0;57333.3333333333;704;86.6666666666667
28109;2023;4;4;0;100;0;157375;1482.75;118.75
28110;2023;44;26;18;59.0909090909091;40.9090909090909;278904.545454545;2707.18181818182;102.204545454545
28113;2023;18;14;4;77.7777777777778;22.2222222222222;184048.222222222;2220.88888888889;91.1111111111111
28114;2023;1;1;0;100;0;85000;708;120
28116;2023;20;20;0;100;0;214782.5;2194;93.2
28117;2023;4;4;0;100;0;125000;2246.75;57
28118;2023;5;5;0;100;0;236660;1831;143
28120;2023;6;6;0;100;0;180166.666666667;1535.16666666667;121.666666666667
28121;2023;3;3;0;100;0;156670;1814.33333333333;100.333333333333
28122;2023;15;15;0;100;0;179386.666666667;1938.73333333333;97.6666666666667
28123;2023;4;4;0;100;0;87250;1152.25;76
28124;2023;7;7;0;100;0;172357.142857143;1503.57142857143;115.571428571429
28126;2023;3;3;0;100;0;123500;1052.66666666667;112.666666666667
28127;2023;26;26;0;100;0;119957.692307692;1458;88.9230769230769
28128;2023;8;8;0;100;0;148375;1498.5;97
28129;2023;14;14;0;100;0;204657.142857143;2323.07142857143;98.8571428571429
28130;2023;10;10;0;100;0;193500;1743.8;113.4
28132;2023;6;6;0;100;0;125091.666666667;1327.83333333333;94.6666666666667
28134;2023;277;126;151;45.4873646209386;54.5126353790614;140196.111913357;1913.62454873646;72.9061371841155
28135;2023;10;9;1;90;10;342975;2474.7;137.7
28136;2023;1;1;0;100;0;343450;3122;110
28137;2023;11;11;0;100;0;184374.454545455;2321.09090909091;82.0909090909091
28139;2023;1;1;0;100;0;118000;2070;57
28140;2023;84;21;63;25;75;153761.071428571;2713.61904761905;58.25
28142;2023;4;4;0;100;0;171150;1318;128.5
28143;2023;2;2;0;100;0;229500;1346;172.5
28144;2023;5;5;0;100;0;115400;1247.4;94.6
28146;2023;9;9;0;100;0;254700;2235.11111111111;117.777777777778
28147;2023;7;7;0;100;0;145857.142857143;1713;87
28148;2023;5;5;0;100;0;85770;1087.2;76.6
28149;2023;11;11;0;100;0;136518.181818182;1264.27272727273;113.090909090909
28153;2023;3;3;0;100;0;128936.666666667;1329;97.3333333333333
28154;2023;13;13;0;100;0;211053.230769231;2062.30769230769;103.076923076923
28155;2023;4;4;0;100;0;156330;2083.5;81.25
28156;2023;14;14;0;100;0;143998.785714286;1537;101
28157;2023;4;4;0;100;0;154700;1548;111.75
28158;2023;9;9;0;100;0;266277.777777778;2648.88888888889;97.4444444444444
28159;2023;6;6;0;100;0;174833.333333333;1444.5;129.166666666667
28160;2023;12;12;0;100;0;179625;1874.41666666667;98.75
28161;2023;11;11;0;100;0;115557.272727273;1570.81818181818;74.7272727272727
28162;2023;3;3;0;100;0;171000;2065.66666666667;82.6666666666667
28163;2023;2;2;0;100;0;217000;1885;126.5
28164;2023;14;14;0;100;0;138346.428571429;1568.28571428571;88.9285714285714
28166;2023;6;6;0;100;0;118083.333333333;1574.83333333333;77.6666666666667
28167;2023;4;4;0;100;0;137000;1778.5;94
28168;2023;42;34;8;80.9523809523809;19.047619047619;214789.285714286;2453.66666666667;97.4761904761905
28169;2023;3;3;0;100;0;281100;1954.33333333333;164.333333333333
28170;2023;2;2;0;100;0;205275;1590.5;128.5
28171;2023;8;8;0;100;0;241387.5;2349.375;101.125
28172;2023;8;8;0;100;0;190389.375;2014.25;97.125
28173;2023;17;17;0;100;0;296411.764705882;2553.82352941176;115.705882352941
28175;2023;1;1;0;100;0;290000;1824;159
28176;2023;8;8;0;100;0;133475;1493.625;88.375
28177;2023;4;4;0;100;0;277250;2239.5;118.75
28178;2023;8;8;0;100;0;296073.375;2026.25;162.125
28180;2023;4;4;0;100;0;356180;2996;121.5
28182;2023;3;3;0;100;0;83000;1252;71.6666666666667
28183;2023;8;8;0;100;0;175450;2123.25;85.5
28184;2023;1;1;0;100;0;85000;1417;60
28185;2023;13;12;1;92.3076923076923;7.69230769230769;333246.153846154;3084.84615384615;113.769230769231
28187;2023;7;7;0;100;0;260288.571428571;2527.28571428571;109.142857142857
28188;2023;8;8;0;100;0;222301.25;2121.25;106.125
28190;2023;2;2;0;100;0;217500;1551;141.5
28191;2023;30;27;3;90;10;233770.666666667;2580.9;94.5333333333333
28192;2023;6;6;0;100;0;104383.333333333;1376.83333333333;74
28193;2023;3;3;0;100;0;177833.333333333;1977.66666666667;86
28194;2023;3;3;0;100;0;262000;2155.33333333333;124.666666666667
28195;2023;6;6;0;100;0;228858.333333333;2559.83333333333;91.5
28196;2023;35;33;2;94.2857142857143;5.71428571428571;144581.885714286;1638.05714285714;91.6
28198;2023;10;10;0;100;0;144771.2;1385.9;103.7
28199;2023;40;39;1;97.5;2.5;157425.75;1668.85;97.125
28200;2023;4;4;0;100;0;106250;1424.25;79.75
28201;2023;28;28;0;100;0;227948.928571429;2544.39285714286;94.1071428571429
28202;2023;5;5;0;100;0;253400;1983.4;120.8
28203;2023;11;11;0;100;0;172259.090909091;1832.90909090909;94.3636363636364
28206;2023;7;7;0;100;0;148135.714285714;1479.57142857143;104.428571428571
28207;2023;1;1;0;100;0;125000;2358;53
28208;2023;3;3;0;100;0;405706.666666667;3164.33333333333;146
28209;2023;58;40;18;68.9655172413793;31.0344827586207;230074.982758621;2483.6724137931;93.4137931034483
28210;2023;3;3;0;100;0;158400;1817.66666666667;84
28211;2023;8;8;0;100;0;110562.5;1318;88.625
28212;2023;2;2;0;100;0;192250;908;218.5
28213;2023;7;5;2;71.4285714285714;28.5714285714286;221607.142857143;2562.57142857143;94.5714285714286
28214;2023;49;47;2;95.9183673469388;4.08163265306122;120162.510204082;1513.55102040816;81.469387755102
28215;2023;3;3;0;100;0;187900;1466;115.333333333333
28216;2023;4;4;0;100;0;244250;1951;126.75
28217;2023;4;4;0;100;0;230000;1280.25;161
28218;2023;123;55;68;44.7154471544715;55.2845528455285;150946.853658537;2290.72357723577;68.2439024390244
28219;2023;7;7;0;100;0;150835.714285714;2010.71428571429;79
28220;2023;91;66;25;72.5274725274725;27.4725274725275;232493.868131868;2511.7032967033;91.4395604395604
28222;2023;4;4;0;100;0;191000;1650.75;125.5
28223;2023;17;17;0;100;0;217781.764705882;2362.35294117647;94.4117647058823
28225;2023;9;9;0;100;0;132522.222222222;1474.33333333333;91.6666666666667
28226;2023;16;16;0;100;0;197581.8125;1728.8125;116.8125
28227;2023;49;37;12;75.5102040816327;24.4897959183673;227622.265306122;2663.34693877551;87.5714285714286
28229;2023;100;58;42;58;42;175768.57;2319.01;77.51
28230;2023;3;3;0;100;0;187333.333333333;1645.33333333333;113
28231;2023;2;2;0;100;0;168750;1512.5;109.5
28232;2023;12;12;0;100;0;173200;1631.5;105.333333333333
28233;2023;9;9;0;100;0;156703.333333333;2039.66666666667;87.3333333333333
28234;2023;6;6;0;100;0;145208.333333333;1478.5;109.666666666667
28235;2023;4;4;0;100;0;340567.5;2836.75;118
28236;2023;20;19;1;95;5;150023.75;1578.3;90
28237;2023;1;1;0;100;0;140000;927;151
28239;2023;8;8;0;100;0;233950;2942.75;105.375
28240;2023;5;5;0;100;0;101600;1448.2;72.4
28242;2023;1;1;0;100;0;73500;634;116
28246;2023;8;8;0;100;0;158405.625;1677.375;91.75
28247;2023;9;9;0;100;0;325477.777777778;2820.22222222222;121.888888888889
28248;2023;8;8;0;100;0;152625;2020;75.5
28249;2023;6;6;0;100;0;237833.333333333;2631.83333333333;91.6666666666667
28251;2023;10;10;0;100;0;178957;1879;105.5
28252;2023;7;7;0;100;0;166285.714285714;1867.57142857143;86.5714285714286
28253;2023;6;6;0;100;0;242216.666666667;2438.33333333333;105.166666666667
28254;2023;15;15;0;100;0;199552.666666667;2072.26666666667;102
28255;2023;2;2;0;100;0;145250;1759.5;89.5
28256;2023;4;4;0;100;0;133500;1529.25;84
28257;2023;1;1;0;100;0;214000;1427;150
28259;2023;1;1;0;100;0;190900;1326;144
28260;2023;2;2;0;100;0;79962.5;1126;73.5
28261;2023;17;17;0;100;0;128794.117647059;1355.70588235294;98.1764705882353
28263;2023;3;3;0;100;0;198133.333333333;1550.33333333333;112.333333333333
28264;2023;5;5;0;100;0;109400;1329.2;89.4
28265;2023;2;2;0;100;0;121300;1843.5;79.5
28267;2023;2;2;0;100;0;193750;1478;136
28269;2023;14;14;0;100;0;290682.857142857;2409.35714285714;121
28270;2023;2;2;0;100;0;110000;983.5;110
28272;2023;2;2;0;100;0;198075;2158.5;86.5
28273;2023;3;3;0;100;0;128500;2278;60.6666666666667
28274;2023;5;5;0;100;0;124690;1400;89.2
28275;2023;7;7;0;100;0;246857.142857143;2173.85714285714;113.857142857143
28276;2023;1;1;0;100;0;149000;2014;74
28277;2023;1;1;0;100;0;244000;4692;52
28278;2023;14;13;1;92.8571428571429;7.14285714285714;285991.357142857;2541.64285714286;129.214285714286
28279;2023;64;47;17;73.4375;26.5625;173108.78125;2072.890625;82.859375
28280;2023;151;104;47;68.8741721854305;31.1258278145695;116458.165562914;1434.64238410596;79.1192052980132
28281;2023;2;2;0;100;0;75500;1594.5;50
28282;2023;5;5;0;100;0;109020;1428.4;77.8
28283;2023;6;6;0;100;0;90791.6666666667;1013.83333333333;94.5
28284;2023;1;1;0;100;0;51000;1700;30
28285;2023;2;2;0;100;0;229160;2150.5;108
28286;2023;3;3;0;100;0;162966.666666667;1628;99.6666666666667
28287;2023;9;9;0;100;0;132165.555555556;1956.33333333333;74.3333333333333
28289;2023;1;1;0;100;0;180000;2308;78
28290;2023;3;3;0;100;0;120633.333333333;1477.66666666667;79.6666666666667
28291;2023;10;10;0;100;0;158290;1721.9;116.2
28292;2023;12;12;0;100;0;232008.333333333;2219.08333333333;110.75
28293;2023;16;16;0;100;0;235503.75;2295.1875;104.1875
28294;2023;7;7;0;100;0;218721.428571429;2442;99.2857142857143
28296;2023;5;5;0;100;0;132200;1123.4;115.6
28298;2023;35;29;6;82.8571428571429;17.1428571428571;189982.285714286;2450.08571428571;81.7428571428571
28299;2023;1;1;0;100;0;275000;2331;118
28300;2023;1;1;0;100;0;110000;1310;84
28301;2023;8;8;0;100;0;258956.25;2577.625;109.5
28302;2023;13;13;0;100;0;117488.461538462;1436.92307692308;86.2307692307692
28304;2023;2;2;0;100;0;163500;994.5;161
28305;2023;2;2;0;100;0;158700;1532;105
28306;2023;3;3;0;100;0;176731.333333333;1677.33333333333;115.333333333333
28308;2023;4;4;0;100;0;133125;1474.75;100
28309;2023;7;7;0;100;0;210507.142857143;1950.71428571429;108.285714285714
28310;2023;4;4;0;100;0;135275;1470.75;94.75
28312;2023;2;2;0;100;0;154000;1514.5;101.5
28313;2023;1;1;0;100;0;151200;694;218
28314;2023;2;2;0;100;0;198183.5;1945;103
28315;2023;2;2;0;100;0;116420;1235.5;88.5
28316;2023;3;3;0;100;0;250333.333333333;2166.66666666667;124.333333333333
28317;2023;6;6;0;100;0;245566.666666667;2318.66666666667;103.666666666667
28319;2023;8;8;0;100;0;168631.25;1943;111.625
28321;2023;10;10;0;100;0;266540;2337.3;115.6
28322;2023;10;10;0;100;0;180950;1908.3;98.2
28323;2023;2;2;0;100;0;146375;1802;80.5
28324;2023;8;8;0;100;0;169306.25;1698.125;101
28325;2023;13;13;0;100;0;226346.923076923;2257.53846153846;101.076923076923
28326;2023;5;5;0;100;0;127328;1272.6;103.2
28327;2023;5;5;0;100;0;95200;1056.8;92.4
28329;2023;2;2;0;100;0;210000;2050.5;101.5
28330;2023;14;14;0;100;0;123952.857142857;1380.35714285714;96.1428571428571
28331;2023;18;18;0;100;0;204690.166666667;2195;92.7777777777778
28332;2023;8;8;0;100;0;252343.75;2611.75;98.25
28333;2023;1;1;0;100;0;65500;585;112
28334;2023;32;31;1;96.875;3.125;118185.625;1589.78125;73.28125
28335;2023;15;15;0;100;0;166434.666666667;1624.26666666667;100.333333333333
28336;2023;2;2;0;100;0;200312.5;2336;86.5
28337;2023;23;23;0;100;0;241287.652173913;2329.65217391304;108.173913043478
28339;2023;4;4;0;100;0;176062.5;2175;82.25
28341;2023;2;2;0;100;0;146000;1735;85.5
28342;2023;2;2;0;100;0;318500;3825;91.5
28343;2023;4;4;0;100;0;291230.5;2294.75;128
28344;2023;3;3;0;100;0;270000;1987.33333333333;144
28347;2023;13;12;1;92.3076923076923;7.69230769230769;236384.615384615;3145;81.0769230769231
28348;2023;38;38;0;100;0;162242.631578947;1775.81578947368;94.5263157894737
28349;2023;6;6;0;100;0;309170;2479;120.5
28350;2023;10;10;0;100;0;215580.5;2100.2;103.4
28351;2023;5;5;0;100;0;165674;1723;102.2
28352;2023;16;16;0;100;0;300769.3125;2693.9375;113.3125
28353;2023;7;7;0;100;0;205557.142857143;2344.28571428571;84.4285714285714
28354;2023;7;7;0;100;0;105642.857142857;1089.14285714286;99.8571428571429
28355;2023;4;4;0;100;0;394000;3999;105
28357;2023;13;13;0;100;0;246438.461538462;2599.76923076923;97.5384615384615
28358;2023;33;32;1;96.969696969697;3.03030303030303;244253.181818182;2457.90909090909;104.939393939394
28359;2023;48;48;0;100;0;152469.291666667;1775.54166666667;88.875
28360;2023;9;9;0;100;0;199072.222222222;2126.77777777778;99.7777777777778
28362;2023;8;8;0;100;0;111625;1273.125;87.75
28363;2023;12;12;0;100;0;204891.666666667;2220.33333333333;94.5
28364;2023;18;17;1;94.4444444444444;5.55555555555556;126544.444444444;1431.33333333333;87.3333333333333
28365;2023;7;7;0;100;0;180650;1664.57142857143;111
28367;2023;3;3;0;100;0;96166.6666666667;1345;75.6666666666667
28369;2023;7;7;0;100;0;186764.285714286;1625.71428571429;120.571428571429
28370;2023;4;4;0;100;0;197643.75;1849.25;102.5
28371;2023;11;11;0;100;0;183181.818181818;2322;82.1818181818182
28372;2023;6;6;0;100;0;250691.666666667;2550.83333333333;101.166666666667
28373;2023;43;40;3;93.0232558139535;6.97674418604651;126386.511627907;1534.62790697674;87.0930232558139
28374;2023;9;9;0;100;0;219701.111111111;2107.55555555556;109.888888888889
28375;2023;5;5;0;100;0;259906.2;2669.8;104.2
28377;2023;23;23;0;100;0;227230.434782609;2295.95652173913;106.739130434783
28378;2023;7;7;0;100;0;140333.714285714;1964.28571428571;76.1428571428571
28379;2023;7;7;0;100;0;266871.428571429;2547.57142857143;106.571428571429
28380;2023;14;14;0;100;0;260198.642857143;2558.35714285714;107.357142857143
28382;2023;8;8;0;100;0;212250;2097.875;91.625
28383;2023;4;4;0;100;0;156768.75;2080.75;74.25
28385;2023;4;4;0;100;0;129375;1222;100.5
28386;2023;15;15;0;100;0;176905;1832.06666666667;97.2666666666667
28387;2023;8;8;0;100;0;132675;1501.125;76.875
28388;2023;8;8;0;100;0;231507.375;2487.375;92.5
28389;2023;3;3;0;100;0;116000;1442.33333333333;102.333333333333
28390;2023;4;4;0;100;0;125225;1235;106.75
28391;2023;34;27;7;79.4117647058823;20.5882352941176;149137.647058824;1898.61764705882;86.9117647058823
28392;2023;3;3;0;100;0;151333.333333333;1661;90
28393;2023;25;24;1;96;4;211727.2;1816.24;118.92
28394;2023;16;16;0;100;0;175831.25;1768.3125;100.375
28395;2023;5;5;0;100;0;138370;2225.4;72.4
28396;2023;4;4;0;100;0;115775;1339.5;86
28397;2023;3;3;0;100;0;197666.666666667;1889;105
28398;2023;19;19;0;100;0;104995.789473684;1293.42105263158;82.9473684210526
28401;2023;3;3;0;100;0;98166.6666666667;1479;62.3333333333333
28403;2023;1;1;0;100;0;210000;2059;102
28404;2023;112;84;28;75;25;168932.160714286;2001.82142857143;86.2589285714286
28405;2023;10;10;0;100;0;214340;2277.3;99.8
28406;2023;18;18;0;100;0;128222.722222222;1477.38888888889;90.5555555555556
28407;2023;6;6;0;100;0;117083.333333333;1469.5;72.3333333333333
28409;2023;6;6;0;100;0;144643.333333333;1306.66666666667;112.666666666667
28410;2023;4;4;0;100;0;188415;2051.5;91
28411;2023;4;4;0;100;0;172237.5;1494;122.25
28414;2023;1;1;0;100;0;95000;1397;68
28415;2023;9;9;0;100;0;186411.111111111;2123.11111111111;90
28417;2023;14;14;0;100;0;255135.714285714;2308.07142857143;114.714285714286
28418;2023;2;2;0;100;0;134750;1246;106.5
28419;2023;6;6;0;100;0;129408.333333333;1618.83333333333;91.5
28421;2023;2;2;0;100;0;201000;1777.5;109.5
28422;2023;47;43;4;91.4893617021277;8.51063829787234;141872.340425532;1703.93617021277;88.1276595744681
28423;2023;6;6;0;100;0;281141.666666667;4492;89.6666666666667
28424;2023;19;19;0;100;0;145731.631578947;1763.15789473684;80.6842105263158
28425;2023;4;4;0;100;0;257500;3291;82
28426;2023;15;15;0;100;0;147463.333333333;1524.2;104.4
29001;2023;13;11;2;84.6153846153846;15.3846153846154;182142.307692308;2136.07692307692;95.4615384615385
29002;2023;14;14;0;100;0;239600;1942.42857142857;124.857142857143
29003;2023;74;53;21;71.6216216216216;28.3783783783784;235278.783783784;2992.22972972973;79.9864864864865
29004;2023;69;61;8;88.4057971014493;11.5942028985507;209743.710144928;2214.40579710145;95.1449275362319
29005;2023;14;13;1;92.8571428571429;7.14285714285714;238570;2406.07142857143;104.5
29006;2023;124;54;70;43.5483870967742;56.4516129032258;308608.379032258;3906.46774193548;79.9838709677419
29007;2023;21;21;0;100;0;100492.904761905;1616.95238095238;68.8571428571429
29008;2023;9;9;0;100;0;238322.222222222;2564.55555555556;105
29010;2023;11;11;0;100;0;212266.545454545;1965.45454545455;108.727272727273
29011;2023;25;20;5;80;20;282468;2737.72;103.36
29012;2023;7;7;0;100;0;77428.5714285714;1052.42857142857;79.2857142857143
29013;2023;1;0;1;0;100;121000;1862;65
29014;2023;6;5;1;83.3333333333333;16.6666666666667;147001.666666667;1348.66666666667;104.5
29015;2023;28;27;1;96.4285714285714;3.57142857142857;209838.214285714;2176.35714285714;98.8928571428571
29016;2023;15;15;0;100;0;117838.2;1504.46666666667;83.7333333333333
29017;2023;8;8;0;100;0;287020.625;2450.125;119.125
29018;2023;9;9;0;100;0;65343.3333333333;1103.77777777778;63.2222222222222
29019;2023;2526;604;1922;23.9113222486144;76.0886777513856;159326.364608076;2321.53998416469;69.9726840855107
29020;2023;62;57;5;91.9354838709677;8.06451612903226;179619.822580645;1845.90322580645;99.2258064516129
29021;2023;33;28;5;84.8484848484848;15.1515151515152;204106.181818182;2799.75757575758;80
29022;2023;43;34;9;79.0697674418605;20.9302325581395;250680.627906977;2980.74418604651;87.9069767441861
29023;2023;80;60;20;75;25;364653.2;3772.575;98.0125
29024;2023;107;90;17;84.1121495327103;15.8878504672897;117671.261682243;1420.81308411215;84.0093457943925
29025;2023;14;14;0;100;0;119642.857142857;1324.92857142857;96.2857142857143
29026;2023;57;44;13;77.1929824561403;22.8070175438596;140211.912280702;1774.71929824561;81.2982456140351
29027;2023;56;56;0;100;0;125700.517857143;1330.66071428571;94.7321428571429
29028;2023;18;18;0;100;0;230084.555555556;2450.44444444444;92.6111111111111
29029;2023;18;18;0;100;0;136018.055555556;1508;89.8888888888889
29030;2023;45;44;1;97.7777777777778;2.22222222222222;215937.133333333;2124.11111111111;108.333333333333
29031;2023;77;57;20;74.025974025974;25.974025974026;316437.077922078;4125.42857142857;82.5974025974026
29032;2023;24;24;0;100;0;354442.083333333;3288.5;116.958333333333
29033;2023;11;11;0;100;0;96136.3636363636;1079;90.0909090909091
29034;2023;18;18;0;100;0;142215.555555556;1585.44444444444;87.3333333333333
29035;2023;15;15;0;100;0;217713.533333333;2059.93333333333;105.733333333333
29036;2023;16;16;0;100;0;94350;1320.25;81.0625
29037;2023;45;38;7;84.4444444444444;15.5555555555556;349440.222222222;3537.44444444444;104.177777777778
29038;2023;16;16;0;100;0;132560.625;1429.8125;98.0625
29039;2023;328;174;154;53.0487804878049;46.9512195121951;277323.417682927;3585.9237804878;78.8262195121951
29040;2023;52;44;8;84.6153846153846;15.3846153846154;327017.115384615;3324.25;102.134615384615
29041;2023;12;12;0;100;0;141732.75;1497.75;95.8333333333333
29042;2023;119;87;32;73.109243697479;26.890756302521;255234.504201681;2978.31092436975;83.5294117647059
29043;2023;16;15;1;93.75;6.25;245709.375;2473.6875;100.9375
29044;2023;16;16;0;100;0;156002.1875;1616.875;98.8125
29045;2023;21;21;0;100;0;246271.714285714;2464.04761904762;105.333333333333
29046;2023;220;145;75;65.9090909090909;34.0909090909091;204362.022727273;2425.28636363636;86.7954545454545
29047;2023;18;18;0;100;0;199155;1911.72222222222;109.833333333333
29048;2023;24;24;0;100;0;182636.875;1759;102.666666666667
29049;2023;39;39;0;100;0;162425.58974359;1658.74358974359;100.512820512821
29051;2023;70;70;0;100;0;237316.242857143;2177.92857142857;111.557142857143
29053;2023;30;29;1;96.6666666666667;3.33333333333333;202039.5;2011.23333333333;104.633333333333
29054;2023;16;16;0;100;0;94406.375;1253.9375;74.625
29055;2023;40;40;0;100;0;224523.6;2281.4;105.85
29056;2023;19;19;0;100;0;262242.631578947;2647.94736842105;103.052631578947
29057;2023;41;34;7;82.9268292682927;17.0731707317073;334593.585365854;3527.19512195122;96.0487804878049
29058;2023;175;131;44;74.8571428571429;25.1428571428571;361600.4;3989.21142857143;95.9485714285714
29059;2023;6;6;0;100;0;186998.5;1813.33333333333;99
29060;2023;25;24;1;96;4;303676.12;2843.92;112.2
29061;2023;59;55;4;93.2203389830508;6.77966101694915;237568.254237288;2344.71186440678;103.118644067797
29062;2023;24;24;0;100;0;166489.958333333;1796.5;94.9583333333333
29063;2023;7;7;0;100;0;252005.714285714;2386.71428571429;110.857142857143
29064;2023;3;3;0;100;0;95500;1713.33333333333;58
29065;2023;7;7;0;100;0;191635.714285714;2068.28571428571;96.5714285714286
29066;2023;16;16;0;100;0;196015.4375;1938.5625;102.625
29067;2023;28;28;0;100;0;121285.714285714;1237.25;94.25
29068;2023;17;17;0;100;0;208806.411764706;1881.29411764706;108.117647058824
29069;2023;75;66;9;88;12;243516.253333333;2483.34666666667;99.9733333333333
29070;2023;4;4;0;100;0;141500;1853.25;76.75
29071;2023;10;10;0;100;0;144300;1392.4;108.4
29072;2023;61;46;15;75.4098360655738;24.5901639344262;209766.901639344;2673.19672131148;82.327868852459
29073;2023;14;14;0;100;0;172499.214285714;1979.64285714286;94.3571428571429
29074;2023;12;12;0;100;0;140299;1456.25;91.9166666666667
29075;2023;139;121;18;87.0503597122302;12.9496402877698;246990;2483.87050359712;100.309352517986
29076;2023;47;47;0;100;0;257358.829787234;2357.36170212766;109.957446808511
29077;2023;31;29;2;93.5483870967742;6.45161290322581;278321.193548387;2344.16129032258;122.774193548387
29078;2023;30;30;0;100;0;154410.533333333;1686.1;93.6
29079;2023;15;15;0;100;0;197666.2;2153.86666666667;92
29080;2023;23;23;0;100;0;218760.869565217;2174.39130434783;97.5652173913043
29081;2023;36;33;3;91.6666666666667;8.33333333333333;119842.361111111;1379;87.1666666666667
29082;2023;6;5;1;83.3333333333333;16.6666666666667;267333.333333333;3483.5;71.3333333333333
29085;2023;13;8;5;61.5384615384615;38.4615384615385;250330.769230769;4125.84615384615;68.8461538461538
29086;2023;12;12;0;100;0;192539.583333333;2050.75;99
29087;2023;8;8;0;100;0;123250;1887.75;68.75
29089;2023;7;7;0;100;0;131460.428571429;1424;91.7142857142857
29090;2023;8;8;0;100;0;202870;1829.5;106.375
29091;2023;35;35;0;100;0;231396.142857143;2439.91428571429;96.8571428571429
29093;2023;9;9;0;100;0;204830;2340.22222222222;89.1111111111111
29094;2023;11;10;1;90.9090909090909;9.09090909090909;174323.090909091;1632.81818181818;108
29095;2023;6;6;0;100;0;258083.333333333;2269.5;112.333333333333
29097;2023;24;24;0;100;0;152267.333333333;1495.33333333333;101.25
29098;2023;37;36;1;97.2972972972973;2.7027027027027;252699.864864865;2650.86486486487;96.2972972972973
29099;2023;13;13;0;100;0;254802.307692308;2179.76923076923;114.846153846154
29100;2023;3;3;0;100;0;217808.333333333;1774.33333333333;116.666666666667
29101;2023;39;34;5;87.1794871794872;12.8205128205128;274945.102564103;2892.46153846154;95.8974358974359
29102;2023;19;19;0;100;0;124570.684210526;1394.78947368421;92.5263157894737
29103;2023;225;140;85;62.2222222222222;37.7777777777778;181732.306666667;2196.72;84.2266666666667
29104;2023;8;8;0;100;0;193381.875;2532.75;87.125
29105;2023;124;98;26;79.0322580645161;20.9677419354839;168416.379032258;1809.93548387097;92.0645161290323
29106;2023;17;17;0;100;0;209294.117647059;2060.41176470588;104.294117647059
29107;2023;10;10;0;100;0;177398.1;1634.9;112.6
29108;2023;12;12;0;100;0;222541.916666667;2317;97
29109;2023;25;24;1;96;4;305137.76;3283.12;96.4
29110;2023;8;8;0;100;0;110000;1202.375;99.5
29111;2023;10;10;0;100;0;183400;1452.4;128.6
29112;2023;20;20;0;100;0;266683;2648.2;103.9
29113;2023;36;36;0;100;0;166662.972222222;1713.19444444444;100
29114;2023;8;8;0;100;0;117000;1258.25;93.25
29115;2023;3;3;0;100;0;46666.6666666667;693;79.6666666666667
29117;2023;66;51;15;77.2727272727273;22.7272727272727;176163.924242424;2048.84848484848;89.5909090909091
29119;2023;13;13;0;100;0;210901;2007.61538461538;108.153846153846
29120;2023;21;16;5;76.1904761904762;23.8095238095238;157620.095238095;1876.66666666667;87.7142857142857
29122;2023;14;14;0;100;0;147803.785714286;1398.35714285714;108.857142857143
29123;2023;7;7;0;100;0;102785.714285714;1191.28571428571;87.7142857142857
29124;2023;113;81;32;71.6814159292035;28.3185840707965;180035.973451327;2073.36283185841;90.8495575221239
29125;2023;10;10;0;100;0;129266.4;1406.3;107.1
29128;2023;4;4;0;100;0;156125;1829.5;100
29130;2023;43;40;3;93.0232558139535;6.97674418604651;284126.76744186;3058.16279069767;95.9302325581395
29131;2023;3;3;0;100;0;139666.666666667;1151;127.666666666667
29132;2023;9;9;0;100;0;335916.666666667;2593.22222222222;120.111111111111
29133;2023;38;34;4;89.4736842105263;10.5263157894737;370124.815789474;4042.68421052632;99.5526315789474
29134;2023;13;13;0;100;0;210639.230769231;2416.76923076923;97
29135;2023;75;71;4;94.6666666666667;5.33333333333333;359762.893333333;3476.49333333333;106.28
29136;2023;11;11;0;100;0;211403.454545455;1932.45454545455;103.818181818182
29137;2023;20;20;0;100;0;278335;2756.05;103.4
29139;2023;7;7;0;100;0;150110;1853.71428571429;77.7142857142857
29140;2023;37;35;2;94.5945945945946;5.40540540540541;245531.081081081;2308.08108108108;107.891891891892
29141;2023;9;9;0;100;0;67227.7777777778;910;76.5555555555556
29142;2023;7;7;0;100;0;154962.857142857;1505;93.4285714285714
29143;2023;10;10;0;100;0;243396.9;2586.7;97.5
29144;2023;6;6;0;100;0;166916.666666667;1933.66666666667;93.6666666666667
29145;2023;7;7;0;100;0;160392.428571429;2013.85714285714;91.2857142857143
29146;2023;43;43;0;100;0;199276.255813953;2226.55813953488;93.1395348837209
29147;2023;27;26;1;96.2962962962963;3.7037037037037;249832.703703704;2415.77777777778;106.222222222222
29148;2023;13;11;2;84.6153846153846;15.3846153846154;161269.230769231;1322.46153846154;112.769230769231
29150;2023;90;80;10;88.8888888888889;11.1111111111111;296770.355555556;3321.3;95.5888888888889
29151;2023;298;139;159;46.6442953020134;53.3557046979866;138494.44966443;1724.15100671141;78.3892617449664
29152;2023;12;12;0;100;0;96774.9166666667;1225.66666666667;78.75
29153;2023;56;52;4;92.8571428571429;7.14285714285714;420706.875;4151.10714285714;103.071428571429
29155;2023;8;8;0;100;0;248500;3120.375;84.5
29156;2023;18;18;0;100;0;260501.111111111;2268.5;116.388888888889
29158;2023;87;74;13;85.0574712643678;14.9425287356322;262680.67816092;2815.28735632184;94.8045977011494
29159;2023;6;6;0;100;0;132250;1188.66666666667;119.5
29160;2023;82;78;4;95.1219512195122;4.8780487804878;220463.182926829;2212.13414634146;102.829268292683
29161;2023;28;27;1;96.4285714285714;3.57142857142857;275974.535714286;3047.39285714286;92.75
29162;2023;33;33;0;100;0;121756.060606061;1482.30303030303;80.9393939393939
29163;2023;33;33;0;100;0;186723.575757576;1750.12121212121;106.545454545455
29165;2023;53;47;6;88.6792452830189;11.3207547169811;274110.471698113;2640.33962264151;105.924528301887
29166;2023;12;12;0;100;0;193297.916666667;1690.83333333333;114.666666666667
29167;2023;36;36;0;100;0;219754.527777778;2148.05555555556;101.75
29168;2023;21;21;0;100;0;211129.428571429;2560.95238095238;85.1904761904762
29169;2023;33;33;0;100;0;195631.090909091;1885.12121212121;105.969696969697
29170;2023;34;31;3;91.1764705882353;8.82352941176471;302997.058823529;2454.52941176471;119.411764705882
29171;2023;40;40;0;100;0;229594.725;2378.45;98.525
29172;2023;25;23;2;92;8;228585.68;2311.36;104.4
29173;2023;24;24;0;100;0;199244.625;1973.33333333333;102.875
29174;2023;64;62;2;96.875;3.125;258598.984375;2575.734375;101.78125
29175;2023;39;39;0;100;0;113301.564102564;1242.15384615385;91.5128205128205
29176;2023;16;16;0;100;0;229756.375;2399.5;113.125
29177;2023;42;42;0;100;0;278787.69047619;2778.45238095238;104.880952380952
29178;2023;83;81;2;97.5903614457831;2.40963855421687;268621.56626506;2735.68674698795;104.807228915663
29179;2023;40;39;1;97.5;2.5;176755.6;1722.525;103.3
29180;2023;15;15;0;100;0;177923.333333333;2145.73333333333;93.4
29181;2023;22;22;0;100;0;235178.909090909;2194.86363636364;106.863636363636
29182;2023;13;13;0;100;0;177970.230769231;1576.07692307692;116.615384615385
29183;2023;6;6;0;100;0;141850;1752.66666666667;81
29184;2023;43;43;0;100;0;152856.744186047;1747.58139534884;88.7209302325581
29185;2023;59;54;5;91.5254237288136;8.47457627118644;222159.796610169;2470.5593220339;96.1016949152542
29186;2023;22;22;0;100;0;215825;1890.40909090909;112.818181818182
29187;2023;8;8;0;100;0;154752.5;1521.5;118.25
29188;2023;64;54;10;84.375;15.625;242195.28125;2626.359375;92.921875
29189;2023;134;114;20;85.0746268656716;14.9253731343284;257125.365671642;2548.81343283582;101.619402985075
29190;2023;67;44;23;65.6716417910448;34.3283582089552;265036.074626866;3179.73134328358;84.7761194029851
29191;2023;39;39;0;100;0;139993.051282051;1578.74358974359;88.7948717948718
29192;2023;29;29;0;100;0;229674.137931034;2237.58620689655;103.275862068966
29193;2023;20;20;0;100;0;150836.5;1289.9;108.35
29195;2023;106;99;7;93.3962264150943;6.60377358490566;247933.820754717;2672.89622641509;94.6415094339623
29196;2023;28;27;1;96.4285714285714;3.57142857142857;182766.642857143;1697.46428571429;111.892857142857
29197;2023;84;77;7;91.6666666666667;8.33333333333333;226884.5;2575.13095238095;88.9404761904762
29198;2023;17;17;0;100;0;212004.764705882;1996.41176470588;110.823529411765
29199;2023;56;56;0;100;0;182759.321428571;1848.66071428571;99.1071428571429
29201;2023;21;21;0;100;0;253252;2676.47619047619;94.3809523809524
29202;2023;26;26;0;100;0;101095.153846154;1057.19230769231;93.5384615384615
29204;2023;11;11;0;100;0;183142.181818182;1687.18181818182;114.727272727273
29205;2023;10;10;0;100;0;106260;1157.3;97.3
29206;2023;25;25;0;100;0;163148;1689.76;102.2
29207;2023;45;44;1;97.7777777777778;2.22222222222222;184554.022222222;1769.71111111111;108.622222222222
29208;2023;14;14;0;100;0;194906.142857143;2024.5;101.571428571429
29209;2023;36;34;2;94.4444444444444;5.55555555555556;223233.472222222;2188.33333333333;103.666666666667
29210;2023;26;24;2;92.3076923076923;7.69230769230769;164330.769230769;1600.88461538462;102.192307692308
29211;2023;13;13;0;100;0;99965.3846153846;1136.23076923077;90.5384615384615
29212;2023;106;98;8;92.4528301886792;7.54716981132075;245989.405660377;2463.55660377358;102.037735849057
29213;2023;21;20;1;95.2380952380952;4.76190476190476;157611.904761905;1543.47619047619;106.190476190476
29214;2023;8;8;0;100;0;256298.625;2756.625;91
29215;2023;37;37;0;100;0;233311.108108108;2426.2972972973;102.945945945946
29216;2023;35;35;0;100;0;235586.228571429;2223.05714285714;106.285714285714
29217;2023;58;55;3;94.8275862068966;5.17241379310345;253529;2922.62068965517;90.3793103448276
29218;2023;36;30;6;83.3333333333333;16.6666666666667;195271.694444444;2080.83333333333;98.6944444444444
29220;2023;140;86;54;61.4285714285714;38.5714285714286;188661.785714286;2490.83571428571;76.3714285714286
29221;2023;22;22;0;100;0;311869.045454545;2813;110.181818181818
29222;2023;8;6;2;75;25;114582.875;1768.125;79.625
29224;2023;7;7;0;100;0;170682.142857143;1941.28571428571;91
29225;2023;24;23;1;95.8333333333333;4.16666666666667;212900.416666667;2136.16666666667;106.916666666667
29226;2023;17;17;0;100;0;231465.058823529;2057.41176470588;122
29227;2023;25;25;0;100;0;88359.56;1150.92;84.32
29228;2023;8;7;1;87.5;12.5;211500;2701.375;78
29229;2023;10;10;0;100;0;158050;1577.6;98
29230;2023;18;18;0;100;0;182033.333333333;1986.94444444444;92.0555555555556
29232;2023;1216;508;708;41.7763157894737;58.2236842105263;169149.763157895;2324.59950657895;73.8347039473684
29233;2023;156;109;47;69.8717948717949;30.1282051282051;190208.326923077;2304.89102564103;84.9487179487179
29234;2023;18;18;0;100;0;225137.055555556;2071.38888888889;108.111111111111
29235;2023;126;94;32;74.6031746031746;25.3968253968254;303670.761904762;2923.53174603175;100.333333333333
29236;2023;57;55;2;96.4912280701754;3.50877192982456;235436.947368421;2475.0350877193;102.19298245614
29237;2023;14;14;0;100;0;209428.571428571;1904.07142857143;105.214285714286
29238;2023;11;11;0;100;0;272540.909090909;2417.27272727273;112.090909090909
29239;2023;56;27;29;48.2142857142857;51.7857142857143;211921.285714286;3032.71428571429;71.9642857142857
29240;2023;8;8;0;100;0;200558.25;1994.125;99.125
29241;2023;85;78;7;91.7647058823529;8.23529411764706;180856.576470588;1936.78823529412;96.4352941176471
29244;2023;7;7;0;100;0;138655;1680.14285714286;91.1428571428571
29245;2023;11;11;0;100;0;256200.909090909;2290.72727272727;109.636363636364
29246;2023;4;4;0;100;0;99658;1502.75;66.75
29247;2023;35;35;0;100;0;276466.428571429;2583.02857142857;106.942857142857
29248;2023;8;8;0;100;0;200998.125;1814.25;114.375
29249;2023;10;10;0;100;0;118489;1230;92.3
29250;2023;15;15;0;100;0;81416.6666666667;1056.06666666667;80.1333333333333
29251;2023;9;9;0;100;0;211644.444444444;2007.88888888889;106.666666666667
29252;2023;19;19;0;100;0;252199.578947368;2535.21052631579;107.368421052632
29254;2023;76;64;12;84.2105263157895;15.7894736842105;158644.881578947;1750.48684210526;91.7894736842105
29255;2023;8;8;0;100;0;212962.5;2056.875;100.375
29256;2023;25;6;19;24;76;115648.08;2790.68;44.32
29257;2023;24;24;0;100;0;297807.291666667;2628.08333333333;109.416666666667
29259;2023;95;70;25;73.6842105263158;26.3157894736842;199045.894736842;2255.33684210526;89.3052631578947
29260;2023;87;69;18;79.3103448275862;20.6896551724138;251645.988505747;2625.49425287356;96.2758620689655
29261;2023;4;4;0;100;0;127500;1279.25;109
29262;2023;13;13;0;100;0;108419.846153846;1390.15384615385;86.1538461538462
29263;2023;14;14;0;100;0;195953.571428571;1949.35714285714;99.9285714285714
29264;2023;8;8;0;100;0;143223.75;1498.625;99.5
29265;2023;14;14;0;100;0;192857.857142857;1882.85714285714;104.214285714286
29266;2023;42;40;2;95.2380952380952;4.76190476190476;170078.904761905;1716.30952380952;100.595238095238
29267;2023;11;11;0;100;0;91351.0909090909;1050.09090909091;90.0909090909091
29268;2023;10;10;0;100;0;246095;2311;116
29269;2023;23;23;0;100;0;182089.695652174;1872.52173913043;98.8695652173913
29270;2023;21;21;0;100;0;212672.619047619;2220.66666666667;99.1428571428571
29271;2023;9;9;0;100;0;163200;1660.77777777778;100.666666666667
29272;2023;15;15;0;100;0;234710.066666667;2831.2;97.8
29273;2023;26;25;1;96.1538461538462;3.84615384615385;297356.346153846;2885.5;101.923076923077
29274;2023;78;78;0;100;0;127828.679487179;1381.79487179487;97.2820512820513
29275;2023;21;21;0;100;0;93637.1428571429;1255.09523809524;75.6190476190476
29276;2023;17;17;0;100;0;280432.941176471;2557.94117647059;107.823529411765
29277;2023;25;25;0;100;0;164198.4;1531.4;112.12
29278;2023;33;33;0;100;0;109687.272727273;1166.33333333333;92.2727272727273
29279;2023;43;43;0;100;0;148355.488372093;1709.6511627907;95.2790697674419
29280;2023;21;21;0;100;0;299468.80952381;3039.80952380952;103
29281;2023;6;6;0;100;0;174666.666666667;2359.66666666667;87.3333333333333
29282;2023;6;6;0;100;0;320030.333333333;2797.83333333333;112
29284;2023;43;42;1;97.6744186046512;2.32558139534884;282120.418604651;2685.18604651163;111.255813953488
29285;2023;7;7;0;100;0;109680;1031.71428571429;105.285714285714
29287;2023;14;14;0;100;0;156668.214285714;1997.64285714286;83.3571428571429
29288;2023;4;4;0;100;0;196250;1983.5;95.25
29289;2023;2;2;0;100;0;100750;1476.5;71
29290;2023;4;4;0;100;0;164250;1618.5;104.5
29291;2023;13;13;0;100;0;127031.384615385;1453.15384615385;91.1538461538462
29292;2023;2;2;0;100;0;167128;2066.5;86.5
29293;2023;103;94;9;91.2621359223301;8.7378640776699;324906.747572816;3375.63106796117;95.9126213592233
29294;2023;8;8;0;100;0;152475;1518.875;129.25
29295;2023;7;7;0;100;0;241858.571428571;2091.57142857143;113.142857142857
29296;2023;9;9;0;100;0;224633.333333333;2180.66666666667;104.555555555556
29297;2023;30;28;2;93.3333333333333;6.66666666666667;188359.533333333;2105.7;91.8666666666667
29298;2023;5;5;0;100;0;190252.8;1959.8;94.6
29299;2023;1;1;0;100;0;150000;1056;142
29300;2023;18;18;0;100;0;240954.444444444;2448.83333333333;102.611111111111
29301;2023;8;8;0;100;0;176116.25;1630.25;109.25
29302;2023;68;68;0;100;0;122590.897058824;1429.47058823529;89.1323529411765
;2023;18;15;3;83.3333333333333;16.6666666666667;463815.555555556;5213.55555555556;101.277777777778
;2023;749;40;709;5.34045393858478;94.6595460614152;278404.582109479;4027.391188251;69.8357810413885
;2023;18;16;2;88.8888888888889;11.1111111111111;501606.611111111;4448.94444444444;111.222222222222
;2023;44;12;32;27.2727272727273;72.7272727272727;444554.477272727;6334.77272727273;76.2045454545455
;2023;2;2;0;100;0;99290;2468.5;36
;2023;11;10;1;90.9090909090909;9.09090909090909;380737.272727273;4876.45454545455;93
;2023;2;1;1;50;50;252000;2790;82
;2023;3;2;1;66.6666666666667;33.3333333333333;55900;1050.66666666667;49.3333333333333
;2023;5;3;2;60;40;78740;2928.4;34.8
;2023;2;2;0;100;0;235000;4350;55
;2023;2;2;0;100;0;85000;1367.5;69.5
;2023;1;1;0;100;0;30000;1500;20
;2023;4;3;1;75;25;145000;2087.25;73
;2023;18;15;3;83.3333333333333;16.6666666666667;614063.333333333;5714.72222222222;116.722222222222
;2023;3;3;0;100;0;367703.333333333;3450.66666666667;136.333333333333
;2023;4;3;1;75;25;152500;2825.5;64
;2023;48;14;34;29.1666666666667;70.8333333333333;571439.625;5509.95833333333;82.3333333333333
;2023;10;1;9;10;90;214744.2;4910.2;42.8
;2023;1;1;0;100;0;25000;2500;10
;2023;2;2;0;100;0;235000;4167.5;90
;2023;12;4;8;33.3333333333333;66.6666666666667;369110.916666667;4555.58333333333;76.0833333333333
;2023;1;0;1;0;100;20000;417;48
;2023;20;2;18;10;90;195741.2;4530.25;44.6
;2023;1;1;0;100;0;835000;5252;159
;2023;17;10;7;58.8235294117647;41.1764705882353;394816.705882353;4301.47058823529;87.1764705882353
;2023;1;1;0;100;0;30000;517;58
;2023;15;11;4;73.3333333333333;26.6666666666667;366211;4191.66666666667;78.5333333333333
;2023;2;2;0;100;0;325745;3843;85.5
;2023;16;10;6;62.5;37.5;276253.75;4281.5625;63.375
;2023;1;1;0;100;0;46500;1292;36
;2023;13;13;0;100;0;1270520.92307692;8272.46153846154;150.538461538462
;2023;1;1;0;100;0;160000;1684;95
;2023;15;10;5;66.6666666666667;33.3333333333333;348836.6;4345.6;78.5333333333333
;2023;4;4;0;100;0;557335.5;5945.75;99.5
;2023;3;1;2;33.3333333333333;66.6666666666667;73333.3333333333;1124.33333333333;57.3333333333333
;2023;18;16;2;88.8888888888889;11.1111111111111;308048.888888889;3679.77777777778;82.3333333333333
;2023;1;1;0;100;0;310000;1550;200
;2023;1;1;0;100;0;425000;4570;93
;2023;1;1;0;100;0;150000;3125;48
;2023;1;0;1;0;100;45000;900;50
;2023;78;29;49;37.1794871794872;62.8205128205128;399266.538461538;6390.88461538462;64.1923076923077
;2023;1;1;0;100;0;160000;2000;80
;2023;1;1;0;100;0;99000;1165;85
;2023;31;23;8;74.1935483870968;25.8064516129032;788417.709677419;6593.06451612903;105.41935483871
;2023;2;1;1;50;50;44500;685;65
;2023;3;0;3;0;100;102000;1575.33333333333;61
;2023;4;2;2;50;50;51850;1162.5;43.75
;2023;1;1;0;100;0;25196;840;30
;2023;2;2;0;100;0;141869.5;1960;72
;2023;1;0;1;0;100;90000;1059;85
;2023;5;1;4;20;80;214354;5997.6;36.2
;2023;2;1;1;50;50;142000;2845;49.5
;2023;3;3;0;100;0;247000;2247;98.6666666666667
;2023;5;5;0;100;0;251890.8;2677.2;101.4
;2023;17;8;9;47.0588235294118;52.9411764705882;454765.117647059;4433.11764705882;90.5294117647059
;2023;2;2;0;100;0;126500;1821.5;64.5
;2023;1;1;0;100;0;109250;2731;40
;2023;5;2;3;40;60;225400;2277;87.4
;2023;2;2;0;100;0;94280;974;127.5
;2023;1;1;0;100;0;80000;571;140
;2023;8;8;0;100;0;444036.25;4123.625;117.75
;2023;4;2;2;50;50;195407.5;3403.5;58.75
;2023;4;2;2;50;50;150757.5;3259.75;43.75
;2023;10;9;1;90;10;927324;6169.4;112.5
;2023;23;15;8;65.2173913043478;34.7826086956522;640472.347826087;6676.39130434783;95.8260869565217
;2023;4;4;0;100;0;155823.75;2204.25;83.5
;2023;160;75;85;46.875;53.125;552650.7375;6275.19375;83.5875
;2023;49;11;38;22.4489795918367;77.5510204081633;303850.489795918;4337.9387755102;73.8979591836735
;2023;1;1;0;100;0;76000;1070;71
;2023;4;3;1;75;25;108250;1933.75;51.25
;2023;3;3;0;100;0;149665;2859;54
;2023;1;1;0;100;0;120000;2449;49
;2023;1;0;1;0;100;20000;400;50
;2023;18;8;10;44.4444444444444;55.5555555555556;451953.611111111;5140.38888888889;86.1666666666667
;2023;2;0;2;0;100;112500;3487.5;32.5
;2023;17;7;10;41.1764705882353;58.8235294117647;290885.882352941;3915.17647058824;74.0588235294118
;2023;40;16;24;40;60;252868.6;3322.05;69.65
;2023;10;5;5;50;50;346375;4101.4;77.5
;2023;3;0;3;0;100;125016.666666667;1209;90.6666666666667
;2023;2;0;2;0;100;65500;2067;37.5
;2023;3;3;0;100;0;111533.333333333;1299.66666666667;105.666666666667
;2023;2;1;1;50;50;307500;3385.5;85
;2023;2;1;1;50;50;120000;1523.5;80
;2023;22;19;3;86.3636363636364;13.6363636363636;494350.227272727;4961.40909090909;110.409090909091
;2023;3;3;0;100;0;566250;4649;119.333333333333
;2023;14;8;6;57.1428571428571;42.8571428571429;496764.857142857;5164.21428571429;89.8571428571429
;2023;6;3;3;50;50;169718.666666667;2047;65
;2023;1;1;0;100;0;105000;745;141
;2023;3;1;2;33.3333333333333;66.6666666666667;131666.666666667;1604.66666666667;83.6666666666667
;2023;1;0;1;0;100;25000;568;44
;2023;3;3;0;100;0;153000;2805.66666666667;58.6666666666667
;2023;5;5;0;100;0;261000;3211.8;73.2
;2023;1;0;1;0;100;1,00E+05;4000;25
;2023;6;4;2;66.6666666666667;33.3333333333333;123644;1810.16666666667;64.1666666666667
;2023;1;1;0;100;0;2,00E+05;2778;72
;2023;2;2;0;100;0;73350;925.5;78
;2023;16;7;9;43.75;56.25;293163.75;4288.4375;70.3125
;2023;8;6;2;75;25;375014;2809.75;121.625
;2023;3;3;0;100;0;589000;4879.66666666667;104.333333333333
;2023;2;1;1;50;50;50890;1796.5;27.5
;2023;6;5;1;83.3333333333333;16.6666666666667;146666.666666667;2734;81.3333333333333
;2023;1;1;0;100;0;175000;2917;60
;2023;47;35;12;74.468085106383;25.531914893617;812144.829787234;6873.27659574468;109.468085106383
;2023;1;1;0;100;0;398000;2992;133
;2023;15;8;7;53.3333333333333;46.6666666666667;200964.6;2445.26666666667;82.5333333333333
;2023;9;1;8;11.1111111111111;88.8888888888889;399260.444444444;6055.44444444444;59.6666666666667
;2023;2;1;1;50;50;2,00E+05;2250;79.5
;2023;7;4;3;57.1428571428571;42.8571428571429;343555.714285714;4452;69.2857142857143
;2023;2;1;1;50;50;417500;3796.5;110.5
;2023;3;2;1;66.6666666666667;33.3333333333333;232873.333333333;3346;60
;2023;312;8;304;2.56410256410256;97.4358974358974;207953.743589744;3087.00641025641;67.8044871794872
;2023;24;19;5;79.1666666666667;20.8333333333333;186660.416666667;3635.54166666667;52.5833333333333
;2023;1;0;1;0;100;45000;1607;28
;2023;79;23;56;29.1139240506329;70.8860759493671;235863.278481013;3030.24050632911;79.0253164556962
;2023;1;1;0;100;0;3,00E+05;2500;120
;2023;131;57;74;43.5114503816794;56.4885496183206;247791.145038168;3615.45801526718;70.8625954198473
;2023;28;10;18;35.7142857142857;64.2857142857143;333603.571428571;4199.57142857143;77.0714285714286
;2023;1;0;1;0;100;45000;1250;36
;2023;3;1;2;33.3333333333333;66.6666666666667;42333.3333333333;818.666666666667;53.3333333333333
;2023;34;23;11;67.6470588235294;32.3529411764706;259369.5;3513.73529411765;76.2058823529412
;2023;132;10;122;7.57575757575758;92.4242424242424;236853.21969697;4785.21212121212;50.0075757575758
;2023;4;3;1;75;25;87000;1348;71.5
;2023;6;6;0;100;0;213036.666666667;2902.66666666667;70.1666666666667
;2023;6;3;3;50;50;143102.5;2195.16666666667;59.1666666666667
;2023;2;2;0;100;0;67500;3125;21
;2023;4;3;1;75;25;156975;2078.25;72.25
;2023;3;2;1;66.6666666666667;33.3333333333333;211600;2053.66666666667;97
;2023;3;2;1;66.6666666666667;33.3333333333333;100720;1445;69.6666666666667
;2023;1;1;0;100;0;135000;964;140
;2023;4;0;4;0;100;308705;5235.75;57.5
;2023;4;2;2;50;50;124875;2152.75;59.25
;2023;14;4;10;28.5714285714286;71.4285714285714;190407.857142857;2772.28571428571;69.5
;2023;2;1;1;50;50;282059.5;2295.5;98
;2023;9;7;2;77.7777777777778;22.2222222222222;888544.222222222;9103.44444444445;95.8888888888889
;2023;60;3;57;5;95;142464.666666667;3034.31666666667;52.15
;2023;1;1;0;100;0;75000;2143;35
;2023;2;2;0;100;0;143500;1803;79.5
;2023;1;1;0;100;0;44000;936;47
;2023;5;5;0;100;0;175000;2211.6;74.2
;2023;1;1;0;100;0;280000;2667;105
;2023;1;1;0;100;0;1,00E+05;2041;49
;2023;2;0;2;0;100;114900;2217;51
;2023;1;0;1;0;100;27000;750;36
;2023;34;16;18;47.0588235294118;52.9411764705882;279717.882352941;3312.29411764706;82.2058823529412
;2023;3;3;0;100;0;321576.666666667;1722;149
;2023;2;1;1;50;50;53750;588;93.5
;2023;31;20;11;64.5161290322581;35.4838709677419;214395.806451613;2496.1935483871;86.4516129032258
;2023;3;1;2;33.3333333333333;66.6666666666667;102263.333333333;1778.33333333333;67.3333333333333
;2023;64;2;62;3.125;96.875;237906.890625;4571.234375;52.546875
;2023;3;2;1;66.6666666666667;33.3333333333333;211823.333333333;2779.33333333333;86.6666666666667
;2023;4;3;1;75;25;172249.5;3082.25;60.5
;2023;1;0;1;0;100;271000;3305;82
;2023;43;7;36;16.2790697674419;83.7209302325581;119521.395348837;2671.04651162791;44.4883720930233
;2023;2;0;2;0;100;104975;1383;80
;2023;1;0;1;0;100;35000;636;55
;2023;80;31;49;38.75;61.25;185630.8625;3178.0375;60.325
;2023;44;14;30;31.8181818181818;68.1818181818182;437980.931818182;5775.13636363636;71.5
;2023;8;4;4;50;50;243440.625;4457.5;52.5
;2023;1;1;0;100;0;50000;909;55
;2023;1;1;0;100;0;120000;857;140
;2023;1;1;0;100;0;65000;903;72
;2023;2;1;1;50;50;66000;2039.5;45.5
;2023;2;2;0;100;0;215070;2146.5;100
;2023;1;0;1;0;100;170000;3400;50
;2023;2;0;2;0;100;145825;2581.5;71.5
;2023;5;3;2;60;40;184390;3332.4;50.2
;2023;23;12;11;52.1739130434783;47.8260869565217;473963.52173913;4945.21739130435;92.6086956521739
;2023;2;1;1;50;50;159500;2918.5;51.5
;2023;4;1;3;25;75;112427.5;1639.25;63.5
;2023;5;5;0;100;0;223581;3214;75
;2023;5;3;2;60;40;215000;2037;116.2
;2023;1;1;0;100;0;128860;4602;28
;2023;1;1;0;100;0;2,00E+05;2000;100
;2023;1;1;0;100;0;30000;462;65
;2023;1;1;0;100;0;155251;4436;35
;2023;1;1;0;100;0;190000;3800;50
;2023;25;11;14;44;56;208873.4;3286.68;63.52
;2023;2;1;1;50;50;192500;2022;101.5
;2023;3;1;2;33.3333333333333;66.6666666666667;298373.333333333;2209;88.6666666666667
;2023;1;1;0;100;0;42500;1012;42
;2023;3;2;1;66.6666666666667;33.3333333333333;155000;1791.66666666667;82
;2023;1;1;0;100;0;266020;2660;100
;2023;1;1;0;100;0;180000;800;225
;2023;2;2;0;100;0;405000;4864.5;95
;2023;1;1;0;100;0;155550;2636;59
;2023;18;10;8;55.5555555555556;44.4444444444444;264070.111111111;3964.38888888889;64.4444444444444
;2023;26;13;13;50;50;218207.038461538;2673;81.5
;2023;1;1;0;100;0;1,00E+05;1250;80
;2023;1;0;1;0;100;60000;750;80
;2023;1;1;0;100;0;45000;938;48
;2023;1;1;0;100;0;150000;1667;90
;2023;2;2;0;100;0;255000;2620.5;98
;2023;1;1;0;100;0;210000;1780;118
;2023;1;0;1;0;100;35000;833;42
;2023;4;1;3;25;75;186500;2069.75;80
;2023;10;8;2;80;20;270807.5;4188;74.5
;2023;1;1;0;100;0;182850;4571;40
;2023;1;1;0;100;0;230000;1513;152
;2023;1;0;1;0;100;77269;773;100
;2023;2;2;0;100;0;29497.5;821.5;39
;2023;1;1;0;100;0;245000;2917;84
;2023;3;1;2;33.3333333333333;66.6666666666667;151666.666666667;4475;54.3333333333333
;2023;1;0;1;0;100;53000;757;70
;2023;2;1;1;50;50;233750;2906;90
;2023;6;4;2;66.6666666666667;33.3333333333333;407078.333333333;3449.66666666667;99.1666666666667
;2023;34;18;16;52.9411764705882;47.0588235294118;136708.647058824;3290.61764705882;42.7941176470588
;2023;1;1;0;100;0;40000;1000;40
;2023;2;2;0;100;0;87500;1416.5;62.5
;2023;1;0;1;0;100;76000;1551;49
;2023;2;0;2;0;100;135750;1982.5;74.5
;2023;3;2;1;66.6666666666667;33.3333333333333;53411.6666666667;1292.33333333333;40.6666666666667
;2023;26;22;4;84.6153846153846;15.3846153846154;268284.269230769;2940.15384615385;100.692307692308
;2023;1;1;0;100;0;35000;1000;35
;2023;2;1;1;50;50;245820;2589;94.5
;2023;3;0;3;0;100;75333.3333333333;2768.33333333333;27.6666666666667
;2023;11;7;4;63.6363636363636;36.3636363636364;170624.363636364;2638.63636363636;67.1818181818182
;2023;1;1;0;100;0;80000;1600;50
;2023;5;2;3;40;60;93936;1518;60.2
;2023;1;1;0;100;0;190000;1583;120
;2023;1;1;0;100;0;343742;3508;98
;2023;2;1;1;50;50;265490;2581.5;102
;2023;14;12;2;85.7142857142857;14.2857142857143;294075;3246.71428571429;84.2857142857143
;2023;10;8;2;80;20;347787.3;2986.6;106.1
;2023;8;6;2;75;25;243688.875;1892.75;136.75
;2023;3;3;0;100;0;77000;2439.33333333333;29.6666666666667
;2023;3;2;1;66.6666666666667;33.3333333333333;58666.6666666667;1470;52
;2023;1;1;0;100;0;70000;1077;65
;2023;3;3;0;100;0;583666.666666667;6601.33333333333;87.6666666666667
;2023;1;1;0;100;0;37000;712;52
;2023;28;7;21;25;75;320638.821428571;4843.5;67.5357142857143
;2023;3;1;2;33.3333333333333;66.6666666666667;40295.6666666667;957.666666666667;41.6666666666667
;2023;1;0;1;0;100;168000;1976;85
;2023;27;5;22;18.5185185185185;81.4814814814815;217818.555555556;3339.33333333333;65.7407407407407
;2023;1;1;0;100;0;130000;2167;60
;2023;29;12;17;41.3793103448276;58.6206896551724;199476.586206897;3294.24137931034;59.4137931034483
;2023;12;5;7;41.6666666666667;58.3333333333333;387360.833333333;4602.83333333333;81.9166666666667
;2023;11;7;4;63.6363636363636;36.3636363636364;212923.636363636;3204.27272727273;63.0909090909091
;2023;52;10;42;19.2307692307692;80.7692307692308;140467.153846154;3003.59615384615;51.3076923076923
;2023;7;5;2;71.4285714285714;28.5714285714286;205564.285714286;3388.71428571429;60.4285714285714
;2023;13;9;4;69.2307692307692;30.7692307692308;332037.769230769;4562.92307692308;83.3076923076923
;2023;1;0;1;0;100;57700;2061;28
;2023;7;5;2;71.4285714285714;28.5714285714286;155357.142857143;2404.28571428571;65.5714285714286
;2023;1;1;0;100;0;270000;3176;85
;2023;2;2;0;100;0;282000;3929.5;70.5
;2023;2;0;2;0;100;22500;781.5;30
;2023;5;3;2;60;40;194506;3398.2;58
;2023;1;1;0;100;0;210000;2333;90
;2023;2;0;2;0;100;46500;2008;23.5
;2023;2;2;0;100;0;174707.5;2053;83
;2023;3;3;0;100;0;219333.333333333;2469.66666666667;86.6666666666667
;2023;1;0;1;0;100;25000;472;53
;2023;1;1;0;100;0;138750;2668;52
;2023;1;1;0;100;0;150000;2206;68
;2023;6;3;3;50;50;222225;2301.66666666667;94.3333333333333
;2023;11;7;4;63.6363636363636;36.3636363636364;326037.818181818;3338.81818181818;96.1818181818182
;2023;11;9;2;81.8181818181818;18.1818181818182;297065.818181818;3190.90909090909;96.1818181818182
;2023;2;2;0;100;0;146250;2512;57
;2023;18;12;6;66.6666666666667;33.3333333333333;243923;3114.44444444444;82.7222222222222
;2023;3;2;1;66.6666666666667;33.3333333333333;286535.333333333;2696.66666666667;97.3333333333333
;2023;2;1;1;50;50;36500;1122.5;32.5
;2023;3;2;1;66.6666666666667;33.3333333333333;544353.333333333;4183.66666666667;108.666666666667
;2023;31;4;27;12.9032258064516;87.0967741935484;286271.580645161;3635.16129032258;77.2258064516129
;2023;3;2;1;66.6666666666667;33.3333333333333;203500;2114.66666666667;97.6666666666667
;2023;3;3;0;100;0;97500;1643.66666666667;53.6666666666667
;2023;2;1;1;50;50;248000;3228.5;77.5
;2023;3;3;0;100;0;205483.333333333;3067.33333333333;56.6666666666667
;2023;3;2;1;66.6666666666667;33.3333333333333;74123.3333333333;1268.66666666667;51.6666666666667
;2023;2;1;1;50;50;75000;1213;54
30001;2023;6;6;0;100;0;322858.333333333;3110;104.5
30002;2023;12;12;0;100;0;236030.833333333;2483;94.4166666666667
30003;2023;141;106;35;75.177304964539;24.822695035461;310600.659574468;4222.64539007092;74.3971631205674
30004;2023;39;34;5;87.1794871794872;12.8205128205128;338211.538461538;3109.69230769231;110.717948717949
30005;2023;4;4;0;100;0;251216.75;2160;141
30006;2023;73;65;8;89.041095890411;10.958904109589;278556.616438356;3079.78082191781;91.1232876712329
30007;2023;553;269;284;48.6437613019892;51.3562386980108;146621.618444846;1931.90596745027;75.0560578661844
30008;2023;12;12;0;100;0;232790.416666667;2173.16666666667;105.25
30009;2023;6;5;1;83.3333333333333;16.6666666666667;78750;971.833333333333;77.6666666666667
30010;2023;43;31;12;72.0930232558139;27.906976744186;234416.88372093;2577.48837209302;90.6279069767442
30011;2023;131;66;65;50.381679389313;49.618320610687;319687.175572519;3582.99236641221;85.2900763358779
30012;2023;47;43;4;91.4893617021277;8.51063829787234;215276.595744681;2324.82978723404;90.3617021276596
30013;2023;5;5;0;100;0;474607;3114.8;143.8
30014;2023;12;12;0;100;0;365652.083333333;3790.25;106.166666666667
30015;2023;3;3;0;100;0;86666.6666666667;1658.33333333333;49.6666666666667
30016;2023;5;2;3;40;60;89630;1233;72.8
30017;2023;3;2;1;66.6666666666667;33.3333333333333;97126.6666666667;2860.33333333333;65.6666666666667
30018;2023;1;1;0;100;0;330000;3028;109
30019;2023;32;29;3;90.625;9.375;353817.28125;2951.28125;119.9375
30020;2023;12;10;2;83.3333333333333;16.6666666666667;269362.916666667;2772.25;96.1666666666667
30021;2023;7;6;1;85.7142857142857;14.2857142857143;703076.428571429;3844.85714285714;165.857142857143
30022;2023;1;1;0;100;0;120000;3000;40
30023;2023;14;14;0;100;0;364476.428571429;4238;112.642857142857
30024;2023;7;7;0;100;0;142072.428571429;1757.85714285714;79.1428571428571
30025;2023;4;4;0;100;0;131215;1695.5;85.5
30026;2023;15;10;5;66.6666666666667;33.3333333333333;101387.333333333;1328.86666666667;73.2
30027;2023;25;25;0;100;0;267942;2446.88;111.12
30028;2023;241;119;122;49.3775933609959;50.6224066390041;161162.182572614;2016.07883817427;79.1203319502075
30029;2023;19;17;2;89.4736842105263;10.5263157894737;233289.052631579;2730.21052631579;86.5263157894737
30030;2023;10;8;2;80;20;206013.5;3014.3;81.4
30031;2023;2;2;0;100;0;177590;2442;67.5
30032;2023;159;89;70;55.9748427672956;44.0251572327044;161797.220125786;1895.93081761006;83.4213836477987
30033;2023;45;40;5;88.8888888888889;11.1111111111111;251823.244444444;2720.71111111111;95.1777777777778
30034;2023;65;59;6;90.7692307692308;9.23076923076923;241425.123076923;2835.95384615385;84.6461538461539
30035;2023;9;9;0;100;0;303771.111111111;3223.77777777778;96.7777777777778
30036;2023;48;38;10;79.1666666666667;20.8333333333333;230231.270833333;2617.52083333333;87.75
30037;2023;37;22;15;59.4594594594595;40.5405405405405;123353.918918919;1364.10810810811;89.4324324324324
30038;2023;5;3;2;60;40;117380;1500.8;74.8
30039;2023;26;25;1;96.1538461538462;3.84615384615385;225414.038461538;2409.53846153846;95.8076923076923
30040;2023;5;5;0;100;0;145602.6;1750.2;84
30041;2023;17;17;0;100;0;354486.470588235;3293.41176470588;111.411764705882
30042;2023;25;24;1;96;4;297009;2682.08;114.6
30043;2023;1;1;0;100;0;144500;3440;42
30044;2023;1;1;0;100;0;250000;3906;64
30045;2023;7;6;1;85.7142857142857;14.2857142857143;172808.571428571;2381.42857142857;69.5714285714286
30046;2023;6;6;0;100;0;172216.666666667;2108.66666666667;80.5
30047;2023;51;41;10;80.3921568627451;19.6078431372549;273621.470588235;3016.27450980392;90.4117647058823
30048;2023;4;4;0;100;0;498500;3555.5;145.75
30049;2023;4;4;0;100;0;210472.5;2827.5;75.5
30050;2023;4;4;0;100;0;304862.5;2383.25;122
30051;2023;15;13;2;86.6666666666667;13.3333333333333;145540.666666667;1786.4;84.5333333333333
30052;2023;8;8;0;100;0;170609.375;1721;94.25
30053;2023;10;10;0;100;0;147950;1638.5;84.2
30054;2023;1;1;0;100;0;569700;2191;260
30055;2023;6;6;0;100;0;251000;2324;109.166666666667
30056;2023;9;9;0;100;0;427581.111111111;3084.77777777778;128.222222222222
30057;2023;11;11;0;100;0;274731.727272727;3262.81818181818;83.7272727272727
30058;2023;2;2;0;100;0;152500;1336;135.5
30059;2023;30;30;0;100;0;285187.133333333;2987;94.2
30060;2023;41;35;6;85.3658536585366;14.6341463414634;266066;2757.19512195122;99.1951219512195
30061;2023;23;19;4;82.6086956521739;17.3913043478261;247894.695652174;2745.26086956522;92.9565217391304
30062;2023;134;85;49;63.4328358208955;36.5671641791045;230712.828358209;3115.91044776119;73.7089552238806
30064;2023;4;4;0;100;0;56000;1435;45.5
30065;2023;4;4;0;100;0;356000;2297.75;145.5
30066;2023;6;6;0;100;0;287841.666666667;2460.66666666667;110.5
30067;2023;10;10;0;100;0;243990;2651.9;87.6
30068;2023;2;2;0;100;0;167500;1902;86
30069;2023;7;7;0;100;0;303607.142857143;2876.57142857143;107.571428571429
30070;2023;6;6;0;100;0;212645.833333333;2286.83333333333;96.1666666666667
30071;2023;5;4;1;80;20;120900;1591.2;74.8
30072;2023;8;8;0;100;0;220443.75;2130.75;92.25
30073;2023;21;20;1;95.2380952380952;4.76190476190476;500206.095238095;4287.33333333333;122.952380952381
30075;2023;32;31;1;96.875;3.125;272211.375;3219.375;88.625
30076;2023;10;9;1;90;10;245010.5;2634.8;94.7
30077;2023;6;5;1;83.3333333333333;16.6666666666667;218841.666666667;2293.5;89.8333333333333
30079;2023;5;5;0;100;0;206070;1918.4;106.2
30080;2023;18;14;4;77.7777777777778;22.2222222222222;117103.333333333;1591;74.2222222222222
30081;2023;10;9;1;90;10;256347;2937.4;90.7
30082;2023;39;34;5;87.1794871794872;12.8205128205128;273681.871794872;2837.4358974359;98.5897435897436
30083;2023;27;23;4;85.1851851851852;14.8148148148148;320917.62962963;3595.96296296296;92.3703703703704
30084;2023;10;10;0;100;0;221067.5;2689.2;88.9
30085;2023;14;14;0;100;0;288488.571428571;2523.14285714286;121.928571428571
30086;2023;10;10;0;100;0;429115.3;4912.9;97.2
30087;2023;4;4;0;100;0;182423.75;2127.25;91.5
30088;2023;7;7;0;100;0;215510.857142857;2228;101.714285714286
30089;2023;23;23;0;100;0;239391.739130435;2567.08695652174;99.1304347826087
30090;2023;4;4;0;100;0;112422.5;2035.75;55.25
30091;2023;18;18;0;100;0;312334.833333333;3227.66666666667;96.6666666666667
30092;2023;27;24;3;88.8888888888889;11.1111111111111;237358.518518519;2637.62962962963;91.7407407407407
30093;2023;1;1;0;100;0;421350;3121;135
30094;2023;3;2;1;66.6666666666667;33.3333333333333;233833.333333333;3088.66666666667;79
30095;2023;11;11;0;100;0;243526.454545455;2887.45454545455;87.5454545454545
30096;2023;6;6;0;100;0;253708.333333333;3200.66666666667;83.8333333333333
30097;2023;7;6;1;85.7142857142857;14.2857142857143;216142.857142857;2597.85714285714;92.2857142857143
30098;2023;1;1;0;100;0;254560;3104;82
30099;2023;5;5;0;100;0;191000;2419.6;105.2
30100;2023;9;8;1;88.8888888888889;11.1111111111111;206620.222222222;2119.66666666667;99.7777777777778
30101;2023;2;2;0;100;0;334000;1775;188.5
30102;2023;12;12;0;100;0;195363.333333333;1758.08333333333;106.833333333333
30103;2023;10;8;2;80;20;304277.5;2473.1;112.6
30104;2023;6;6;0;100;0;215439.166666667;2268.83333333333;95.8333333333333
30105;2023;8;6;2;75;25;179171.25;2350.125;71.875
30106;2023;8;7;1;87.5;12.5;245932.5;2134.75;121.25
30107;2023;4;4;0;100;0;461393.75;4502.75;102.25
30108;2023;3;3;0;100;0;285333.333333333;3029;106.666666666667
30109;2023;1;1;0;100;0;306050;3826;80
30110;2023;11;11;0;100;0;439230.454545455;3333.54545454545;128.181818181818
30111;2023;3;3;0;100;0;377141;3246;109
30112;2023;19;19;0;100;0;249968.421052632;2661.94736842105;96.8947368421053
30113;2023;7;7;0;100;0;330800;3692.57142857143;104.857142857143
30114;2023;8;6;2;75;25;264756.25;2740.875;102.25
30115;2023;7;6;1;85.7142857142857;14.2857142857143;315722.428571429;3343.14285714286;87
30116;2023;13;13;0;100;0;176459.230769231;2199.23076923077;79.1538461538462
30117;2023;27;22;5;81.4814814814815;18.5185185185185;216188.962962963;2769.77777777778;78
30119;2023;2;2;0;100;0;394000;1786.5;180
30120;2023;14;14;0;100;0;212096.428571429;2211.85714285714;101.428571428571
30121;2023;2;2;0;100;0;328200;3418.5;96
30122;2023;8;8;0;100;0;235596.25;2531.375;101.375
30123;2023;44;38;6;86.3636363636364;13.6363636363636;267706.545454545;3102.09090909091;83.7954545454545
30124;2023;3;3;0;100;0;600953.333333333;4104.66666666667;144.666666666667
30125;2023;37;29;8;78.3783783783784;21.6216216216216;232873.837837838;2812.72972972973;87.4864864864865
30126;2023;11;11;0;100;0;367098.727272727;3508.09090909091;103.818181818182
30127;2023;17;17;0;100;0;236578.117647059;2425.23529411765;96.8235294117647
30128;2023;48;38;10;79.1666666666667;20.8333333333333;226252.125;2528.58333333333;88.6666666666667
30129;2023;3;3;0;100;0;330733.333333333;3954;82.6666666666667
30130;2023;17;14;3;82.3529411764706;17.6470588235294;116836.235294118;1312.23529411765;85.1176470588235
30131;2023;19;16;3;84.2105263157895;15.7894736842105;267200;3014.47368421053;97.3684210526316
30132;2023;42;18;24;42.8571428571429;57.1428571428571;101525.357142857;1201.21428571429;89.2380952380952
30133;2023;724;41;683;5.66298342541436;94.3370165745856;211651.965469613;5538.87430939226;37.3867403314917
30134;2023;5;5;0;100;0;294124;2278;116.6
30135;2023;33;29;4;87.8787878787879;12.1212121212121;211977.727272727;2432.84848484848;87.1515151515152
30136;2023;13;13;0;100;0;280312.923076923;3758.23076923077;73.3846153846154
30137;2023;4;4;0;100;0;280402.25;2541.5;112.25
30138;2023;16;16;0;100;0;332927.375;3224.5;104.5
30139;2023;3;3;0;100;0;120433.333333333;1480.33333333333;101
30140;2023;15;12;3;80;20;97456.3333333333;1404;79
30141;2023;60;53;7;88.3333333333333;11.6666666666667;265495.466666667;2702.03333333333;98.5333333333333
30142;2023;7;7;0;100;0;99371.4285714286;1370.42857142857;67.4285714285714
30143;2023;3;3;0;100;0;240000;2559;90.3333333333333
30144;2023;3;3;0;100;0;216283.333333333;2442.33333333333;84.6666666666667
30145;2023;16;16;0;100;0;226623.3125;2367.9375;102.375
30146;2023;12;12;0;100;0;190368.333333333;2373.58333333333;79.1666666666667
30147;2023;11;9;2;81.8181818181818;18.1818181818182;216232.545454545;2529.63636363636;85.6363636363636
30148;2023;5;5;0;100;0;297454;3163.6;90.8
30149;2023;8;8;0;100;0;227610.375;2439.75;100.75
30150;2023;2;2;0;100;0;182000;2289;82
30151;2023;15;14;1;93.3333333333333;6.66666666666667;380809.333333333;3168.53333333333;113.2
30152;2023;16;14;2;87.5;12.5;253088;2320.5625;108.375
30154;2023;7;7;0;100;0;172714.285714286;3138.28571428571;100.428571428571
30155;2023;57;56;1;98.2456140350877;1.75438596491228;261356.842105263;2754.77192982456;95.8771929824561
30156;2023;86;62;24;72.0930232558139;27.906976744186;245321.069767442;2936.66279069767;86.7325581395349
30158;2023;3;3;0;100;0;329873.333333333;2638.33333333333;124.333333333333
30159;2023;15;10;5;66.6666666666667;33.3333333333333;146213.333333333;1619.2;91.6666666666667
30160;2023;4;4;0;100;0;212758.75;2472.25;85
30161;2023;6;5;1;83.3333333333333;16.6666666666667;330418.333333333;2651.83333333333;120.5
30162;2023;13;12;1;92.3076923076923;7.69230769230769;259973.076923077;2864.07692307692;97.5384615384615
30163;2023;3;3;0;100;0;268200;2757;96
30164;2023;31;28;3;90.3225806451613;9.67741935483871;177139.741935484;2299.35483870968;74.3548387096774
30165;2023;15;15;0;100;0;260118.666666667;2414.66666666667;104.266666666667
30166;2023;24;21;3;87.5;12.5;248029;2798.25;82.5833333333333
30167;2023;10;9;1;90;10;151410;1576.6;101.1
30168;2023;11;11;0;100;0;319790.909090909;2903.27272727273;109.545454545455
30169;2023;51;40;11;78.4313725490196;21.5686274509804;228090.941176471;2913.90196078431;81.6078431372549
30170;2023;12;11;1;91.6666666666667;8.33333333333333;208028.333333333;2188.58333333333;96.5
30171;2023;11;11;0;100;0;227363.636363636;1793.72727272727;123.272727272727
30172;2023;3;3;0;100;0;168660;1880.33333333333;77
30173;2023;17;17;0;100;0;263469;2657.70588235294;103.058823529412
30174;2023;25;25;0;100;0;410950.04;3776.28;103.76
30175;2023;1;1;0;100;0;182420;2280;80
30176;2023;4;4;0;100;0;101755;1325.25;65.75
30177;2023;3;3;0;100;0;213516.666666667;2140.66666666667;104
30178;2023;14;14;0;100;0;265113.928571429;2688;99
30179;2023;37;33;4;89.1891891891892;10.8108108108108;218371.027027027;2489.83783783784;92.054054054054
30180;2023;6;6;0;100;0;236395;2730;87.8333333333333
30181;2023;4;4;0;100;0;267921.25;2251.75;118.25
30182;2023;10;10;0;100;0;254565.7;2590.3;99
30183;2023;9;7;2;77.7777777777778;22.2222222222222;222172.222222222;1884.22222222222;112.111111111111
30184;2023;18;18;0;100;0;253663.333333333;2287.72222222222;111.833333333333
30185;2023;23;19;4;82.6086956521739;17.3913043478261;327313.47826087;3370.4347826087;95.6086956521739
30186;2023;23;23;0;100;0;383877.086956522;3799.86956521739;101.95652173913
30187;2023;2;2;0;100;0;143228;1564.5;92
30188;2023;8;8;0;100;0;208986.25;2142.5;102
30189;2023;2287;587;1700;25.6668124180149;74.3331875819851;172751.351114998;2466.70922606034;68.4359422824661
30191;2023;16;15;1;93.75;6.25;236099.3125;2309.5625;102.375
30192;2023;7;6;1;85.7142857142857;14.2857142857143;328750;3568.57142857143;93.7142857142857
30193;2023;6;5;1;83.3333333333333;16.6666666666667;325353.333333333;2369.5;138.5
30194;2023;5;5;0;100;0;183740;3205;74.4
30196;2023;5;5;0;100;0;318730;3573.4;92.8
30197;2023;1;1;0;100;0;433500;2744;158
30198;2023;4;4;0;100;0;187601.75;2262.5;80
30200;2023;14;13;1;92.8571428571429;7.14285714285714;228379.285714286;1883.85714285714;115.785714285714
30201;2023;7;7;0;100;0;154214.285714286;1793.14285714286;86.7142857142857
30202;2023;159;93;66;58.4905660377358;41.5094339622642;155179.622641509;1857.93710691824;80
30203;2023;6;6;0;100;0;232383.333333333;2606;109.166666666667
30204;2023;5;4;1;80;20;501250;4649.6;102.8
30205;2023;5;5;0;100;0;277309;2788.4;98.4
30206;2023;50;50;0;100;0;349069.62;3319.9;104.86
30207;2023;11;11;0;100;0;284027.090909091;2678.09090909091;109.272727272727
30209;2023;40;36;4;90;10;429535.325;3737.25;110
30210;2023;43;34;9;79.0697674418605;20.9302325581395;215209.162790698;2575.76744186047;85.3720930232558
30211;2023;37;35;2;94.5945945945946;5.40540540540541;251481.72972973;2643.56756756757;96.6486486486486
30212;2023;23;15;8;65.2173913043478;34.7826086956522;188028.782608696;2247.17391304348;80.304347826087
30213;2023;1;1;0;100;0;127700;2838;45
30214;2023;19;17;2;89.4736842105263;10.5263157894737;225923.684210526;2345;96.3684210526316
30215;2023;3;3;0;100;0;222833.333333333;1986.66666666667;108.666666666667
30216;2023;19;16;3;84.2105263157895;15.7894736842105;126033.789473684;1512.15789473684;85.4210526315789
30217;2023;84;82;2;97.6190476190476;2.38095238095238;311764.333333333;3260.29761904762;94.7380952380952
30218;2023;8;8;0;100;0;373010;3328.125;114.125
30219;2023;2;2;0;100;0;141775;1625.5;83
30220;2023;4;4;0;100;0;227381.25;2299.75;91
30221;2023;54;45;9;83.3333333333333;16.6666666666667;210029.074074074;2398.66666666667;90.8333333333333
30222;2023;4;4;0;100;0;233725;3097.5;77.25
30223;2023;42;40;2;95.2380952380952;4.76190476190476;256680.380952381;2519.92857142857;100.452380952381
30224;2023;7;7;0;100;0;230655.428571429;2491.57142857143;93.2857142857143
30225;2023;15;15;0;100;0;256336;2609.6;89.8666666666667
30226;2023;6;6;0;100;0;287403.333333333;2890.5;100.166666666667
30227;2023;42;28;14;66.6666666666667;33.3333333333333;137616.428571429;1857.59523809524;70.6428571428571
30228;2023;18;17;1;94.4444444444444;5.55555555555556;257591.444444444;2755.16666666667;92.5
30229;2023;7;6;1;85.7142857142857;14.2857142857143;122482.857142857;1548.57142857143;77.2857142857143
30230;2023;14;14;0;100;0;330077.428571429;3572.42857142857;87.2857142857143
30231;2023;10;9;1;90;10;90772;1514.4;68
30232;2023;6;6;0;100;0;410766.666666667;3374.16666666667;121.333333333333
30233;2023;7;7;0;100;0;256045.714285714;2577.57142857143;107.857142857143
30234;2023;4;4;0;100;0;290081.25;2503.5;120
30235;2023;14;14;0;100;0;199079.642857143;2500.92857142857;78.0714285714286
30237;2023;10;9;1;90;10;179400;1857.5;98.3
30238;2023;2;2;0;100;0;110500;913;103.5
30239;2023;5;5;0;100;0;143980;1746.4;86.8
30240;2023;4;4;0;100;0;221411.5;2087.5;100.75
30241;2023;15;15;0;100;0;258038.133333333;2586.2;99.6
30242;2023;2;2;0;100;0;231075;2623.5;82.5
30243;2023;70;60;10;85.7142857142857;14.2857142857143;223581.371428571;2448.2;90.0285714285714
30244;2023;3;3;0;100;0;344784;3316;97
30245;2023;2;1;1;50;50;478160;2775.5;163
30246;2023;1;0;1;0;100;108000;1543;70
30248;2023;6;6;0;100;0;287937.5;2815.33333333333;108.166666666667
30249;2023;7;7;0;100;0;340235.714285714;3122.71428571429;112.571428571429
30250;2023;2;2;0;100;0;359682.5;2775;131.5
30251;2023;6;4;2;66.6666666666667;33.3333333333333;168316.666666667;3048;91.6666666666667
30252;2023;3;3;0;100;0;281033.333333333;2258.66666666667;94.3333333333333
30253;2023;14;11;3;78.5714285714286;21.4285714285714;182171.571428571;1943.14285714286;96.7857142857143
30254;2023;24;23;1;95.8333333333333;4.16666666666667;287499.583333333;2753.70833333333;106
30255;2023;27;25;2;92.5925925925926;7.40740740740741;235343.333333333;2295.48148148148;101.555555555556
30256;2023;11;11;0;100;0;175386.363636364;1915.54545454545;88.1818181818182
30257;2023;15;14;1;93.3333333333333;6.66666666666667;252500;2888;94.4666666666667
30258;2023;157;106;51;67.515923566879;32.484076433121;187750.286624204;2297.75796178344;80.7388535031847
30259;2023;41;41;0;100;0;232043.12195122;2316.46341463415;104.536585365854
30260;2023;13;13;0;100;0;305529.846153846;2944.53846153846;109.384615384615
30261;2023;2;2;0;100;0;222000;2485.5;90
30262;2023;3;3;0;100;0;253596.666666667;1971.33333333333;122
30263;2023;41;26;15;63.4146341463415;36.5853658536585;154838.902439024;1991.39024390244;78.4634146341463
30264;2023;4;3;1;75;25;183000;1768.5;101.5
30265;2023;4;4;0;100;0;322845;2802.25;115
30266;2023;14;13;1;92.8571428571429;7.14285714285714;236214.285714286;2468.92857142857;97.5714285714286
30267;2023;12;11;1;91.6666666666667;8.33333333333333;135355;1548.75;93.5833333333333
30268;2023;4;4;0;100;0;130650;1657.75;80.75
30269;2023;29;21;8;72.4137931034483;27.5862068965517;196918;2527.44827586207;78.1724137931034
30270;2023;8;8;0;100;0;288606.25;2804.875;105.75
30271;2023;3;3;0;100;0;121000;1442.66666666667;80.6666666666667
30272;2023;1;1;0;100;0;82000;1673;49
30273;2023;19;19;0;100;0;261138.947368421;2456.84210526316;106.631578947368
30274;2023;28;26;2;92.8571428571429;7.14285714285714;223926.857142857;2367.57142857143;93.3928571428571
30275;2023;2;2;0;100;0;197702.5;1578;127.5
30276;2023;57;52;5;91.2280701754386;8.7719298245614;288694.385964912;3475.05263157895;82.7017543859649
30277;2023;2;2;0;100;0;234650;2569;93.5
30278;2023;24;20;4;83.3333333333333;16.6666666666667;296681.916666667;3019.66666666667;97.375
30279;2023;16;15;1;93.75;6.25;269598.3125;2610.1875;100
30280;2023;9;6;3;66.6666666666667;33.3333333333333;149055.555555556;1346.11111111111;106.777777777778
30281;2023;23;19;4;82.6086956521739;17.3913043478261;232849.956521739;2531.95652173913;95.8695652173913
30282;2023;8;8;0;100;0;215596.25;2236.5;103.125
30283;2023;2;2;0;100;0;265000;5956;54
30284;2023;36;33;3;91.6666666666667;8.33333333333333;188771.111111111;2055;95.6111111111111
30285;2023;11;9;2;81.8181818181818;18.1818181818182;233068.545454545;2374.09090909091;97.9090909090909
30286;2023;28;28;0;100;0;384601.785714286;3393.96428571429;110.5
30287;2023;12;11;1;91.6666666666667;8.33333333333333;194479.166666667;2018.25;93.6666666666667
30288;2023;18;9;9;50;50;125748.888888889;1600.22222222222;69.8333333333333
30289;2023;1;1;0;100;0;59400;742;80
30290;2023;16;16;0;100;0;282563.125;2584.625;110.5625
30291;2023;1;1;0;100;0;339200;3533;96
30292;2023;5;5;0;100;0;234274;2388;103.8
30293;2023;3;3;0;100;0;274311.666666667;3754.33333333333;77.3333333333333
30294;2023;49;40;9;81.6326530612245;18.3673469387755;235432.653061224;2490.08163265306;95
30295;2023;49;45;4;91.8367346938776;8.16326530612245;320478.775510204;3235.0612244898;97.4285714285714
30296;2023;3;3;0;100;0;361166.666666667;6860.66666666667;140
30297;2023;13;12;1;92.3076923076923;7.69230769230769;188429.846153846;3041.76923076923;71.4615384615385
30298;2023;7;7;0;100;0;313592;2575.85714285714;122.142857142857
30299;2023;33;33;0;100;0;507294.424242424;4044.24242424242;128.545454545455
30300;2023;7;6;1;85.7142857142857;14.2857142857143;237601.714285714;2139.85714285714;119.714285714286
30301;2023;7;7;0;100;0;390271.428571429;3560.42857142857;115.142857142857
30302;2023;14;14;0;100;0;289499.285714286;2431.64285714286;120.285714285714
30303;2023;12;11;1;91.6666666666667;8.33333333333333;223415.833333333;2470.75;83.3333333333333
30304;2023;6;6;0;100;0;264083.333333333;2771.5;96.3333333333333
30305;2023;35;28;7;80;20;170805.428571429;2184.48571428571;81.6285714285714
30306;2023;4;4;0;100;0;192642.5;2378.75;81
30307;2023;24;17;7;70.8333333333333;29.1666666666667;113388.125;1252.79166666667;89.4166666666667
30308;2023;8;8;0;100;0;581835;3919.125;140.125
30309;2023;3;3;0;100;0;320025.333333333;2729.33333333333;105
30310;2023;2;2;0;100;0;315000;2805.5;105
30311;2023;32;20;12;62.5;37.5;174720.46875;2333.21875;81.15625
30312;2023;21;20;1;95.2380952380952;4.76190476190476;403540.952380952;3209.04761904762;121.380952380952
30313;2023;8;8;0;100;0;297118.75;2575.875;112.875
30314;2023;3;3;0;100;0;272966.666666667;2206;122.666666666667
30315;2023;14;14;0;100;0;277048.571428571;3111.92857142857;95.7857142857143
30316;2023;3;3;0;100;0;97576.6666666667;1604.66666666667;61.3333333333333
30317;2023;21;20;1;95.2380952380952;4.76190476190476;196613;2126.09523809524;91.5714285714286
30318;2023;3;3;0;100;0;213933.333333333;2307.66666666667;109
30319;2023;4;4;0;100;0;365702.5;3949;94.5
30321;2023;68;44;24;64.7058823529412;35.2941176470588;223044.264705882;2665.08823529412;82.6176470588235
30322;2023;2;1;1;50;50;85727.5;2038;42.5
30323;2023;1;1;0;100;0;80000;727;110
30324;2023;5;5;0;100;0;314240;3128;101.2
30325;2023;18;13;5;72.2222222222222;27.7777777777778;172570.833333333;2018.94444444444;93.3888888888889
30326;2023;19;15;4;78.9473684210526;21.0526315789474;221559.263157895;2354.84210526316;94.4210526315789
30327;2023;1;1;0;100;0;70000;1458;48
30328;2023;10;9;1;90;10;243350;2503.9;102.4
30329;2023;2;2;0;100;0;121500;2112.5;59
30330;2023;5;4;1;80;20;172300;3050.2;59.8
30331;2023;12;11;1;91.6666666666667;8.33333333333333;207205.833333333;2091.75;93
30333;2023;50;41;9;82;18;248010.32;2792.56;89.34
30334;2023;185;89;96;48.1081081081081;51.8918918918919;335822.491891892;3837.97297297297;84.4324324324324
30336;2023;17;16;1;94.1176470588235;5.88235294117647;257335.176470588;2349.11764705882;104.470588235294
30337;2023;4;4;0;100;0;483937.5;3413.75;144
30338;2023;5;5;0;100;0;278724;2492.8;112.6
30339;2023;51;37;14;72.5490196078431;27.4509803921569;137373.784313725;1917.80392156863;79
30340;2023;7;7;0;100;0;220308.571428571;2259.14285714286;99.2857142857143
30341;2023;112;78;34;69.6428571428571;30.3571428571429;206225.848214286;2532.14285714286;83.6875
30342;2023;8;5;3;62.5;37.5;217684.25;3246.5;80.5
30343;2023;5;5;0;100;0;221488;3090.2;78.4
30344;2023;62;54;8;87.0967741935484;12.9032258064516;299702.741935484;3121.95161290323;99.0161290322581
30345;2023;12;8;4;66.6666666666667;33.3333333333333;108212.083333333;1408.33333333333;77.0833333333333
30346;2023;26;25;1;96.1538461538462;3.84615384615385;322256;3221;97.4615384615385
30347;2023;11;10;1;90.9090909090909;9.09090909090909;216720.363636364;3051.63636363636;75.4545454545455
30348;2023;11;10;1;90.9090909090909;9.09090909090909;268954.090909091;1980.27272727273;126.727272727273
30349;2023;11;11;0;100;0;285616.272727273;2792.27272727273;111.818181818182
30350;2023;62;27;35;43.5483870967742;56.4516129032258;118272.629032258;1499.20967741935;79.0806451612903
30351;2023;161;118;43;73.2919254658385;26.7080745341615;388513.813664596;3864.39751552795;98.9316770186335
30352;2023;21;19;2;90.4761904761905;9.52380952380952;307393.857142857;2999.71428571429;108.52380952381
30353;2023;2;2;0;100;0;140002.5;2071.5;67.5
30354;2023;1;1;0;100;0;344800;3592;96
30355;2023;6;5;1;83.3333333333333;16.6666666666667;225326.666666667;2239.33333333333;97.6666666666667
30356;2023;34;23;11;67.6470588235294;32.3529411764706;215547.941176471;2753.32352941176;79.6764705882353
31001;2023;1;1;0;100;0;150000;1007;149
31002;2023;1;1;0;100;0;90000;2500;36
31003;2023;7;6;1;85.7142857142857;14.2857142857143;495978.571428571;3295.71428571429;160.571428571429
31004;2023;20;20;0;100;0;291373.7;2675.65;106.45
31005;2023;5;4;1;80;20;162976;1354.4;117.4
31008;2023;4;4;0;100;0;252262.5;1762.5;137.75
31009;2023;1;1;0;100;0;130000;1150;113
31010;2023;2;2;0;100;0;321221;1761.5;171
31011;2023;8;7;1;87.5;12.5;113825;1315.5;89.75
31012;2023;1;1;0;100;0;80000;825;97
31013;2023;3;3;0;100;0;263000;2164;123
31014;2023;2;2;0;100;0;127015;1607;82.5
31015;2023;3;3;0;100;0;109333.333333333;1498.66666666667;70
31017;2023;1;1;0;100;0;225000;2500;90
31018;2023;4;4;0;100;0;257500;1688;158
31020;2023;14;14;0;100;0;101638.214285714;1332.71428571429;77.6428571428571
31021;2023;1;1;0;100;0;195800;2128;92
31022;2023;143;54;89;37.7622377622378;62.2377622377622;196570.433566434;2810.88811188811;70.027972027972
31023;2023;6;6;0;100;0;122595.833333333;1146.16666666667;107.166666666667
31024;2023;1;1;0;100;0;193000;1608;120
31025;2023;6;6;0;100;0;434700;3098.5;132.5
31026;2023;18;17;1;94.4444444444444;5.55555555555556;197577.222222222;2213.72222222222;97.9444444444444
31027;2023;1;1;0;100;0;140000;824;170
31028;2023;25;17;8;68;32;138079.52;1612.28;86.8
31029;2023;3;3;0;100;0;438530;2778.33333333333;160
31030;2023;1;1;0;100;0;2,00E+05;1818;110
31031;2023;10;10;0;100;0;175045;1682.2;105.6
31032;2023;77;59;18;76.6233766233766;23.3766233766234;266125.571428571;2765.88311688312;97.3766233766234
31033;2023;142;88;54;61.9718309859155;38.0281690140845;177112.281690141;2186.50704225352;79.8450704225352
31034;2023;3;3;0;100;0;111666.666666667;1410;82
31035;2023;40;12;28;30;70;239447.975;3535.775;71.725
31036;2023;16;15;1;93.75;6.25;316619.125;3022.625;104.125
31037;2023;26;24;2;92.3076923076923;7.69230769230769;198859.615384615;2084.11538461538;99.2307692307692
31038;2023;10;10;0;100;0;291271.6;2516.1;123.6
31039;2023;2;2;0;100;0;255055;1473;164
31041;2023;4;4;0;100;0;123975;1223;99.25
31042;2023;196;28;168;14.2857142857143;85.7142857142857;120481.897959184;2406.24489795918;49.4489795918367
31043;2023;3;3;0;100;0;207333.333333333;1367.33333333333;145.333333333333
31044;2023;199;75;124;37.6884422110553;62.3115577889447;314870.281407035;3783.46733668342;80.0753768844221
31045;2023;5;5;0;100;0;156594;1823.8;95.6
31046;2023;1;1;0;100;0;189761;2711;70
31047;2023;3;3;0;100;0;218865;1622.33333333333;140
31048;2023;39;35;4;89.7435897435898;10.2564102564103;259321.948717949;2731.87179487179;96.6666666666667
31049;2023;2;2;0;100;0;120000;1283.5;95
31050;2023;2;2;0;100;0;168500;1535;109
31051;2023;2;2;0;100;0;215012.5;1725;119.5
31052;2023;14;14;0;100;0;276423.642857143;2507.92857142857;111.071428571429
31053;2023;3;3;0;100;0;456766.666666667;3109.33333333333;150.333333333333
31054;2023;1;1;0;100;0;93000;959;97
31055;2023;2;2;0;100;0;316500;3036;102.5
31056;2023;84;39;45;46.4285714285714;53.5714285714286;270856.595238095;3173.90476190476;82.1785714285714
31057;2023;14;10;4;71.4285714285714;28.5714285714286;321761;3090.92857142857;111.857142857143
31058;2023;1;1;0;100;0;6,00E+05;3000;200
31059;2023;5;5;0;100;0;161326;1455;101.2
31060;2023;1;1;0;100;0;480000;2008;239
31061;2023;1;1;0;100;0;496500;2921;170
31063;2023;2;2;0;100;0;354610;2266;160.5
31065;2023;23;21;2;91.304347826087;8.69565217391304;227945.217391304;2205.47826086957;109
31066;2023;45;36;9;80;20;207583.444444444;2324.17777777778;88.5555555555556
31067;2023;2;2;0;100;0;161455;1917.5;89
31068;2023;1;1;0;100;0;166000;1886;88
31069;2023;364;113;251;31.043956043956;68.956043956044;244935.06043956;3303.93406593407;72.7087912087912
31070;2023;6;6;0;100;0;164566.666666667;1407.66666666667;123
31071;2023;2;2;0;100;0;328385.5;3139.5;105
31072;2023;3;3;0;100;0;216875;2475.33333333333;82
31073;2023;6;6;0;100;0;335583.333333333;2745.33333333333;129.166666666667
31074;2023;4;4;0;100;0;543420;3405;138
31075;2023;16;16;0;100;0;313674.6875;3044.375;105.625
31076;2023;1;1;0;100;0;50000;769;65
31077;2023;7;7;0;100;0;264038.571428571;2231.14285714286;114.142857142857
31079;2023;48;47;1;97.9166666666667;2.08333333333333;299349.895833333;2794.79166666667;109.375
31080;2023;22;21;1;95.4545454545455;4.54545454545455;145122.727272727;1310.59090909091;109.136363636364
31081;2023;1;1;0;100;0;156200;2403;65
31082;2023;15;14;1;93.3333333333333;6.66666666666667;294850;2507.93333333333;119.866666666667
31083;2023;3;3;0;100;0;245666.666666667;2058.66666666667;152.333333333333
31084;2023;10;8;2;80;20;146151.5;1864.1;80.6
31085;2023;15;13;2;86.6666666666667;13.3333333333333;106568.866666667;1576.13333333333;71.2
31086;2023;1;1;0;100;0;180000;2045;88
31087;2023;1;1;0;100;0;244400;3055;80
31088;2023;30;26;4;86.6666666666667;13.3333333333333;336371;2818.16666666667;120.166666666667
31089;2023;6;6;0;100;0;306872.5;3023.83333333333;100.833333333333
31090;2023;3;3;0;100;0;116333.333333333;1378;95.3333333333333
31091;2023;59;48;11;81.3559322033898;18.6440677966102;272746.525423729;2845.93220338983;96.6101694915254
31092;2023;1;1;0;100;0;60000;545;110
31093;2023;8;8;0;100;0;229812.5;2400.75;98.875
31094;2023;32;27;5;84.375;15.625;255725.78125;2667.09375;96.21875
31096;2023;1;1;0;100;0;254300;2469;103
31097;2023;9;8;1;88.8888888888889;11.1111111111111;270790.666666667;2446.44444444444;105.555555555556
31098;2023;15;13;2;86.6666666666667;13.3333333333333;177529.866666667;1829.33333333333;102.866666666667
31099;2023;7;7;0;100;0;379275.714285714;2550;131.428571428571
31100;2023;33;33;0;100;0;195976.727272727;2107;97.8484848484848
31101;2023;1;1;0;100;0;551527;4243;130
31102;2023;5;5;0;100;0;187930;2019.4;90.8
31104;2023;4;4;0;100;0;270312.5;2256.5;119.25
31105;2023;3;3;0;100;0;373049;3295.66666666667;129.333333333333
31106;2023;27;24;3;88.8888888888889;11.1111111111111;239046.925925926;2276.22222222222;104.407407407407
31107;2023;68;50;18;73.5294117647059;26.4705882352941;218290.911764706;2247.85294117647;99.1764705882353
31108;2023;1;1;0;100;0;381871;2708;141
31109;2023;8;8;0;100;0;175319;1488.25;117.25
31110;2023;8;8;0;100;0;137560.625;1519;96.875
31111;2023;4;4;0;100;0;314900;2756.25;119.5
31113;2023;174;63;111;36.2068965517241;63.7931034482759;243670.367816092;3192.84482758621;77.1609195402299
31115;2023;1;1;0;100;0;150000;2143;70
31116;2023;137;82;55;59.8540145985402;40.1459854014599;230878.503649635;2857.72262773723;81.4598540145985
31117;2023;26;25;1;96.1538461538462;3.84615384615385;387938.846153846;3684.42307692308;106.615384615385
31118;2023;117;67;50;57.2649572649573;42.7350427350427;220033.632478632;2697.30769230769;81.8547008547009
31119;2023;1;1;0;100;0;354365;1772;200
31120;2023;9;9;0;100;0;330831.111111111;3178.77777777778;115.888888888889
31124;2023;1;1;0;100;0;230000;2072;111
31125;2023;1;1;0;100;0;40000;580;69
31126;2023;3;3;0;100;0;196800;1755.33333333333;137.666666666667
31128;2023;9;9;0;100;0;175550;1829.88888888889;99.3333333333333
31129;2023;1;1;0;100;0;139115;2782;50
31132;2023;1;1;0;100;0;295000;4683;63
31133;2023;1;1;0;100;0;112850;2508;45
31134;2023;1;1;0;100;0;75000;455;165
31135;2023;74;45;29;60.8108108108108;39.1891891891892;149676.243243243;1811.01351351351;83.7567567567568
31136;2023;25;22;3;88;12;309935.92;3195.68;97.4
31137;2023;2;2;0;100;0;362050;2554.5;149.5
31139;2023;2;2;0;100;0;53250;872;62
31140;2023;4;4;0;100;0;157000;1795;86.25
31141;2023;3;3;0;100;0;574080;2960;179
31142;2023;4;4;0;100;0;257500;2176.5;119.75
31143;2023;1;1;0;100;0;230210;1338;172
31144;2023;14;14;0;100;0;124156.428571429;1909.85714285714;73.4285714285714
31145;2023;35;34;1;97.1428571428571;2.85714285714286;209971.228571429;2062.34285714286;105.428571428571
31147;2023;8;8;0;100;0;190105.625;1758.625;110.625
31148;2023;3;3;0;100;0;297833.333333333;2728.66666666667;112.666666666667
31149;2023;495;187;308;37.7777777777778;62.2222222222222;215670.814141414;2753.59191919192;76.7131313131313
31150;2023;117;70;47;59.8290598290598;40.1709401709402;254307.333333333;3013.1452991453;83.6581196581197
31151;2023;8;7;1;87.5;12.5;444865;3142.625;151.375
31152;2023;2;2;0;100;0;113450;782;150
31153;2023;7;7;0;100;0;235861.285714286;2512;110
31155;2023;4;4;0;100;0;154562.5;1771;96.25
31156;2023;5;5;0;100;0;212970;2172.6;93.8
31157;2023;221;107;114;48.4162895927602;51.5837104072398;223060.859728507;2852.16742081448;76.5429864253394
31158;2023;1;1;0;100;0;120000;2400;50
31159;2023;4;4;0;100;0;126655.25;1110.5;105.25
31160;2023;34;18;16;52.9411764705882;47.0588235294118;214103.441176471;2581.85294117647;82.4411764705882
31161;2023;9;8;1;88.8888888888889;11.1111111111111;406862.222222222;3653.77777777778;109.111111111111
31162;2023;6;6;0;100;0;359909;3220;115.166666666667
31163;2023;18;14;4;77.7777777777778;22.2222222222222;358326.833333333;3332.72222222222;109.944444444444
31164;2023;2;2;0;100;0;143500;1968;81
31165;2023;88;58;30;65.9090909090909;34.0909090909091;254855.488636364;2795.40909090909;88.25
31166;2023;3;3;0;100;0;163333.333333333;2217.66666666667;76.6666666666667
31167;2023;5;5;0;100;0;166600;1700;100.4
31168;2023;1;1;0;100;0;172500;927;186
31169;2023;64;38;26;59.375;40.625;306820.09375;3386.5625;92.3125
31170;2023;1;1;0;100;0;265000;2650;100
31171;2023;4;4;0;100;0;202485.5;2072;92.25
31173;2023;2;2;0;100;0;322500;2675;118
31174;2023;8;8;0;100;0;107902.5;1628.625;73.75
31175;2023;4;4;0;100;0;217652;1738.5;125.25
31176;2023;2;2;0;100;0;146500;1116.5;131
31177;2023;2;2;0;100;0;105500;1618;66
31178;2023;2;2;0;100;0;234425;2021;119
31179;2023;7;7;0;100;0;230124.285714286;2153.57142857143;109.285714285714
31181;2023;26;24;2;92.3076923076923;7.69230769230769;267531.038461538;2578.03846153846;102.461538461538
31182;2023;85;52;33;61.1764705882353;38.8235294117647;228695.141176471;2706.64705882353;84.0352941176471
31183;2023;4;4;0;100;0;2,00E+05;1672;124.75
31184;2023;22;18;4;81.8181818181818;18.1818181818182;411829.090909091;3814.45454545455;106.045454545455
31185;2023;3;3;0;100;0;293233.333333333;2396;140.666666666667
31186;2023;37;17;20;45.945945945946;54.0540540540541;206738;2849.24324324324;71.6216216216216
31187;2023;132;99;33;75;25;292929.742424242;2848.79545454545;101.825757575758
31188;2023;41;39;2;95.1219512195122;4.8780487804878;331484.317073171;2803.07317073171;119.341463414634
31189;2023;2;2;0;100;0;202450;1391;127.5
31190;2023;13;12;1;92.3076923076923;7.69230769230769;96866.1538461538;1429.76923076923;76.9230769230769
31191;2023;2;2;0;100;0;63235;941.5;65
31192;2023;9;9;0;100;0;398111.666666667;3392.22222222222;118.666666666667
31193;2023;23;23;0;100;0;181513.913043478;1630.52173913043;106.391304347826
31194;2023;1;1;0;100;0;370070;1869;198
31196;2023;5;5;0;100;0;181896;1727.8;104.6
31197;2023;3;3;0;100;0;197966.666666667;1873;109.666666666667
31199;2023;7;7;0;100;0;147370;1973.85714285714;82.1428571428571
31202;2023;63;52;11;82.5396825396825;17.4603174603175;251777.873015873;2602.66666666667;100.539682539683
31203;2023;89;53;36;59.5505617977528;40.4494382022472;228042.505617978;2700.40449438202;83.9887640449438
31205;2023;37;12;25;32.4324324324324;67.5675675675676;204389.459459459;2716.94594594595;75.1621621621622
31206;2023;11;11;0;100;0;161068.181818182;1661.90909090909;97.1818181818182
31207;2023;2;2;0;100;0;78400;935;88.5
31208;2023;5;5;0;100;0;160600;1399.8;121.8
31209;2023;4;4;0;100;0;360886.25;2423;154.5
31210;2023;14;13;1;92.8571428571429;7.14285714285714;248470.928571429;2453.78571428571;109.5
31211;2023;4;4;0;100;0;249750;2685;103.25
31212;2023;6;6;0;100;0;239825;3031.83333333333;78.6666666666667
31213;2023;3;3;0;100;0;116666.666666667;2127.66666666667;71.6666666666667
31215;2023;1;1;0;100;0;2,00E+05;2222;90
31216;2023;2;2;0;100;0;398250;2623.5;154
31218;2023;2;2;0;100;0;215250;1454;156
31219;2023;3;3;0;100;0;239966.666666667;2674.66666666667;90.3333333333333
31220;2023;2;2;0;100;0;138822.5;1930;75
31221;2023;10;3;7;30;70;117977;1862.9;66.4
31224;2023;18;15;3;83.3333333333333;16.6666666666667;119863.833333333;1249.11111111111;100.888888888889
31226;2023;1;1;0;100;0;380000;2289;166
31227;2023;5;5;0;100;0;655217;3748.2;179.8
31228;2023;20;17;3;85;15;304362.85;2970.55;102.8
31229;2023;5;5;0;100;0;186711.4;1942.6;84.2
31230;2023;51;46;5;90.1960784313726;9.80392156862745;294237.058823529;2893.45098039216;101.098039215686
31231;2023;8;8;0;100;0;234056.25;2611.25;114.25
31232;2023;105;71;34;67.6190476190476;32.3809523809524;217255.828571429;2516.21904761905;88.0666666666667
31233;2023;14;14;0;100;0;287316.857142857;2801.42857142857;108.428571428571
31234;2023;6;6;0;100;0;230651.5;2147.66666666667;106.666666666667
31236;2023;6;6;0;100;0;101821.666666667;1282.66666666667;82.1666666666667
31237;2023;3;3;0;100;0;108047;819.333333333333;134
31238;2023;5;5;0;100;0;148698;1514.2;104.4
31239;2023;35;35;0;100;0;141131.942857143;1452.88571428571;101.085714285714
31240;2023;2;2;0;100;0;221150;2386.5;97
31241;2023;4;4;0;100;0;148818.75;1148.75;140.75
31242;2023;1;1;0;100;0;255000;2550;100
31243;2023;2;2;0;100;0;175000;1947.5;89
31244;2023;1;1;0;100;0;245000;1914;128
31245;2023;5;5;0;100;0;107029;1137.8;84.2
31246;2023;7;7;0;100;0;162205.714285714;1585;103.428571428571
31247;2023;21;21;0;100;0;141241.666666667;1362.95238095238;105.619047619048
31248;2023;42;33;9;78.5714285714286;21.4285714285714;263464.904761905;2811.64285714286;93.5476190476191
31249;2023;4;3;1;75;25;224262.5;2306;98.75
31250;2023;8;8;0;100;0;266573.625;2241.375;131.625
31251;2023;1;1;0;100;0;229310;1281;179
31252;2023;16;13;3;81.25;18.75;292900.125;2896.875;99.0625
31253;2023;23;20;3;86.9565217391304;13.0434782608696;256523.565217391;2551.95652173913;101.478260869565
31254;2023;20;15;5;75;25;286302;3177.55;90.1
31255;2023;1;1;0;100;0;145000;1208;120
31256;2023;4;4;0;100;0;316500;3218;99.75
31258;2023;1;1;0;100;0;138495;2663;52
31259;2023;24;18;6;75;25;395463.75;3299.125;119.708333333333
31260;2023;1;1;0;100;0;115000;1369;84
31261;2023;12;12;0;100;0;193105.833333333;2310;83.5
31262;2023;6;6;0;100;0;181793.333333333;1728.83333333333;100.333333333333
31263;2023;44;39;5;88.6363636363636;11.3636363636364;268512.431818182;2710.04545454545;98.9545454545455
31264;2023;3;3;0;100;0;194833.333333333;2421.66666666667;80.3333333333333
31265;2023;2;2;0;100;0;104575;1157;86.5
31266;2023;3;3;0;100;0;221733.333333333;1836;120
31267;2023;2;2;0;100;0;119435;1379.5;90
31268;2023;1;1;0;100;0;281000;1338;210
31269;2023;14;14;0;100;0;284521.428571429;2857.57142857143;103.642857142857
31270;2023;8;8;0;100;0;197985;1674.5;118.5
31271;2023;21;20;1;95.2380952380952;4.76190476190476;345091.095238095;2893.33333333333;121.47619047619
31273;2023;23;22;1;95.6521739130435;4.34782608695652;364141.47826087;3210.86956521739;117.391304347826
31275;2023;2;2;0;100;0;256575;1551.5;153.5
31276;2023;5;5;0;100;0;179204;1478;125.2
31277;2023;21;20;1;95.2380952380952;4.76190476190476;303849.666666667;2814.04761904762;113.047619047619
31278;2023;3;3;0;100;0;242666.666666667;2782.33333333333;84.6666666666667
31279;2023;1;1;0;100;0;95000;633;150
31280;2023;2;2;0;100;0;152975;1616;105.5
31281;2023;11;11;0;100;0;220468.181818182;2112.27272727273;106.090909090909
31282;2023;104;57;47;54.8076923076923;45.1923076923077;233736.644230769;2982.76923076923;74.8173076923077
31283;2023;3;3;0;100;0;211222;2229.66666666667;91.6666666666667
31284;2023;18;18;0;100;0;452798.888888889;3357.33333333333;140.666666666667
31285;2023;12;12;0;100;0;365049.916666667;3250.16666666667;132.666666666667
31286;2023;5;5;0;100;0;174337.2;2049.8;80.8
31287;2023;45;44;1;97.7777777777778;2.22222222222222;240626.266666667;2477.22222222222;97.0222222222222
31288;2023;2;2;0;100;0;162500;2029;82.5
31291;2023;132;70;62;53.030303030303;46.969696969697;216400.659090909;2739.99242424242;78.8257575757576
31293;2023;35;30;5;85.7142857142857;14.2857142857143;310591.2;3255.74285714286;97.1714285714286
31294;2023;1;1;0;100;0;135000;1607;84
31296;2023;1;1;0;100;0;73600;526;140
31297;2023;32;27;5;84.375;15.625;268405.34375;2535.1875;104.125
31299;2023;30;28;2;93.3333333333333;6.66666666666667;259076.166666667;2575.5;102.733333333333
31300;2023;4;4;0;100;0;211250;1428.75;149.75
31301;2023;3;3;0;100;0;180926.666666667;1907;99
31302;2023;1;1;0;100;0;270899;1868;145
31303;2023;38;32;6;84.2105263157895;15.7894736842105;214262.868421053;2326.15789473684;95.4473684210526
31304;2023;4;4;0;100;0;295600;2185;129.75
31305;2023;3;3;0;100;0;105670;1197.33333333333;85.3333333333333
31306;2023;5;5;0;100;0;313305.4;3608.2;98.2
31308;2023;1;1;0;100;0;150000;765;196
31309;2023;3;3;0;100;0;156833.333333333;1374;129.333333333333
31310;2023;2;2;0;100;0;329650;2278.5;145
31311;2023;8;7;1;87.5;12.5;343830.25;3142.25;114.625
31313;2023;3;3;0;100;0;124900;1569;79.3333333333333
31314;2023;3;3;0;100;0;161711.333333333;1392;111.666666666667
31315;2023;13;13;0;100;0;134640;1305.69230769231;110.230769230769
31316;2023;9;8;1;88.8888888888889;11.1111111111111;121842.222222222;1533.88888888889;90.2222222222222
31317;2023;3;3;0;100;0;298354.333333333;2722.66666666667;113.333333333333
31318;2023;5;5;0;100;0;190666;1334.2;139.6
31319;2023;1;1;0;100;0;2,00E+05;1980;101
31320;2023;7;7;0;100;0;265158.571428571;2742.28571428571;99.8571428571429
31322;2023;2;2;0;100;0;179500;1522.5;110.5
31323;2023;2;2;0;100;0;67500;835;71
31324;2023;27;20;7;74.0740740740741;25.9259259259259;151271.074074074;1534.11111111111;102.148148148148
31327;2023;3;3;0;100;0;156650;1951.66666666667;80.6666666666667
31328;2023;1;1;0;100;0;125000;1202;104
31330;2023;5;5;0;100;0;274248;2251.2;122
31331;2023;4;4;0;100;0;282699.75;2363;120.5
31332;2023;2;2;0;100;0;493400;2219;200
31333;2023;1;1;0;100;0;260000;1926;135
31334;2023;7;7;0;100;0;310826.428571429;2629.57142857143;121.285714285714
31335;2023;2;2;0;100;0;261032.5;2185.5;98
31336;2023;9;9;0;100;0;176562.888888889;1925.33333333333;93.8888888888889
31337;2023;3;3;0;100;0;70333.3333333333;1193.66666666667;56.3333333333333
31338;2023;3;3;0;100;0;165166.666666667;2261;70
31339;2023;1;1;0;100;0;604560;3977;152
31340;2023;2;2;0;100;0;678250;11304.5;60
31341;2023;7;6;1;85.7142857142857;14.2857142857143;166738.571428571;1969.85714285714;90.5714285714286
31342;2023;1;1;0;100;0;94000;2474;38
31344;2023;13;12;1;92.3076923076923;7.69230769230769;114309.307692308;1067.92307692308;105.307692307692
31345;2023;19;19;0;100;0;223152.631578947;2478.31578947368;96.1578947368421
31346;2023;6;6;0;100;0;294470.666666667;2878.83333333333;104.333333333333
31348;2023;1;1;0;100;0;36500;445;82
31349;2023;4;4;0;100;0;254525;2444;108
31350;2023;2;2;0;100;0;187812.5;1201.5;161
31351;2023;80;44;36;55;45;200601.325;2707.875;72.0125
31352;2023;1;1;0;100;0;744730;4407;169
31353;2023;1;1;0;100;0;282530;1990;142
31355;2023;7;7;0;100;0;499021.428571429;4140.14285714286;124.428571428571
31356;2023;24;21;3;87.5;12.5;331478.25;2988.70833333333;107.333333333333
31357;2023;2;2;0;100;0;99465;690;145
31358;2023;35;29;6;82.8571428571429;17.1428571428571;337197.514285714;3085.31428571429;108.8
31360;2023;15;7;8;46.6666666666667;53.3333333333333;168326.733333333;2651.13333333333;64.5333333333333
31361;2023;4;4;0;100;0;264125;2581;104
31362;2023;3;3;0;100;0;273733.333333333;2053;128
31363;2023;5;5;0;100;0;269213.4;1861.8;156.2
31364;2023;29;25;4;86.2068965517241;13.7931034482759;269135.586206897;2789.10344827586;98.1034482758621
31365;2023;5;5;0;100;0;105370;980.4;104.2
31366;2023;12;12;0;100;0;398603.25;3008;141.833333333333
31367;2023;3;3;0;100;0;68777.6666666667;1243.66666666667;77.3333333333333
31368;2023;2;2;0;100;0;247600;2593;95.5
31369;2023;1;1;0;100;0;337260;2044;165
31371;2023;1;1;0;100;0;279000;1766;158
31372;2023;6;6;0;100;0;125674.166666667;1269.5;110
31373;2023;1;1;0;100;0;184500;1864;99
31374;2023;8;8;0;100;0;373488.75;3154.125;116.375
31375;2023;41;41;0;100;0;158909.463414634;1625.85365853659;101.121951219512
31376;2023;4;4;0;100;0;98625;1368.75;67.75
31377;2023;5;4;1;80;20;274460;2288;120.8
31378;2023;2;2;0;100;0;85500;1022.5;80.5
31379;2023;2;2;0;100;0;168200;1456.5;97.5
31380;2023;1;0;1;0;100;93500;1375;68
31381;2023;30;28;2;93.3333333333333;6.66666666666667;274865.4;2592.23333333333;105.8
31383;2023;11;11;0;100;0;253118;2817.63636363636;89.9090909090909
31384;2023;17;17;0;100;0;345774.470588235;3261.47058823529;111.529411764706
31385;2023;2;2;0;100;0;137000;1046;128
31386;2023;4;4;0;100;0;190551.5;1980;97.5
31387;2023;3;3;0;100;0;261666.666666667;1995;132
31388;2023;3;3;0;100;0;414411.666666667;3635;114.666666666667
31389;2023;57;20;37;35.0877192982456;64.9122807017544;259304.052631579;3291.89473684211;75.8947368421053
31390;2023;48;29;19;60.4166666666667;39.5833333333333;87901.7291666667;1181.04166666667;74.6875
31391;2023;4;4;0;100;0;199000;1577.75;143
31394;2023;2;1;1;50;50;223543;2587.5;96.5
31395;2023;330;139;191;42.1212121212121;57.8787878787879;180467.196969697;2334.67878787879;76.4636363636364
31396;2023;94;31;63;32.9787234042553;67.0212765957447;143765.106382979;1896.40425531915;70.563829787234
31398;2023;2;2;0;100;0;76500;825.5;98
31399;2023;34;32;2;94.1176470588235;5.88235294117647;229973.823529412;2427.02941176471;96.6176470588235
31401;2023;3;3;0;100;0;248576.666666667;2438.33333333333;102.666666666667
31402;2023;9;9;0;100;0;410312.333333333;3174.11111111111;141.444444444444
31403;2023;12;12;0;100;0;287441.666666667;2830.83333333333;109.416666666667
31404;2023;2;2;0;100;0;304675;4621.5;67
31405;2023;2;2;0;100;0;182500;1617.5;111
31406;2023;12;11;1;91.6666666666667;8.33333333333333;165104.083333333;1755.25;96.4166666666667
31407;2023;11;11;0;100;0;349140.272727273;2695.72727272727;138.636363636364
31408;2023;2;2;0;100;0;175115;1245;138.5
31409;2023;18;10;8;55.5555555555556;44.4444444444444;297935.555555556;3437.38888888889;81.4444444444444
31410;2023;55;45;10;81.8181818181818;18.1818181818182;279255.854545455;3045.4;91.2727272727273
31411;2023;4;4;0;100;0;426860;2989.75;143.75
31412;2023;3;3;0;100;0;151166.666666667;1786.66666666667;88.6666666666667
31413;2023;4;4;0;100;0;360750;2484.5;138.75
31415;2023;2;2;0;100;0;259750;2686;97.5
31416;2023;2;2;0;100;0;128120;2017;70.5
31417;2023;81;59;22;72.8395061728395;27.1604938271605;342125.111111111;3163.12345679012;105
31418;2023;12;6;6;50;50;491974.833333333;3885.33333333333;151.333333333333
31419;2023;2;2;0;100;0;241725;2534;96
31420;2023;35;26;9;74.2857142857143;25.7142857142857;226033.571428571;2594;87.8857142857143
31421;2023;42;28;14;66.6666666666667;33.3333333333333;214359.80952381;2609.7380952381;80.5238095238095
31422;2023;1;1;0;100;0;85000;794;107
31423;2023;4;4;0;100;0;179400;1504;119.25
31424;2023;211;148;63;70.1421800947867;29.8578199052133;273145.322274882;3100.18957345972;86.9431279620853
31425;2023;12;11;1;91.6666666666667;8.33333333333333;153414.333333333;1805.16666666667;88.0833333333333
31426;2023;6;6;0;100;0;127583.333333333;996.5;129.166666666667
31427;2023;9;9;0;100;0;140938.888888889;1227.77777777778;115.444444444444
31428;2023;2;2;0;100;0;231075;2446;89
31429;2023;16;7;9;43.75;56.25;277690.3125;3144.375;86.125
31430;2023;4;4;0;100;0;201987.5;1583.75;127
31431;2023;6;6;0;100;0;96078.3333333333;1524;65.8333333333333
31432;2023;1;0;1;0;100;95000;2714;35
31433;2023;84;62;22;73.8095238095238;26.1904761904762;242479.511904762;2884.45238095238;84.0357142857143
31435;2023;6;6;0;100;0;268931.666666667;2724.33333333333;104.833333333333
31436;2023;3;3;0;100;0;175000;1606.66666666667;136
31439;2023;3;3;0;100;0;453655.666666667;4208;106
31440;2023;2;2;0;100;0;141500;1036;144
31441;2023;2;2;0;100;0;285785;2291.5;123.5
31442;2023;9;9;0;100;0;226381.888888889;2354;94.6666666666667
31443;2023;10;10;0;100;0;131788.5;1188.4;108.6
31444;2023;3;3;0;100;0;177333.333333333;1819.33333333333;95.3333333333333
31445;2023;59;36;23;61.0169491525424;38.9830508474576;309266.169491525;3642.89830508475;84.3389830508475
31446;2023;168;50;118;29.7619047619048;70.2380952380952;235682.642857143;3195.41071428571;74.6071428571429
31447;2023;1;1;0;100;0;90800;698;130
31448;2023;6;6;0;100;0;421139.166666667;3081.83333333333;147.666666666667
31449;2023;2;2;0;100;0;151070;1524;82
31450;2023;3;3;0;100;0;247100;2328.66666666667;112.666666666667
31451;2023;115;101;14;87.8260869565217;12.1739130434783;179811.313043478;1921.51304347826;98.4608695652174
31454;2023;35;31;4;88.5714285714286;11.4285714285714;186213.571428571;2113.08571428571;95.0857142857143
31455;2023;24;24;0;100;0;156430;1714.75;100.625
31456;2023;2;2;0;100;0;47500;1015.5;48
31457;2023;9;9;0;100;0;109506.666666667;1482.44444444444;77.1111111111111
31458;2023;62;39;23;62.9032258064516;37.0967741935484;242216.129032258;3018.37096774194;79.9032258064516
31459;2023;5;5;0;100;0;366364;3335;110.4
31460;2023;36;22;14;61.1111111111111;38.8888888888889;228128.333333333;2783.86111111111;80.6944444444444
31461;2023;1;1;0;100;0;38000;1900;20
31462;2023;22;10;12;45.4545454545455;54.5454545454545;290586.409090909;3071.72727272727;81.0909090909091
31463;2023;2;2;0;100;0;338326.5;1664.5;220
31464;2023;2;2;0;100;0;304995;4010;77
31465;2023;1;1;0;100;0;205000;1708;120
31466;2023;7;7;0;100;0;294064.285714286;2830.28571428571;103.714285714286
31467;2023;39;27;12;69.2307692307692;30.7692307692308;246747.692307692;2992.38461538462;83.2564102564103
31468;2023;2;2;0;100;0;102000;1958;58
31470;2023;7;2;5;28.5714285714286;71.4285714285714;61252.8571428571;1845.42857142857;41.8571428571429
31471;2023;8;7;1;87.5;12.5;127401.25;1370;98.5
31472;2023;3;3;0;100;0;187326.666666667;1826.33333333333;123
31473;2023;19;3;16;15.7894736842105;84.2105263157895;104821.526315789;1759.73684210526;62.4736842105263
31474;2023;1;1;0;100;0;150000;1304;115
31475;2023;23;19;4;82.6086956521739;17.3913043478261;228506.956521739;2453.5652173913;94.2608695652174
31476;2023;7;7;0;100;0;213271.428571429;1776.42857142857;128.857142857143
31478;2023;13;13;0;100;0;192018.461538462;1650.15384615385;124.692307692308
31479;2023;1;1;0;100;0;271565;2263;120
31480;2023;18;17;1;94.4444444444444;5.55555555555556;372918.222222222;3369.05555555556;116.055555555556
31481;2023;19;13;6;68.4210526315789;31.5789473684211;205720.842105263;2131.21052631579;96
31482;2023;2;2;0;100;0;79786;953;83
31483;2023;193;81;112;41.9689119170984;58.0310880829015;102110.046632124;1405.0103626943;73.5544041450777
31484;2023;26;18;8;69.2307692307692;30.7692307692308;264870.730769231;2970.61538461538;88.2307692307692
31486;2023;17;12;5;70.5882352941177;29.4117647058824;211451.941176471;2504.52941176471;82.7058823529412
31487;2023;1;1;0;100;0;116000;892;130
31488;2023;138;88;50;63.768115942029;36.231884057971;297333.717391304;3357.81884057971;87.195652173913
31490;2023;66;55;11;83.3333333333333;16.6666666666667;251902.53030303;2752.33333333333;91.9848484848485
31491;2023;5;5;0;100;0;182090;2158.2;86.2
31492;2023;6;6;0;100;0;259554.666666667;2222.16666666667;112.5
31493;2023;2;2;0;100;0;227335;2345.5;95
31495;2023;6;6;0;100;0;250750;2592.16666666667;101
31496;2023;1;1;0;100;0;195000;3250;60
31497;2023;20;17;3;85;15;337306.8;3341.9;107.05
31498;2023;1;1;0;100;0;126480;723;175
31499;2023;117;91;26;77.7777777777778;22.2222222222222;226615.675213675;2488.17094017094;90.9145299145299
31500;2023;30;12;18;40;60;160280.533333333;2818.36666666667;61.5
31501;2023;3;3;0;100;0;398750;2891;136.666666666667
31502;2023;5;5;0;100;0;132000;1509.6;89.6
31503;2023;10;9;1;90;10;108268;1298.6;89.4
31504;2023;1;1;0;100;0;230000;2500;92
31505;2023;10;10;0;100;0;232991;1792.2;130.1
31506;2023;164;88;76;53.6585365853659;46.3414634146341;272486.512195122;3300.53658536585;81.4756097560976
31507;2023;28;18;10;64.2857142857143;35.7142857142857;170220.357142857;2236.5;74.1428571428571
31509;2023;1;1;0;100;0;180000;1500;120
31510;2023;6;5;1;83.3333333333333;16.6666666666667;226341.666666667;1353.83333333333;177.166666666667
31512;2023;7;7;0;100;0;344689.285714286;3360.85714285714;102
31513;2023;4;4;0;100;0;157500;2846.25;76.25
31515;2023;2;2;0;100;0;232307;1836.5;127
31516;2023;11;10;1;90.9090909090909;9.09090909090909;300470.909090909;2642.63636363636;120.909090909091
31517;2023;18;18;0;100;0;204450.555555556;2340.27777777778;90.8888888888889
31518;2023;3;3;0;100;0;300470;2794;105.666666666667
31519;2023;2;2;0;100;0;494200;2493;200
31520;2023;1;1;0;100;0;75000;1339;56
31521;2023;4;4;0;100;0;117500;1090;103.25
31523;2023;22;18;4;81.8181818181818;18.1818181818182;160708.227272727;1698.45454545455;98.9545454545455
31525;2023;3;3;0;100;0;352400;2990;118.666666666667
31526;2023;79;53;26;67.0886075949367;32.9113924050633;257331.594936709;2887.18987341772;88.2911392405063
31527;2023;3;3;0;100;0;202400;3642.33333333333;103.333333333333
31528;2023;2;2;0;100;0;356650;1501.5;256
31529;2023;2;2;0;100;0;237050;2711.5;89.5
31531;2023;2;2;0;100;0;229173;1728.5;142.5
31532;2023;1;1;0;100;0;137000;1292;106
31533;2023;14;12;2;85.7142857142857;14.2857142857143;310322.142857143;2838.64285714286;111.142857142857
31534;2023;1;1;0;100;0;311000;2237;139
31535;2023;11;11;0;100;0;154048.636363636;1379.81818181818;106.636363636364
31536;2023;1;1;0;100;0;197000;1684;117
31537;2023;2;2;0;100;0;170500;1370;123.5
31538;2023;2;2;0;100;0;292987.5;2447;126
31539;2023;1;1;0;100;0;225000;1705;132
31540;2023;2;2;0;100;0;402120;3833;110
31541;2023;72;24;48;33.3333333333333;66.6666666666667;238469.472222222;3269.98611111111;71.5
31542;2023;1;1;0;100;0;155000;969;160
31544;2023;10;10;0;100;0;133182.2;1209.6;111.6
31545;2023;1;1;0;100;0;175000;1182;148
31546;2023;3;3;0;100;0;303000;2560.66666666667;123.333333333333
31547;2023;120;75;45;62.5;37.5;217489.258333333;2532.05833333333;86.4166666666667
31548;2023;2;2;0;100;0;90700;1345.5;66.5
31550;2023;6;6;0;100;0;161258.833333333;1513.16666666667;109.333333333333
31551;2023;5;5;0;100;0;339226.4;2594.2;152.4
31552;2023;1;1;0;100;0;112000;1672;67
31553;2023;16;10;6;62.5;37.5;225068.125;2463.375;87.4375
31554;2023;1;1;0;100;0;121000;3025;40
31555;2023;7292;1056;6236;14.4816236972024;85.5183763027976;227759.735600658;3611.64577619309;63.3258365331871
31556;2023;1;1;0;100;0;110000;1392;79
31557;2023;282;176;106;62.4113475177305;37.5886524822695;336352.315602837;3524.92553191489;93.1843971631206
31558;2023;3;3;0;100;0;339941;2367.33333333333;144
31560;2023;7;7;0;100;0;275087.285714286;2822.14285714286;100.142857142857
31561;2023;118;98;20;83.0508474576271;16.9491525423729;328634.127118644;3451.27118644068;97.7966101694915
31563;2023;9;9;0;100;0;291205.555555556;3276;89.6666666666667
31564;2023;1;1;0;100;0;390000;1696;230
31565;2023;12;9;3;75;25;91258.3333333333;1008.66666666667;92.9166666666667
31566;2023;5;5;0;100;0;351778;2664.8;140.2
31567;2023;4;4;0;100;0;480234;3970.25;121.75
31568;2023;3;3;0;100;0;281833.333333333;2500.66666666667;142.666666666667
31569;2023;4;4;0;100;0;314500;2635.25;120.25
31570;2023;3;3;0;100;0;175000;1318.66666666667;113.333333333333
31572;2023;39;38;1;97.4358974358974;2.56410256410256;265570.230769231;2816.07692307692;99.4615384615385
31573;2023;48;41;7;85.4166666666667;14.5833333333333;240442.979166667;2764.04166666667;86.2291666666667
31574;2023;30;28;2;93.3333333333333;6.66666666666667;258760.1;2613.2;100.633333333333
31575;2023;9;7;2;77.7777777777778;22.2222222222222;532836.666666667;3455.22222222222;145.333333333333
31576;2023;3;3;0;100;0;220080;2349;94.6666666666667
31577;2023;1;1;0;100;0;170000;2024;84
31578;2023;10;10;0;100;0;562276;4466.1;164.3
31579;2023;3;3;0;100;0;343883.333333333;2968.33333333333;119
31580;2023;5;3;2;60;40;259578;3163.6;82
31581;2023;16;16;0;100;0;275297.5;2488.75;113.25
31582;2023;47;44;3;93.6170212765958;6.38297872340426;243111.042553191;2802.23404255319;88.7234042553192
31583;2023;11;11;0;100;0;252222;2287.54545454545;118.545454545455
31584;2023;85;68;17;80;20;184003.164705882;2207.84705882353;84.4705882352941
31585;2023;17;16;1;94.1176470588235;5.88235294117647;209907.411764706;1714.52941176471;119.352941176471
31586;2023;1;1;0;100;0;185830;1239;150
31587;2023;12;12;0;100;0;245735.666666667;2217;110.416666666667
31588;2023;120;84;36;70;30;236281.583333333;2946.19166666667;81.7333333333333
31589;2023;12;11;1;91.6666666666667;8.33333333333333;234972.5;2447.83333333333;97.5833333333333
31591;2023;4;4;0;100;0;140430;1533.75;87.5
31592;2023;23;23;0;100;0;269051.347826087;2453.04347826087;109.478260869565
31593;2023;2;2;0;100;0;142500;1203.5;118
32001;2023;11;11;0;100;0;170321.818181818;1567.63636363636;108.727272727273
32002;2023;1;1;0;100;0;168000;1527;110
32003;2023;1;1;0;100;0;338000;2181;155
32004;2023;2;2;0;100;0;178725;1329;129
32005;2023;2;2;0;100;0;280863;2546.5;110
32007;2023;2;2;0;100;0;190000;1640.5;117
32009;2023;1;1;0;100;0;313900;1495;210
32012;2023;16;16;0;100;0;163211.375;1567.75;105.8125
32013;2023;348;155;193;44.5402298850575;55.4597701149425;139270.028735632;1778.45977011494;79.6408045977011
32014;2023;1;1;0;100;0;120000;1818;66
32016;2023;4;4;0;100;0;329250;2074;156
32017;2023;1;1;0;100;0;158500;1910;83
32018;2023;2;2;0;100;0;193400;1855.5;107
32019;2023;2;2;0;100;0;173250;2139.5;82
32020;2023;4;4;0;100;0;311250;1728.5;174
32022;2023;1;1;0;100;0;210000;1180;178
32024;2023;2;2;0;100;0;202525;1313.5;174.5
32025;2023;4;4;0;100;0;157475;1149.25;143.5
32027;2023;22;19;3;86.3636363636364;13.6363636363636;144304.545454545;1306.59090909091;119.181818181818
32028;2023;1;1;0;100;0;170000;1000;170
32029;2023;5;5;0;100;0;198800;931.6;210
32030;2023;3;3;0;100;0;128340.666666667;1281.33333333333;95.3333333333333
32031;2023;1;1;0;100;0;293450;1969;149
32032;2023;3;2;1;66.6666666666667;33.3333333333333;101666.666666667;1285.33333333333;71.6666666666667
32033;2023;4;4;0;100;0;167137.5;1105.5;154.5
32034;2023;1;1;0;100;0;144000;1263;114
32035;2023;3;3;0;100;0;67333.3333333333;917.333333333333;71.6666666666667
32036;2023;8;8;0;100;0;180198;1836.5;94.75
32037;2023;5;5;0;100;0;192000;1540.2;119.4
32038;2023;1;1;0;100;0;247000;2398;103
32039;2023;2;2;0;100;0;165050;2432.5;67.5
32040;2023;2;2;0;100;0;213975;2130.5;134.5
32041;2023;2;2;0;100;0;127500;1827;69.5
32043;2023;3;3;0;100;0;314533.333333333;1268.66666666667;228.333333333333
32044;2023;4;4;0;100;0;224350;1932.25;112.75
32045;2023;1;1;0;100;0;550302;3057;180
32046;2023;1;1;0;100;0;212850;2365;90
32047;2023;1;1;0;100;0;168000;1244;135
32049;2023;1;1;0;100;0;167000;1336;125
32053;2023;1;1;0;100;0;376800;2093;180
32054;2023;3;3;0;100;0;206083.333333333;1728;118.666666666667
32055;2023;2;2;0;100;0;354520;2185.5;172
32058;2023;1;1;0;100;0;455000;2459;185
32060;2023;2;2;0;100;0;160200;1955;82.5
32061;2023;1;1;0;100;0;466580;5242;89
32062;2023;3;3;0;100;0;182000;1243.66666666667;146.666666666667
32063;2023;6;6;0;100;0;162525;1357.33333333333;125.166666666667
32064;2023;5;5;0;100;0;212900;1838.6;114.4
32065;2023;4;4;0;100;0;195750;1448;118.75
32066;2023;3;3;0;100;0;199416.666666667;1991;105.333333333333
32068;2023;3;3;0;100;0;174501.666666667;1750.33333333333;115.333333333333
32070;2023;6;6;0;100;0;175266.666666667;1579.83333333333;116.333333333333
32073;2023;3;3;0;100;0;107616.666666667;744;140.333333333333
32075;2023;4;4;0;100;0;200508;1548.5;140.75
32076;2023;5;5;0;100;0;272214;1777.6;148.6
32077;2023;1;1;0;100;0;205000;2278;90
32078;2023;1;1;0;100;0;42000;525;80
32079;2023;22;22;0;100;0;165157.727272727;1323.68181818182;123.909090909091
32080;2023;3;3;0;100;0;186400;1664.66666666667;114.333333333333
32081;2023;2;2;0;100;0;103375;764.5;123
32082;2023;2;2;0;100;0;197000;1253;169
32083;2023;22;22;0;100;0;165119.318181818;1401.45454545455;119.045454545455
32084;2023;1;1;0;100;0;190000;1696;112
32085;2023;4;4;0;100;0;241812.5;1879.75;121.75
32086;2023;2;2;0;100;0;285395;1854.5;154
32087;2023;1;1;0;100;0;150000;1250;120
32090;2023;1;1;0;100;0;364000;2619;139
32091;2023;3;3;0;100;0;164533.333333333;1836;96.3333333333333
32092;2023;1;1;0;100;0;402000;2772;145
32093;2023;2;2;0;100;0;140000;1661.5;84.5
32094;2023;5;5;0;100;0;165200;1976;101.2
32095;2023;8;8;0;100;0;242733.75;1871.125;133.75
32096;2023;89;29;60;32.5842696629214;67.4157303370787;80881.5617977528;1405.55056179775;58.4719101123596
32098;2023;5;5;0;100;0;350302;2564.4;160.6
32099;2023;1;1;0;100;0;182000;1400;130
32102;2023;5;5;0;100;0;213480;1760.6;119.4
32104;2023;1;1;0;100;0;293950;2296;128
32105;2023;1;1;0;100;0;583520;3536;165
32106;2023;13;13;0;100;0;218976.923076923;1752.30769230769;125
32107;2023;109;102;7;93.5779816513761;6.42201834862385;165705.009174312;1432.32110091743;111.660550458716
32108;2023;1;1;0;100;0;78500;835;94
32109;2023;2;2;0;100;0;85000;1396;65
32110;2023;7;7;0;100;0;153014.285714286;1361.42857142857;112.142857142857
32111;2023;1;1;0;100;0;75000;630;119
32112;2023;1;1;0;100;0;250000;2083;120
32113;2023;2;2;0;100;0;212000;1677.5;129
32115;2023;3;3;0;100;0;120696.666666667;976.666666666667;113.666666666667
32116;2023;1;1;0;100;0;426000;1311;325
32117;2023;6;6;0;100;0;199950;2180.33333333333;94
32119;2023;64;57;7;89.0625;10.9375;137132.296875;1488.234375;97.953125
32120;2023;4;4;0;100;0;252580.25;2092.5;123
32121;2023;5;5;0;100;0;223150;1851.4;107
32122;2023;2;2;0;100;0;121500;2281.5;68
32123;2023;4;4;0;100;0;264680;2968;101.5
32124;2023;4;4;0;100;0;205650;2105.25;105
32126;2023;5;5;0;100;0;174140;1107.6;155
32127;2023;10;10;0;100;0;118207;1148.1;93
32128;2023;4;4;0;100;0;325200;1394.5;202.5
32129;2023;3;2;1;66.6666666666667;33.3333333333333;220000;1535.66666666667;145.333333333333
32130;2023;1;1;0;100;0;98755;998;99
32131;2023;3;3;0;100;0;157260;1457.33333333333;112.666666666667
32132;2023;100;86;14;86;14;149475.44;1608.1;95.57
32133;2023;5;5;0;100;0;217660;1606.6;135.2
32134;2023;2;2;0;100;0;281515;2066.5;135.5
32136;2023;1;1;0;100;0;68000;971;70
32138;2023;2;2;0;100;0;137500;1450;95
32139;2023;3;3;0;100;0;130000;1074;121.333333333333
32141;2023;1;1;0;100;0;490000;2450;200
32142;2023;2;2;0;100;0;174846;1493.5;111
32143;2023;3;3;0;100;0;744533.333333333;2262.66666666667;287.333333333333
32145;2023;1;1;0;100;0;212500;2125;100
32146;2023;2;2;0;100;0;87500;851.5;114.5
32147;2023;36;30;6;83.3333333333333;16.6666666666667;154176.5;1548.5;102.527777777778
32149;2023;20;20;0;100;0;163287.7;2090.95;90.9
32150;2023;2;2;0;100;0;157000;1680;91.5
32151;2023;2;2;0;100;0;132500;968;138
32152;2023;3;3;0;100;0;230666.666666667;1823;124
32153;2023;1;1;0;100;0;177500;1707;104
32155;2023;19;19;0;100;0;149503.421052632;1505.05263157895;106.947368421053
32157;2023;1;1;0;100;0;390000;3714;105
32158;2023;2;2;0;100;0;204167.5;1458.5;140
32159;2023;9;9;0;100;0;147677.777777778;1275;110.111111111111
32160;2023;118;70;48;59.3220338983051;40.6779661016949;225213.661016949;2609.20338983051;88.8474576271186
32161;2023;2;2;0;100;0;176700;1661;106
32162;2023;11;11;0;100;0;168143.636363636;1374.45454545455;126.272727272727
32163;2023;1;1;0;100;0;114000;814;140
32165;2023;1;1;0;100;0;160000;1455;110
32166;2023;1;1;0;100;0;81000;1000;81
32167;2023;3;3;0;100;0;228031.333333333;1827.66666666667;134
32169;2023;2;2;0;100;0;165000;1151.5;142
32171;2023;1;1;0;100;0;50000;833;60
32173;2023;1;1;0;100;0;257000;1977;130
32174;2023;4;4;0;100;0;137987.5;2121.5;66.75
32175;2023;1;1;0;100;0;257890;1167;221
32176;2023;2;2;0;100;0;295000;1825;154
32177;2023;3;3;0;100;0;314116.333333333;1916.66666666667;165
32180;2023;8;8;0;100;0;204890.375;1695.25;127.75
32181;2023;5;5;0;100;0;206600.2;1385.2;140.6
32182;2023;2;2;0;100;0;264645;1926.5;144.5
32183;2023;1;1;0;100;0;230000;2091;110
32184;2023;1;1;0;100;0;273750;1766;155
32185;2023;1;1;0;100;0;260000;1926;135
32186;2023;2;2;0;100;0;257120;1518.5;201
32189;2023;1;1;0;100;0;123750;1345;92
32190;2023;9;9;0;100;0;164055.555555556;1154.44444444444;136.222222222222
32191;2023;1;1;0;100;0;45000;577;78
32192;2023;3;3;0;100;0;134235;1359.33333333333;96.3333333333333
32193;2023;5;5;0;100;0;172900;1685.8;104.8
32194;2023;1;1;0;100;0;1575000;4701;335
32198;2023;2;2;0;100;0;282870;2231.5;125
32199;2023;2;2;0;100;0;192750;1560;125
32200;2023;2;2;0;100;0;511000;3115;162.5
32202;2023;4;4;0;100;0;182250;1502.5;125.25
32203;2023;5;5;0;100;0;146000;1727.8;82
32204;2023;7;7;0;100;0;665139.714285714;3191.85714285714;154.714285714286
32207;2023;3;3;0;100;0;172016.666666667;1710;100.333333333333
32208;2023;57;46;11;80.7017543859649;19.2982456140351;190513.438596491;1933.77192982456;100.263157894737
32209;2023;5;5;0;100;0;155554;1454;107.4
32210;2023;3;3;0;100;0;386659.333333333;3731.66666666667;113
32212;2023;2;2;0;100;0;91750;1215.5;95
32213;2023;51;47;4;92.156862745098;7.84313725490196;177359.37254902;1841.13725490196;101.098039215686
32214;2023;2;2;0;100;0;288875;1847.5;154
32215;2023;1;1;0;100;0;294800;1474;200
32217;2023;1;1;0;100;0;335000;1861;180
32218;2023;2;2;0;100;0;138670;1503.5;92
32219;2023;5;5;0;100;0;119650;1205.2;123.6
32220;2023;1;1;0;100;0;190000;2065;92
32221;2023;4;4;0;100;0;219500;2573.5;95.25
32224;2023;2;2;0;100;0;165750;1334.5;117
32225;2023;2;2;0;100;0;133333.5;1114;108.5
32226;2023;1;1;0;100;0;315000;2072;152
32227;2023;8;8;0;100;0;140623.75;1194.875;117.125
32229;2023;1;1;0;100;0;235800;2358;100
32230;2023;1;1;0;100;0;85000;977;87
32231;2023;4;4;0;100;0;191437.5;1638.75;114.25
32233;2023;34;25;9;73.5294117647059;26.4705882352941;156005.176470588;1848.17647058824;87.0294117647059
32234;2023;1;1;0;100;0;125877;1998;63
32235;2023;4;4;0;100;0;190991.75;1290.75;154.5
32236;2023;1;1;0;100;0;292500;3656;80
32237;2023;6;6;0;100;0;210526.666666667;2264;97
32238;2023;2;2;0;100;0;1,00E+05;1043;116
32239;2023;5;5;0;100;0;266000;2910.8;100.8
32240;2023;1;1;0;100;0;247500;1719;144
32241;2023;3;3;0;100;0;205216.666666667;1913;105
32242;2023;23;19;4;82.6086956521739;17.3913043478261;190438.695652174;1703.04347826087;103.913043478261
32243;2023;2;2;0;100;0;131000;1117;114
32244;2023;4;4;0;100;0;193195;1862.5;108
32246;2023;1;1;0;100;0;226500;1872;121
32247;2023;3;3;0;100;0;192816.666666667;1545;123.666666666667
32248;2023;3;3;0;100;0;314733.333333333;1624;180.333333333333
32249;2023;37;34;3;91.8918918918919;8.10810810810811;205226.135135135;1806.75675675676;114.054054054054
32252;2023;16;16;0;100;0;140222;1191.0625;118.1875
32253;2023;5;5;0;100;0;175760;1320.2;134.6
32254;2023;2;2;0;100;0;124000;1021.5;119.5
32255;2023;2;2;0;100;0;100783;978;118
32256;2023;28;25;3;89.2857142857143;10.7142857142857;131047.678571429;1274.35714285714;102.428571428571
32257;2023;1;1;0;100;0;180000;2368;76
32258;2023;2;1;1;50;50;216000;2585.5;81.5
32260;2023;1;1;0;100;0;313500;1959;160
32261;2023;1;1;0;100;0;181750;3305;55
32262;2023;5;4;1;80;20;346072;2408.2;147.8
32263;2023;1;1;0;100;0;365000;1763;207
32264;2023;4;4;0;100;0;203250;1818;111.5
32266;2023;2;2;0;100;0;163150;1752.5;83.5
32267;2023;2;2;0;100;0;165650;1677.5;99
32268;2023;5;5;0;100;0;221680;2336.2;92.8
32269;2023;3;3;0;100;0;81000;967.333333333333;85.6666666666667
32270;2023;3;3;0;100;0;365653.333333333;2235;174
32271;2023;5;5;0;100;0;119710;1527;74.2
32272;2023;1;1;0;100;0;120000;1622;74
32273;2023;2;2;0;100;0;202100;2742.5;108
32274;2023;2;2;0;100;0;89000;1519;59
32276;2023;3;3;0;100;0;110820;1817.33333333333;61.6666666666667
32277;2023;2;2;0;100;0;215500;1951;118
32278;2023;3;3;0;100;0;171697;1373.66666666667;155.666666666667
32279;2023;3;3;0;100;0;207316.666666667;1519.33333333333;133.333333333333
32280;2023;2;2;0;100;0;172500;1012.5;167.5
32281;2023;1;1;0;100;0;145000;1510;96
32282;2023;1;1;0;100;0;55000;859;64
32283;2023;6;6;0;100;0;200558.166666667;1404.66666666667;148.5
32284;2023;1;1;0;100;0;275200;1859;148
32285;2023;9;9;0;100;0;156113.333333333;1493.44444444444;110.333333333333
32286;2023;6;6;0;100;0;233750;2143;109.833333333333
32288;2023;1;1;0;100;0;115000;2396;48
32289;2023;2;2;0;100;0;153500;1373;126
32290;2023;19;17;2;89.4736842105263;10.5263157894737;158315.842105263;1363.42105263158;113.315789473684
32292;2023;6;6;0;100;0;276333.333333333;1980.66666666667;123
32294;2023;1;1;0;100;0;80000;696;115
32295;2023;2;2;0;100;0;348278.5;3119.5;111
32296;2023;31;24;7;77.4193548387097;22.5806451612903;133546.774193548;1475.64516129032;93.0322580645161
32297;2023;3;3;0;100;0;175400;2137.66666666667;80
32298;2023;5;5;0;100;0;145520;1319.8;107.2
32299;2023;2;2;0;100;0;96000;1000.5;89
32300;2023;2;2;0;100;0;194850;1552.5;124
32301;2023;9;9;0;100;0;272340.666666667;2004.44444444444;129
32302;2023;1;1;0;100;0;1,00E+05;1667;60
32303;2023;1;1;0;100;0;292500;2089;140
32304;2023;2;2;0;100;0;183805;1598;115.5
32305;2023;11;11;0;100;0;120272.727272727;1129.45454545455;115.363636363636
32306;2023;5;5;0;100;0;276793.6;2235.4;117.2
32307;2023;27;25;2;92.5925925925926;7.40740740740741;179260.185185185;2020.96296296296;92
32308;2023;2;2;0;100;0;444455;2413;193.5
32309;2023;1;1;0;100;0;210000;1826;115
32310;2023;1;1;0;100;0;150000;1456;103
32311;2023;2;2;0;100;0;156000;1389;120.5
32312;2023;5;4;1;80;20;201520;1807.4;109.6
32313;2023;2;2;0;100;0;140000;1013.5;202.5
32314;2023;1;1;0;100;0;120000;1017;118
32315;2023;4;4;0;100;0;98275;1403.25;84.75
32317;2023;1;1;0;100;0;3,00E+05;1724;174
32318;2023;2;2;0;100;0;153929;1528;101
32319;2023;13;13;0;100;0;144686.923076923;1674.61538461538;90.4615384615385
32320;2023;2;2;0;100;0;213397;2885;89
32321;2023;1;1;0;100;0;351265;2977;118
32323;2023;1;1;0;100;0;222000;1110;200
32324;2023;2;2;0;100;0;203350;1709;126
32327;2023;2;2;0;100;0;337500;1805;172
32328;2023;2;2;0;100;0;322540.5;3374;95.5
32329;2023;1;1;0;100;0;577500;5775;100
32330;2023;2;2;0;100;0;168500;1685;100
32331;2023;13;10;3;76.9230769230769;23.0769230769231;183145.384615385;2141.69230769231;86.3846153846154
32333;2023;2;2;0;100;0;195000;1666.5;138
32334;2023;15;15;0;100;0;328128.133333333;3350.73333333333;105.4
32335;2023;6;6;0;100;0;175083.333333333;1783.66666666667;102.833333333333
32336;2023;4;4;0;100;0;229755;1293.75;165
32338;2023;2;2;0;100;0;204750;2297;90
32339;2023;4;4;0;100;0;237375;2171;106.25
32340;2023;3;3;0;100;0;114000;2049.33333333333;61
32341;2023;2;2;0;100;0;196575;1904;110.5
32343;2023;2;2;0;100;0;144050;1366.5;128
32344;2023;16;15;1;93.75;6.25;112000;1333.6875;90.625
32345;2023;6;6;0;100;0;209533.333333333;2165.83333333333;97.6666666666667
32346;2023;2;2;0;100;0;375150;2171;186
32348;2023;4;4;0;100;0;132000;1199.5;85
32349;2023;2;2;0;100;0;267825;2232;122
32350;2023;2;2;0;100;0;130000;1463.5;88
32351;2023;1;1;0;100;0;1,00E+05;862;116
32352;2023;1;1;0;100;0;1,00E+05;1333;75
32354;2023;2;2;0;100;0;3,00E+05;2611;136
32355;2023;1;1;0;100;0;283020;1459;194
32358;2023;2;2;0;100;0;203850;2159.5;100
32359;2023;3;3;0;100;0;180800;1536;101
32360;2023;3;3;0;100;0;204750;1127;190.666666666667
32362;2023;1;1;0;100;0;208630;1320;158
32365;2023;2;2;0;100;0;64172.5;1708.5;37.5
32366;2023;2;2;0;100;0;188812.5;2264.5;85
32367;2023;1;1;0;100;0;390000;1189;328
32368;2023;9;6;3;66.6666666666667;33.3333333333333;115383.333333333;1121.66666666667;99.6666666666667
32369;2023;6;6;0;100;0;249270;1737.16666666667;143
32370;2023;12;11;1;91.6666666666667;8.33333333333333;162372.666666667;1518.33333333333;110.75
32372;2023;1;1;0;100;0;431100;2177;198
32373;2023;4;4;0;100;0;134125;1052.25;129
32375;2023;3;3;0;100;0;161666.666666667;1537.66666666667;103
32376;2023;1;1;0;100;0;548000;3468;158
32378;2023;3;3;0;100;0;140566.666666667;1272.33333333333;107.666666666667
32380;2023;1;1;0;100;0;196000;1032;190
32381;2023;4;4;0;100;0;171500;1481.75;107.75
32382;2023;7;7;0;100;0;185535.714285714;1696.42857142857;112.571428571429
32383;2023;3;3;0;100;0;151066.666666667;1595.66666666667;101.666666666667
32384;2023;2;2;0;100;0;299250;2034;150
32385;2023;1;1;0;100;0;190000;1583;120
32387;2023;2;2;0;100;0;133500;1058;126
32388;2023;2;2;0;100;0;275875;1967;140.5
32389;2023;7;7;0;100;0;233085.714285714;1785.57142857143;119
32390;2023;1;1;0;100;0;143000;1986;72
32391;2023;2;2;0;100;0;50480;879.5;51.5
32392;2023;2;2;0;100;0;154000;1480.5;104.5
32393;2023;4;4;0;100;0;327000;2645.25;130
32395;2023;3;3;0;100;0;121100;1376;81.6666666666667
32396;2023;6;6;0;100;0;110333.333333333;1188;94.3333333333333
32397;2023;6;6;0;100;0;247158.333333333;1490.5;164.333333333333
32398;2023;1;1;0;100;0;195000;1455;134
32400;2023;3;3;0;100;0;149000;1592;95.6666666666667
32401;2023;1;1;0;100;0;120000;1200;100
32402;2023;2;2;0;100;0;186250;1515.5;124.5
32404;2023;12;12;0;100;0;164166.666666667;1547.75;99.6666666666667
32405;2023;1;1;0;100;0;216800;1694;128
32406;2023;2;2;0;100;0;116000;1066;128
32407;2023;2;2;0;100;0;206025;1952.5;107
32408;2023;1;1;0;100;0;166000;1071;155
32409;2023;2;2;0;100;0;217335;2028;111
32410;2023;23;21;2;91.304347826087;8.69565217391304;238661.304347826;2087.95652173913;120.217391304348
32411;2023;3;3;0;100;0;326090;1811.33333333333;173.333333333333
32412;2023;16;14;2;87.5;12.5;108502.1875;1413.0625;85.5
32414;2023;3;3;0;100;0;131586.666666667;1081.66666666667;123
32415;2023;4;4;0;100;0;201662.5;2007.25;105.75
32417;2023;4;4;0;100;0;163027.5;1162;140
32418;2023;1;1;0;100;0;170000;817;208
32420;2023;1;1;0;100;0;210000;1750;120
32421;2023;2;2;0;100;0;279850;2646;106
32424;2023;2;2;0;100;0;250000;5223;56.5
32425;2023;10;10;0;100;0;242858.1;2917.9;85.1
32426;2023;16;14;2;87.5;12.5;179034.375;1523.0625;116.75
32429;2023;2;2;0;100;0;137500;1503.5;79.5
32430;2023;1;1;0;100;0;70000;972;72
32431;2023;1;1;0;100;0;75000;1000;75
32432;2023;1;1;0;100;0;165000;971;170
32433;2023;13;12;1;92.3076923076923;7.69230769230769;151512.307692308;1478.92307692308;103.076923076923
32436;2023;6;6;0;100;0;162711.666666667;1384.66666666667;124.333333333333
32437;2023;3;3;0;100;0;96093.3333333333;1060.66666666667;91
32438;2023;2;2;0;100;0;226375;1547;138
32439;2023;6;6;0;100;0;170666.666666667;1083.33333333333;153.833333333333
32440;2023;3;3;0;100;0;209480;1795.33333333333;122.666666666667
32441;2023;1;1;0;100;0;124000;939;132
32442;2023;2;2;0;100;0;207500;2169;107
32443;2023;1;1;0;100;0;820000;2645;310
32444;2023;1;1;0;100;0;238300;2508;95
32445;2023;4;4;0;100;0;163875;2065.75;93.5
32446;2023;1;1;0;100;0;306500;1613;190
32448;2023;5;5;0;100;0;142484.6;1315.4;117.2
32449;2023;1;1;0;100;0;141500;2358;60
32450;2023;3;3;0;100;0;188500;1310.33333333333;155.666666666667
32451;2023;2;2;0;100;0;413175;2211.5;198
32452;2023;2;2;0;100;0;254580.5;1379.5;189
32455;2023;2;2;0;100;0;131000;863.5;173.5
32456;2023;1;1;0;100;0;250000;1337;187
32457;2023;3;3;0;100;0;208233.333333333;2190;96.6666666666667
32458;2023;4;4;0;100;0;137000;1600.25;87.25
32459;2023;12;12;0;100;0;128645.75;1492.83333333333;87.6666666666667
32460;2023;2;2;0;100;0;199400;2236;88
32462;2023;46;41;5;89.1304347826087;10.8695652173913;137005.47826087;1299.69565217391;105.065217391304
32463;2023;13;13;0;100;0;188009.538461538;1486.15384615385;122.384615384615
32464;2023;6;6;0;100;0;162965;1714.83333333333;96.3333333333333
32465;2023;1;1;0;100;0;70000;1111;63
32468;2023;1;1;0;100;0;170000;2125;80
33001;2023;19;19;0;100;0;162010.736842105;1663;99
33002;2023;11;11;0;100;0;224148.181818182;1540.09090909091;163.818181818182
33003;2023;149;114;35;76.510067114094;23.489932885906;247913.375838926;3044.46979865772;84.2147651006711
33004;2023;45;19;26;42.2222222222222;57.7777777777778;129755.311111111;2096.17777777778;63.2666666666667
33005;2023;207;157;50;75.8454106280193;24.1545893719807;503396.096618357;6221.32850241546;83.8260869565217
33006;2023;12;12;0;100;0;138991.583333333;1461.58333333333;104.5
33007;2023;12;12;0;100;0;335268.75;3823.58333333333;85
33008;2023;4;4;0;100;0;215725;2178;110.25
33009;2023;443;120;323;27.0880361173815;72.9119638826185;586347.424379232;8755.81264108352;64.9435665914221
33010;2023;7;7;0;100;0;339818;2862.42857142857;129.714285714286
33011;2023;103;82;21;79.6116504854369;20.3883495145631;448825.912621359;5837.88349514563;80.747572815534
33012;2023;35;27;8;77.1428571428572;22.8571428571429;293258.8;3238.57142857143;91.7142857142857
33013;2023;81;46;35;56.7901234567901;43.2098765432099;263905.444444444;3224.77777777778;83.2962962962963
33014;2023;9;9;0;100;0;225722.222222222;2112.88888888889;114.888888888889
33015;2023;23;22;1;95.6521739130435;4.34782608695652;253775.260869565;2471.91304347826;104.260869565217
33016;2023;2;2;0;100;0;173500;1682;103
33017;2023;3;3;0;100;0;228333.333333333;2235.66666666667;110
33018;2023;23;19;4;82.6086956521739;17.3913043478261;214772.869565217;2350.39130434783;100.173913043478
33019;2023;132;80;52;60.6060606060606;39.3939393939394;312733.075757576;4021.31060606061;78.8712121212121
33020;2023;3;3;0;100;0;128766.666666667;1400.66666666667;81.6666666666667
33021;2023;9;9;0;100;0;229586.888888889;2532.66666666667;89.5555555555556
33022;2023;41;39;2;95.1219512195122;4.8780487804878;283406.926829268;2903.85365853659;98.6829268292683
33023;2023;14;14;0;100;0;349078.571428571;3096.21428571429;117.357142857143
33024;2023;4;4;0;100;0;225250;1660.75;140.5
33025;2023;2;2;0;100;0;204440;2182;94
33026;2023;5;5;0;100;0;234780;3055.4;83.6
33027;2023;3;3;0;100;0;173000;1540.33333333333;120.666666666667
33028;2023;10;10;0;100;0;275278.5;2651.4;101.7
33029;2023;53;48;5;90.5660377358491;9.43396226415094;377738.301886792;3868.69811320755;99.4339622641509
33030;2023;32;30;2;93.75;6.25;220959.53125;2182.15625;102.53125
33031;2023;1;1;0;100;0;125000;845;148
33032;2023;76;43;33;56.578947368421;43.421052631579;223258.223684211;2939.98684210526;76.6578947368421
33033;2023;5;5;0;100;0;359548.6;4926.2;70
33034;2023;3;3;0;100;0;111919.333333333;1453.66666666667;86.6666666666667
33035;2023;8;8;0;100;0;178951;2495.25;74
33036;2023;49;43;6;87.7551020408163;12.2448979591837;230289.489795918;2206.02040816327;103.428571428571
33037;2023;19;19;0;100;0;295377.473684211;3115.10526315789;95.5263157894737
33038;2023;8;8;0;100;0;182650;1584.5;110.125
33039;2023;429;193;236;44.988344988345;55.011655011655;286202.244755245;4014.93706293706;71.3729603729604
33040;2023;14;14;0;100;0;215760;2311.28571428571;98.6428571428571
33042;2023;75;72;3;96;4;309613.186666667;3168.46666666667;100.706666666667
33043;2023;1;1;0;100;0;3,00E+05;2830;106
33044;2023;3;3;0;100;0;379116.666666667;2193.33333333333;172.666666666667
33045;2023;2;2;0;100;0;362055;2070.5;161
33046;2023;18;18;0;100;0;155996.444444444;1816.38888888889;86.5
33047;2023;35;35;0;100;0;212260.742857143;1688.08571428571;127.8
33048;2023;2;2;0;100;0;313700;3256.5;108.5
33049;2023;22;22;0;100;0;329184.727272727;3460.77272727273;98.6818181818182
33050;2023;14;14;0;100;0;288371.428571429;1978.21428571429;149.928571428571
33051;2023;132;108;24;81.8181818181818;18.1818181818182;307231.287878788;3695.99242424242;87.7121212121212
33052;2023;18;11;7;61.1111111111111;38.8888888888889;213287.111111111;2385.55555555556;89.4444444444444
33053;2023;3;3;0;100;0;150600;1534.33333333333;99
33055;2023;4;4;0;100;0;203037.5;1686.5;114.5
33056;2023;152;107;45;70.3947368421053;29.6052631578947;322772.276315789;3594.67763157895;91.625
33057;2023;7;7;0;100;0;173850;1627.71428571429;104.857142857143
33058;2023;61;41;20;67.2131147540984;32.7868852459016;138541.901639344;1766.18032786885;79.7049180327869
33059;2023;2;2;0;100;0;280000;2575;103.5
33060;2023;4;4;0;100;0;172900;1672.25;94
33061;2023;11;11;0;100;0;376647.454545455;3272.63636363636;114.818181818182
33062;2023;8;8;0;100;0;301831.25;2473.125;126
33063;2023;4333;1056;3277;24.3711054696515;75.6288945303485;336933.728132933;4895.6704361874;68.7770597738288
33065;2023;34;30;4;88.2352941176471;11.7647058823529;525395.264705882;4043.64705882353;124.794117647059
33067;2023;39;32;7;82.051282051282;17.9487179487179;185477.179487179;1818.97435897436;100.25641025641
33069;2023;338;170;168;50.2958579881657;49.7041420118343;430692.763313609;4880.12426035503;85.3047337278107
33070;2023;5;5;0;100;0;298792.8;3534.6;89.2
33071;2023;11;11;0;100;0;236457.909090909;2043.72727272727;127.181818181818
33073;2023;11;11;0;100;0;164199;1673.54545454545;106.818181818182
33074;2023;3;3;0;100;0;339480;1635.66666666667;197.333333333333
33075;2023;299;83;216;27.7591973244147;72.2408026755853;301217.444816053;3889.30100334448;75.8294314381271
33076;2023;7;7;0;100;0;254092.857142857;1815.71428571429;148.428571428571
33077;2023;25;25;0;100;0;309214.8;3131.08;101.48
33078;2023;5;5;0;100;0;236800;1930.2;130.6
33080;2023;79;60;19;75.9493670886076;24.0506329113924;301099.949367089;3812.94936708861;81.3037974683544
33081;2023;18;15;3;83.3333333333333;16.6666666666667;162022.222222222;2126;77.5
33082;2023;15;15;0;100;0;240012;2287.33333333333;106.866666666667
33083;2023;8;8;0;100;0;281982.5;3115;91.375
33084;2023;13;10;3;76.9230769230769;23.0769230769231;239857.692307692;3170.07692307692;79
33085;2023;35;33;2;94.2857142857143;5.71428571428571;508930.114285714;4026.71428571429;122.714285714286
33086;2023;5;5;0;100;0;180012;2060;86.4
33087;2023;3;3;0;100;0;278695;1044.66666666667;247
33088;2023;6;6;0;100;0;132633.333333333;1594.83333333333;83.3333333333333
33089;2023;4;4;0;100;0;87575;1476.75;62.75
33090;2023;37;31;6;83.7837837837838;16.2162162162162;347285.297297297;3799.64864864865;91.8648648648649
33093;2023;7;7;0;100;0;276571.428571429;2968.28571428571;95.7142857142857
33094;2023;6;6;0;100;0;181763.333333333;1516.33333333333;120.833333333333
33095;2023;13;13;0;100;0;112376.923076923;1380;82.0769230769231
33096;2023;78;57;21;73.0769230769231;26.9230769230769;274823.692307692;3049.11538461538;90.8333333333333
33097;2023;71;39;32;54.9295774647887;45.0704225352113;245984.23943662;4433.04225352113;61.169014084507
33098;2023;5;5;0;100;0;161300;2461.4;64.4
33099;2023;39;34;5;87.1794871794872;12.8205128205128;426074.179487179;3675.41025641026;117.820512820513
33100;2023;15;15;0;100;0;249268.266666667;2308.33333333333;102.2
33101;2023;12;12;0;100;0;161791.333333333;1391.91666666667;116.75
33102;2023;4;4;0;100;0;148532.5;1913.75;94
33104;2023;63;50;13;79.3650793650794;20.6349206349206;236104.698412698;2904.26984126984;81.8571428571429
33105;2023;1;1;0;100;0;224837;2392;94
33106;2023;8;8;0;100;0;186543.75;1789;105.625
33108;2023;50;35;15;70;30;109643.24;1380.62;81.82
33109;2023;30;29;1;96.6666666666667;3.33333333333333;278299.5;2911.73333333333;101.433333333333
33111;2023;8;8;0;100;0;132275.625;1344.625;105.375
33113;2023;2;2;0;100;0;95250;874;109
33114;2023;48;33;15;68.75;31.25;180217.270833333;2112.125;90.0416666666667
33115;2023;2;2;0;100;0;247975;2191;114
33116;2023;3;3;0;100;0;263026.666666667;2624.66666666667;100
33117;2023;3;3;0;100;0;179622.333333333;2173;86.6666666666667
33118;2023;20;20;0;100;0;604645.8;4334.25;139.35
33119;2023;340;113;227;33.2352941176471;66.7647058823529;206338.158823529;3382.97647058824;62.9058823529412
33120;2023;29;28;1;96.551724137931;3.44827586206897;249205.655172414;2435.72413793103;103.758620689655
33122;2023;130;121;9;93.0769230769231;6.92307692307692;450269.230769231;4125.2;112.730769230769
33123;2023;23;23;0;100;0;234193.173913043;2136.04347826087;111.347826086957
33124;2023;5;5;0;100;0;176500;1589.2;106.2
33125;2023;26;26;0;100;0;225610.923076923;2146.46153846154;107.807692307692
33126;2023;8;8;0;100;0;185449.625;1595.25;111.5
33127;2023;2;2;0;100;0;230500;2566;88
33128;2023;11;11;0;100;0;182299.818181818;1868.45454545455;103.090909090909
33130;2023;7;7;0;100;0;252182.857142857;2169.85714285714;136.428571428571
33132;2023;7;7;0;100;0;189458.428571429;2170;94.7142857142857
33134;2023;8;8;0;100;0;199500.5;1534;141.25
33136;2023;4;4;0;100;0;231500;1926.25;118
33137;2023;4;4;0;100;0;195560;1575.75;119.75
33138;2023;127;99;28;77.9527559055118;22.0472440944882;166419.25984252;2011.23622047244;85.1023622047244
33140;2023;67;55;12;82.089552238806;17.910447761194;239470.47761194;2915.0447761194;84.1940298507463
33141;2023;7;7;0;100;0;410442.857142857;3307;124.285714285714
33142;2023;16;16;0;100;0;252393.4375;2494.1875;101.75
33143;2023;24;24;0;100;0;248668.333333333;2536.25;101.583333333333
33144;2023;7;7;0;100;0;202335.714285714;2147;96.1428571428571
33145;2023;4;4;0;100;0;318745;2886.5;109.75
33146;2023;16;16;0;100;0;256304.0625;2298.625;114.3125
33147;2023;2;2;0;100;0;257500;2116;121
33148;2023;1;1;0;100;0;141000;1128;125
33150;2023;2;2;0;100;0;224262.5;2165.5;103
33151;2023;6;6;0;100;0;147666.666666667;1707.5;88.1666666666667
33152;2023;1;1;0;100;0;110000;2037;54
33153;2023;3;3;0;100;0;380666.666666667;2254.66666666667;162.333333333333
33154;2023;27;21;6;77.7777777777778;22.2222222222222;105103.185185185;1285.92592592593;83.6296296296296
33155;2023;2;2;0;100;0;146710;2088.5;89
33156;2023;1;1;0;100;0;165000;948;174
33157;2023;8;8;0;100;0;269659.375;2404;120.625
33159;2023;25;22;3;88;12;105868.32;1386.76;76.88
33160;2023;3;3;0;100;0;225533.333333333;2278;98.3333333333333
33161;2023;12;12;0;100;0;215801.583333333;1561.83333333333;141.666666666667
33162;2023;334;157;177;47.0059880239521;52.9940119760479;291078.083832335;3881.30239520958;74.9071856287425
33163;2023;1;1;0;100;0;242000;2719;89
33164;2023;21;21;0;100;0;278738.80952381;2553.85714285714;108.857142857143
33165;2023;45;24;21;53.3333333333333;46.6666666666667;285390.755555556;3596.17777777778;82.0222222222222
33166;2023;9;9;0;100;0;164944.444444444;1498.77777777778;105.222222222222
33167;2023;163;90;73;55.2147239263804;44.7852760736196;274360.797546012;3532.53987730061;78.638036809816
33168;2023;5;5;0;100;0;95100;970.6;91
33170;2023;12;12;0;100;0;124182.5;1282.41666666667;97.75
33172;2023;3;3;0;100;0;135200;1390;97.3333333333333
33173;2023;2;2;0;100;0;171500;1539.5;112
33174;2023;8;8;0;100;0;279741.25;2362.625;120.75
33175;2023;6;6;0;100;0;186885;1654.66666666667;111.833333333333
33176;2023;2;2;0;100;0;170500;1628.5;103.5
33177;2023;29;24;5;82.7586206896552;17.2413793103448;168012.413793103;2424.24137931034;82.9655172413793
33178;2023;3;3;0;100;0;215666.666666667;1510.66666666667;144.333333333333
33179;2023;48;41;7;85.4166666666667;14.5833333333333;200676.041666667;2161.9375;94.375
33180;2023;1;1;0;100;0;385170;1167;330
33181;2023;2;2;0;100;0;513500.5;5170.5;113
33182;2023;9;9;0;100;0;225818;2064.33333333333;110.111111111111
33183;2023;10;10;0;100;0;291825;2880;101.8
33184;2023;2;2;0;100;0;287500;1658;203
33185;2023;20;16;4;80;20;230439.75;2369.75;98.25
33186;2023;16;16;0;100;0;159768.75;1507.1875;107
33187;2023;20;12;8;60;40;123354.5;1661.55;77.6
33188;2023;5;5;0;100;0;194200;1664;126.2
33189;2023;6;6;0;100;0;157893.166666667;1667;95.5
33191;2023;6;6;0;100;0;280843.666666667;2428.5;149.5
33192;2023;297;120;177;40.4040404040404;59.5959595959596;286313.050505051;3925.54545454545;74.2794612794613
33193;2023;26;26;0;100;0;271717.307692308;3184.46153846154;87.8076923076923
33194;2023;10;10;0;100;0;216400;1585;142.7
33195;2023;20;19;1;95;5;146466.75;1347.2;117.75
33197;2023;1;1;0;100;0;210000;1544;136
33198;2023;25;24;1;96;4;164744.2;1510.44;118.88
33199;2023;331;255;76;77.0392749244713;22.9607250755287;434532.598187311;5407.39577039275;82.6253776435045
33200;2023;149;70;79;46.9798657718121;53.0201342281879;292028.194630872;3761.68456375839;78.5838926174497
33201;2023;6;5;1;83.3333333333333;16.6666666666667;274333.333333333;2271.33333333333;124
33202;2023;22;19;3;86.3636363636364;13.6363636363636;301554.545454545;3339.09090909091;93.2727272727273
33203;2023;91;65;26;71.4285714285714;28.5714285714286;235775.208791209;3858.17582417582;63.6483516483516
33204;2023;7;7;0;100;0;195894.285714286;1586.42857142857;130.428571428571
33205;2023;8;8;0;100;0;260451;2331.375;116
33206;2023;4;4;0;100;0;247375;2286.25;147.5
33207;2023;45;45;0;100;0;367947.822222222;3016.66666666667;119.511111111111
33208;2023;10;10;0;100;0;243886.1;2013.6;123.7
33209;2023;6;6;0;100;0;282566.666666667;2342;124
33210;2023;2;2;0;100;0;168500;1894;117.5
33211;2023;4;4;0;100;0;228462.5;2643.75;84.5
33212;2023;3;3;0;100;0;284454.666666667;2360;136.666666666667
33213;2023;37;32;5;86.4864864864865;13.5135135135135;419893.675675676;3679.75675675676;113.72972972973
33214;2023;240;137;103;57.0833333333333;42.9166666666667;333681.191666667;5636.15416666667;58.6458333333333
33216;2023;3;3;0;100;0;246283.333333333;2025.66666666667;118
33218;2023;13;13;0;100;0;205387.153846154;1880.15384615385;107
33219;2023;25;21;4;84;16;224250.84;2416;92.4
33220;2023;14;14;0;100;0;212521.642857143;2456.71428571429;87.7142857142857
33221;2023;14;13;1;92.8571428571429;7.14285714285714;126461.928571429;1245.14285714286;102.785714285714
33222;2023;5;5;0;100;0;201200;2081;100.4
33223;2023;3;3;0;100;0;209183.333333333;1408.33333333333;137.666666666667
33224;2023;3;3;0;100;0;261683.333333333;1432.33333333333;156.666666666667
33225;2023;29;28;1;96.551724137931;3.44827586206897;250633.413793103;2234.68965517241;111.51724137931
33226;2023;29;28;1;96.551724137931;3.44827586206897;196939.517241379;2077.79310344828;104.068965517241
33227;2023;131;71;60;54.1984732824427;45.8015267175573;157908.061068702;2143.98473282443;78.8320610687023
33228;2023;1;1;0;100;0;130000;1313;99
33229;2023;119;92;27;77.3109243697479;22.6890756302521;411056.521008403;5104.65546218487;82.3697478991597
33230;2023;5;5;0;100;0;179800;1916.4;115.6
33231;2023;1;1;0;100;0;291350;3004;97
33233;2023;16;16;0;100;0;230947.0625;2421.125;100.5
33234;2023;28;25;3;89.2857142857143;10.7142857142857;420479.678571429;3780.32142857143;119.821428571429
33235;2023;2;2;0;100;0;642500;3537.5;169
33236;2023;146;108;38;73.972602739726;26.027397260274;896654.116438356;9878.25342465753;93.3082191780822
33237;2023;11;11;0;100;0;210913.636363636;2787.36363636364;101.363636363636
33238;2023;101;92;9;91.0891089108911;8.91089108910891;397338.326732673;3804.43564356436;102.138613861386
33239;2023;3;3;0;100;0;260816.666666667;1657.33333333333;161
33240;2023;91;66;25;72.5274725274725;27.4725274725275;162122.681318681;1945.23076923077;83.9010989010989
33241;2023;7;7;0;100;0;165385.714285714;2043.57142857143;88.5714285714286
33242;2023;11;11;0;100;0;156010.909090909;1259.54545454545;140
33243;2023;382;217;165;56.8062827225131;43.1937172774869;209811.041884817;2705.63612565445;77.3298429319372
33244;2023;1;1;0;100;0;210000;2386;88
33245;2023;10;10;0;100;0;309860;2485.1;132.7
33246;2023;2;2;0;100;0;95000;1234;72.5
33247;2023;1;1;0;100;0;419000;1822;230
33248;2023;32;32;0;100;0;248514.78125;2463.40625;104.34375
33249;2023;185;63;122;34.0540540540541;65.945945945946;200477.810810811;2860.17297297297;70.6486486486486
33250;2023;2;2;0;100;0;316925;2141.5;152
33251;2023;7;7;0;100;0;282541.428571429;2624;110.857142857143
33252;2023;8;8;0;100;0;377701.5;3097;114
33253;2023;7;7;0;100;0;179221.428571429;1961.85714285714;95.8571428571429
33254;2023;2;2;0;100;0;197175;1637.5;119
33255;2023;2;2;0;100;0;182891;1399;128
33256;2023;60;47;13;78.3333333333333;21.6666666666667;272398.666666667;3190.61666666667;85.3
33257;2023;2;2;0;100;0;210500;2449.5;85.5
33258;2023;2;2;0;100;0;105500;696;150
33259;2023;11;11;0;100;0;210387.272727273;2193.63636363636;97.7272727272727
33260;2023;6;6;0;100;0;230333.333333333;1992.16666666667;117.833333333333
33261;2023;16;15;1;93.75;6.25;257069.875;1795.0625;131.5
33262;2023;48;44;4;91.6666666666667;8.33333333333333;272689.895833333;3001.3125;96.0833333333333
33264;2023;11;11;0;100;0;166867.909090909;1687.45454545455;99
33266;2023;6;6;0;100;0;307458.333333333;2605.16666666667;119.666666666667
33268;2023;29;27;2;93.1034482758621;6.89655172413793;248712.75862069;2722.96551724138;103.413793103448
33269;2023;2;2;0;100;0;417790;1961.5;198
33271;2023;4;4;0;100;0;192452.5;2103;94.75
33272;2023;11;11;0;100;0;284004.545454545;2408.72727272727;120.545454545455
33273;2023;66;51;15;77.2727272727273;22.7272727272727;379852.515151515;3915.74242424242;98.5151515151515
33274;2023;20;18;2;90;10;432942.5;4038.65;105.2
33276;2023;1;1;0;100;0;252180;3192;79
33277;2023;2;2;0;100;0;268500;2882;88.5
33278;2023;2;2;0;100;0;238100;2055;117.5
33279;2023;8;8;0;100;0;203256.375;1907;108.625
33280;2023;3;3;0;100;0;189300;1528.66666666667;130.333333333333
33281;2023;1026;340;686;33.1384015594542;66.8615984405458;289745.012670565;3940.18226120858;73.1267056530214
33282;2023;1;1;0;100;0;423000;2712;156
33283;2023;2;2;0;100;0;237747.5;1986;108
33284;2023;93;84;9;90.3225806451613;9.67741935483871;373976.903225806;4181.65591397849;92.6881720430108
33285;2023;7;7;0;100;0;233367.857142857;2345.85714285714;106.285714285714
33287;2023;2;2;0;100;0;173975;1729;105
33288;2023;1;1;0;100;0;110000;1571;70
33289;2023;33;31;2;93.9393939393939;6.06060606060606;175029.03030303;1656.30303030303;99.4848484848485
33290;2023;20;19;1;95;5;404835.7;2667.6;142.5
33291;2023;2;2;0;100;0;154500;1709.5;96
33293;2023;51;33;18;64.7058823529412;35.2941176470588;241767.843137255;3117.58823529412;83.6862745098039
33294;2023;7;7;0;100;0;179872.857142857;1503.14285714286;117.571428571429
33295;2023;1;1;0;100;0;224173;2637;85
33296;2023;7;7;0;100;0;122142.857142857;1367.85714285714;87.5714285714286
33297;2023;24;24;0;100;0;263446.166666667;2554.375;110.375
33298;2023;12;9;3;75;25;239212.25;2379.66666666667;98.5
33299;2023;2;2;0;100;0;111250;1159.5;126.5
33300;2023;12;12;0;100;0;273096.166666667;3095.91666666667;88.0833333333333
33301;2023;4;4;0;100;0;200400;1545;130.25
33302;2023;5;5;0;100;0;281900;2543.8;115.2
33303;2023;2;2;0;100;0;162750;1762;87.5
33304;2023;1;1;0;100;0;250500;1869;134
33305;2023;7;7;0;100;0;206918.571428571;2133.28571428571;103.142857142857
33307;2023;15;15;0;100;0;220740.333333333;2002.46666666667;114.733333333333
33308;2023;1;1;0;100;0;160000;1333;120
33309;2023;8;8;0;100;0;177442.75;2048.25;86.375
33310;2023;2;2;0;100;0;246500;2021;126.5
33311;2023;18;14;4;77.7777777777778;22.2222222222222;198285.666666667;2270.61111111111;87.7777777777778
33312;2023;108;69;39;63.8888888888889;36.1111111111111;284001.064814815;3483.48148148148;84.3518518518518
33314;2023;49;46;3;93.8775510204082;6.12244897959184;144663.06122449;1841.89795918367;86.1020408163265
33315;2023;21;21;0;100;0;161394.285714286;1822.66666666667;97.1904761904762
33316;2023;8;8;0;100;0;247421.25;1679.875;152.875
33317;2023;11;11;0;100;0;223873.818181818;2686.27272727273;84.9090909090909
33318;2023;612;344;268;56.2091503267974;43.7908496732026;336074.696078431;4079.54248366013;82.5098039215686
33319;2023;9;9;0;100;0;151717.111111111;1737.44444444444;95.4444444444444
33320;2023;7;7;0;100;0;169142.857142857;1963.85714285714;87.2857142857143
33321;2023;18;18;0;100;0;285601.111111111;2980.16666666667;96.6666666666667
33322;2023;45;44;1;97.7777777777778;2.22222222222222;391855.333333333;3624.91111111111;112.8
33323;2023;7;7;0;100;0;235850;2260.85714285714;104.142857142857
33324;2023;97;56;41;57.7319587628866;42.2680412371134;121732.865979381;1420.0206185567;84.0515463917526
33325;2023;13;13;0;100;0;236530.692307692;1961.61538461538;111.307692307692
33326;2023;1;1;0;100;0;295570;1206;245
33327;2023;21;21;0;100;0;225052.142857143;2442.80952380952;95.4285714285714
33328;2023;6;6;0;100;0;212750;2035.16666666667;102.5
33329;2023;5;5;0;100;0;247700;1921.6;125.4
33330;2023;35;27;8;77.1428571428572;22.8571428571429;403034.285714286;3537.17142857143;121.8
33331;2023;3;3;0;100;0;195500;1392.66666666667;169.666666666667
33332;2023;17;17;0;100;0;156050;1953.11764705882;85.9411764705882
33333;2023;28;28;0;100;0;383982.5;3997.85714285714;96.75
33334;2023;36;33;3;91.6666666666667;8.33333333333333;230635;2556.19444444444;94.2222222222222
33335;2023;5;5;0;100;0;347943;3300.2;105.6
33336;2023;13;13;0;100;0;195682.769230769;2000.53846153846;101.461538461538
33337;2023;25;25;0;100;0;204141.16;1900.6;110.88
33339;2023;13;13;0;100;0;255730.769230769;2755.84615384615;97.1538461538462
33341;2023;16;16;0;100;0;182337.625;2033.875;93.75
33342;2023;12;12;0;100;0;227612.333333333;2171.75;105.916666666667
33343;2023;16;16;0;100;0;207412.875;2053.25;100.25
33344;2023;5;5;0;100;0;188620.8;1556.6;125.8
33345;2023;6;6;0;100;0;368371.666666667;2525.16666666667;145.333333333333
33346;2023;5;5;0;100;0;211272.8;2098.8;102.6
33347;2023;3;3;0;100;0;166333.333333333;942.666666666667;181.333333333333
33348;2023;16;16;0;100;0;236479.6875;2115.375;113.3125
33349;2023;19;19;0;100;0;418542.631578947;3538.89473684211;118.210526315789
33350;2023;12;12;0;100;0;243897.5;2151;116.166666666667
33351;2023;19;19;0;100;0;134892.578947368;1446;98.7368421052632
33352;2023;53;50;3;94.3396226415094;5.66037735849057;141638.471698113;1497.09433962264;93.6981132075472
33353;2023;3;3;0;100;0;166000;1853;106.666666666667
33354;2023;4;4;0;100;0;312235.25;1362.5;236.25
33355;2023;17;17;0;100;0;152137.058823529;1837.88235294118;84.6470588235294
33356;2023;4;4;0;100;0;312050;2616.5;121.25
33357;2023;13;13;0;100;0;310606;2483.07692307692;125.461538461538
33358;2023;11;11;0;100;0;224375.454545455;1763.72727272727;127.545454545455
33359;2023;1;1;0;100;0;475000;3958;120
33360;2023;2;2;0;100;0;141505;1850;76.5
33361;2023;6;6;0;100;0;208596.666666667;1797.66666666667;147.166666666667
33362;2023;20;20;0;100;0;201265.65;1843.8;107.95
33363;2023;51;51;0;100;0;356753.843137255;3265.07843137255;110.921568627451
33364;2023;5;5;0;100;0;276800;2151.8;121.6
33365;2023;1;1;0;100;0;191820;1918;100
33366;2023;148;110;38;74.3243243243243;25.6756756756757;222134;2664.23648648649;86.0135135135135
33367;2023;5;5;0;100;0;237000;2206;106.8
33369;2023;8;8;0;100;0;241565.625;1629.875;131.375
33370;2023;3;3;0;100;0;106046.666666667;1005.66666666667;110
33372;2023;1;1;0;100;0;205500;2055;100
33373;2023;7;7;0;100;0;140528.571428571;1685.57142857143;78.7142857142857
33374;2023;3;3;0;100;0;181666.666666667;1389.66666666667;138.666666666667
33375;2023;4;4;0;100;0;439225;4187.25;101
33376;2023;50;47;3;94;6;504909.52;4215.76;119.82
33378;2023;24;24;0;100;0;175161.5;1733.79166666667;103.416666666667
33379;2023;2;2;0;100;0;170000;1501.5;112
33380;2023;12;12;0;100;0;152907.666666667;1569.5;103.083333333333
33381;2023;35;28;7;80;20;285506.885714286;2978.51428571429;96.2
33382;2023;24;24;0;100;0;175651.25;1737.91666666667;105.125
33383;2023;7;7;0;100;0;116264.285714286;1102.71428571429;116.571428571429
33384;2023;4;4;0;100;0;671750;2733.5;192.5
33385;2023;6;6;0;100;0;135966.666666667;1251.5;101.5
33387;2023;16;16;0;100;0;227026.875;1980.0625;112.625
33388;2023;5;5;0;100;0;190363.2;2461.8;81.2
33389;2023;34;34;0;100;0;122525.647058824;1398.76470588235;93.9705882352941
33390;2023;2;2;0;100;0;145510;1525.5;93
33391;2023;3;2;1;66.6666666666667;33.3333333333333;210953.333333333;1609;125.666666666667
33392;2023;8;8;0;100;0;214425.5;2047.875;104
33393;2023;61;54;7;88.5245901639344;11.4754098360656;222719.983606557;2094.18032786885;107.377049180328
33394;2023;18;17;1;94.4444444444444;5.55555555555556;525671.777777778;4583.44444444444;101.222222222222
33395;2023;19;18;1;94.7368421052632;5.26315789473684;166079.473684211;1712.31578947368;101.263157894737
33396;2023;2;1;1;50;50;139250;1864.5;80
33397;2023;38;36;2;94.7368421052632;5.26315789473684;327655.184210526;3221.5;100.815789473684
33398;2023;4;4;0;100;0;302194;1814.5;153.5
33399;2023;2;2;0;100;0;114500;2209;51.5
33400;2023;4;4;0;100;0;301931.25;2155;123.5
33402;2023;35;25;10;71.4285714285714;28.5714285714286;96054.9428571429;1174.4;81.8571428571429
33403;2023;1;1;0;100;0;260000;1884;138
33404;2023;2;2;0;100;0;171389;2362.5;72.5
33405;2023;5;5;0;100;0;167310;1749.6;94.2
33406;2023;2;2;0;100;0;240250;2086;120
33407;2023;7;7;0;100;0;324400;2595;107.428571428571
33408;2023;1;1;0;100;0;230000;2706;85
33411;2023;1;1;0;100;0;230905;2178;106
33412;2023;14;14;0;100;0;185755;1966.64285714286;97.5
33413;2023;17;17;0;100;0;322491.470588235;2634.64705882353;124
33414;2023;3;3;0;100;0;220566.666666667;1855;100.666666666667
33415;2023;30;22;8;73.3333333333333;26.6666666666667;211969.433333333;2521.73333333333;85.8
33416;2023;12;12;0;100;0;206272.916666667;1736.25;119
33417;2023;20;19;1;95;5;328917.8;3224.95;101.1
33418;2023;5;5;0;100;0;150809.2;1617.2;95.2
33421;2023;7;6;1;85.7142857142857;14.2857142857143;226584.285714286;1968.71428571429;125
33422;2023;65;46;19;70.7692307692308;29.2307692307692;380972.630769231;4047.6;95.9692307692308
33423;2023;7;7;0;100;0;149200;1575;91
33424;2023;54;46;8;85.1851851851852;14.8148148148148;224790.462962963;2347.38888888889;95.5555555555556
33425;2023;12;11;1;91.6666666666667;8.33333333333333;230776;2282.66666666667;100.666666666667
33426;2023;1;1;0;100;0;80000;1600;50
33427;2023;2;2;0;100;0;261500;1673.5;155
33428;2023;2;2;0;100;0;107250;704;155
33429;2023;4;4;0;100;0;254237.5;2516.5;103
33431;2023;1;1;0;100;0;286160;3367;85
33433;2023;65;55;10;84.6153846153846;15.3846153846154;287095.092307692;3102.87692307692;96.8307692307692
33434;2023;32;22;10;68.75;31.25;177782.84375;2514.46875;72.0625
33435;2023;39;24;15;61.5384615384615;38.4615384615385;177300.769230769;1977.97435897436;92.9487179487179
33436;2023;10;10;0;100;0;284345;3213.5;90.9
33437;2023;21;21;0;100;0;189675.238095238;1886;104.238095238095
33438;2023;27;27;0;100;0;231748.185185185;2301.03703703704;104.481481481481
33439;2023;7;6;1;85.7142857142857;14.2857142857143;172247.857142857;1525.85714285714;117.428571428571
33441;2023;25;14;11;56;44;120596;1661.48;77.2
33442;2023;6;6;0;100;0;337365;2391;122.833333333333
33443;2023;1;1;0;100;0;130000;663;196
33444;2023;4;4;0;100;0;157270;1154.75;132
33445;2023;9;9;0;100;0;198109.111111111;2257.55555555556;92.3333333333333
33447;2023;43;42;1;97.6744186046512;2.32558139534884;134230.465116279;1831.09302325581;85.8372093023256
33448;2023;27;27;0;100;0;349878.111111111;3489.88888888889;102
33449;2023;278;204;74;73.3812949640288;26.6187050359712;336860.097122302;3868.14028776978;88.1798561151079
33450;2023;7;7;0;100;0;178005.714285714;1684.71428571429;100.428571428571
33451;2023;6;5;1;83.3333333333333;16.6666666666667;360819.333333333;3724.66666666667;118.666666666667
33452;2023;8;8;0;100;0;205131;2367.75;88.25
33453;2023;2;2;0;100;0;269050;1570;174
33454;2023;10;10;0;100;0;310346;2868.8;114.3
33456;2023;4;4;0;100;0;173950;1223;127
33457;2023;8;8;0;100;0;260637.5;1989.375;129.625
33458;2023;10;10;0;100;0;241240;2304.5;105.7
33459;2023;3;3;0;100;0;137333.333333333;1931;104.666666666667
33460;2023;7;7;0;100;0;153380;1767;86.7142857142857
33461;2023;4;4;0;100;0;185101.25;1912.25;99
33462;2023;5;5;0;100;0;209256;2080;109.2
33463;2023;17;17;0;100;0;194277.058823529;2017.64705882353;98.1764705882353
33464;2023;2;2;0;100;0;209500;1784.5;126.5
33465;2023;8;8;0;100;0;242452.5;2109.5;117.5
33466;2023;52;12;40;23.0769230769231;76.9230769230769;130716.403846154;2436.61538461538;52.1538461538462
33467;2023;3;3;0;100;0;205316.666666667;1764.33333333333;112.333333333333
33468;2023;11;11;0;100;0;151709.090909091;1426.36363636364;91.9090909090909
33470;2023;10;10;0;100;0;317865;2470.4;133
33471;2023;8;8;0;100;0;185556.25;2421.5;83
33472;2023;1;1;0;100;0;187500;1752;107
33473;2023;32;32;0;100;0;193853.5625;1876.90625;101.875
33474;2023;29;29;0;100;0;384027.965517241;3274.86206896552;118.896551724138
33475;2023;6;6;0;100;0;221125;2104.66666666667;105.5
33476;2023;5;5;0;100;0;135000;1505.4;93.6
33477;2023;18;17;1;94.4444444444444;5.55555555555556;149619.722222222;1442.5;110.722222222222
33478;2023;61;42;19;68.8524590163934;31.1475409836066;152909.524590164;1750.4262295082;82.7540983606557
33479;2023;3;3;0;100;0;3,00E+05;2110;157
33480;2023;12;12;0;100;0;194500;1943.66666666667;99.1666666666667
33481;2023;2;2;0;100;0;291250;1692.5;171
33482;2023;3;3;0;100;0;155666.666666667;2460.66666666667;68
33483;2023;33;30;3;90.9090909090909;9.09090909090909;327582.878787879;3032.15151515152;109.909090909091
33484;2023;23;22;1;95.6521739130435;4.34782608695652;228455.304347826;2090.86956521739;122.869565217391
33485;2023;21;21;0;100;0;299787.285714286;2364.33333333333;128.142857142857
33486;2023;5;5;0;100;0;191800;2350.6;82.8
33487;2023;6;6;0;100;0;309592.5;3100.66666666667;101.833333333333
33488;2023;1;1;0;100;0;97000;874;111
33489;2023;1;1;0;100;0;357562;2980;120
33490;2023;29;25;4;86.2068965517241;13.7931034482759;200691.862068966;2326.1724137931;89.448275862069
33491;2023;4;4;0;100;0;286240.5;2336.75;127.25
33492;2023;35;24;11;68.5714285714286;31.4285714285714;147778.2;2032.88571428571;75.3714285714286
33493;2023;5;5;0;100;0;279008;1277;191.4
33494;2023;3;3;0;100;0;524966.666666667;4349;121.666666666667
33496;2023;28;27;1;96.4285714285714;3.57142857142857;321780.071428571;2883.82142857143;112.571428571429
33498;2023;71;64;7;90.1408450704225;9.85915492957746;377541;3702.97183098592;105.183098591549
33499;2023;5;5;0;100;0;173800;1721.8;109.2
33500;2023;7;7;0;100;0;174200;1660.28571428571;106.714285714286
33501;2023;33;31;2;93.9393939393939;6.06060606060606;346233.03030303;3702.33333333333;96
33502;2023;5;5;0;100;0;164814;1590.4;112.8
33503;2023;4;4;0;100;0;325977.5;3633;93.5
33504;2023;6;6;0;100;0;293523.333333333;2266.83333333333;133.833333333333
33505;2023;11;11;0;100;0;248133.272727273;2429.63636363636;103.818181818182
33506;2023;16;14;2;87.5;12.5;209218.125;2045.375;96.9375
33507;2023;5;5;0;100;0;261622;1977.4;121.4
33508;2023;5;5;0;100;0;225194;2087.8;105
33509;2023;4;4;0;100;0;236905;2000;123.25
33510;2023;2;2;0;100;0;213000;2320;90
33511;2023;4;4;0;100;0;129412.5;1465;89.75
33512;2023;6;6;0;100;0;198350;2487.66666666667;84.5
33514;2023;120;79;41;65.8333333333333;34.1666666666667;268345.358333333;4245.88333333333;67.7916666666667
33515;2023;3;3;0;100;0;185000;1914;101.333333333333
33516;2023;1;1;0;100;0;168400;1736;97
33517;2023;17;17;0;100;0;266870.705882353;2663.41176470588;103.647058823529
33518;2023;12;12;0;100;0;229525.666666667;2494.58333333333;102.916666666667
33519;2023;103;95;8;92.2330097087379;7.76699029126214;413640.291262136;3957.02912621359;105.679611650485
33520;2023;4;4;0;100;0;156947.5;1474.75;121.25
33521;2023;13;13;0;100;0;232777.461538462;2114.07692307692;102.692307692308
33522;2023;594;210;384;35.3535353535354;64.6464646464647;286958.496632997;4448.13131313131;65.5942760942761
33523;2023;27;24;3;88.8888888888889;11.1111111111111;246405.481481481;2540.22222222222;97.0740740740741
33524;2023;3;3;0;100;0;266166.666666667;2079.33333333333;127.666666666667
33525;2023;8;8;0;100;0;163343.75;2155.5;79.75
33527;2023;113;73;40;64.6017699115044;35.3982300884956;362680.008849558;4434.00884955752;80.9734513274336
33528;2023;2;2;0;100;0;307000;3973;81
33529;2023;429;283;146;65.967365967366;34.032634032634;545677.668997669;5904.64335664336;86.6969696969697
33530;2023;11;11;0;100;0;255880;2072;128.636363636364
33531;2023;2;2;0;100;0;258750;2613.5;99
33532;2023;11;11;0;100;0;233428.272727273;1849.09090909091;125.181818181818
33533;2023;34;31;3;91.1764705882353;8.82352941176471;218970.294117647;2334.85294117647;95
33534;2023;6;6;0;100;0;245316.666666667;2651;91
33535;2023;41;39;2;95.1219512195122;4.8780487804878;375638.682926829;3288.17073170732;115.731707317073
33536;2023;3;3;0;100;0;168900;2776.33333333333;81
33537;2023;5;5;0;100;0;190628;1915.2;112.6
33538;2023;9;9;0;100;0;117772.222222222;1276.33333333333;93.1111111111111
33539;2023;44;38;6;86.3636363636364;13.6363636363636;232547.772727273;2291.36363636364;106.477272727273
33540;2023;65;63;2;96.9230769230769;3.07692307692308;280897.861538462;3735.2;84.0923076923077
33541;2023;19;19;0;100;0;239698.526315789;2510.57894736842;91.4210526315789
33542;2023;10;10;0;100;0;178695;1814.8;100
33543;2023;10;9;1;90;10;192021.5;1841;114.6
33544;2023;56;21;35;37.5;62.5;148611.803571429;2604.25;60.4821428571429
33545;2023;21;21;0;100;0;205595.80952381;1978.28571428571;108.428571428571
33546;2023;3;3;0;100;0;158133.333333333;1367.66666666667;116
33547;2023;14;14;0;100;0;185207.142857143;2159.92857142857;89.7857142857143
33548;2023;14;14;0;100;0;200358.357142857;2029.57142857143;94.7857142857143
33549;2023;4;3;1;75;25;146750;1564;96
33550;2023;465;278;187;59.7849462365591;40.2150537634409;284123.965591398;3674.43870967742;78.6236559139785
33551;2023;2;2;0;100;0;147000;1546;87
33552;2023;11;11;0;100;0;244827.181818182;2336.36363636364;102.181818181818
33553;2023;10;10;0;100;0;216005;2244.2;98.6
33554;2023;27;26;1;96.2962962962963;3.7037037037037;295807.555555556;3253.96296296296;94.1851851851852
33555;2023;42;31;11;73.8095238095238;26.1904761904762;306498;3548.80952380952;86.9047619047619
34001;2023;24;22;2;91.6666666666667;8.33333333333333;252129.041666667;2495.58333333333;97.2083333333333
34002;2023;8;8;0;100;0;160613.75;2287;64.375
34003;2023;1994;383;1611;19.2076228686058;80.7923771313942;162554.668505517;4141.07121364092;42.1243731193581
34004;2023;6;6;0;100;0;98458.3333333333;1362.33333333333;66.6666666666667
34006;2023;3;3;0;100;0;87500;1811.33333333333;53
34007;2023;8;8;0;100;0;144528.75;1838.75;74.75
34008;2023;6;6;0;100;0;171500;1886.33333333333;90
34009;2023;27;25;2;92.5925925925926;7.40740740740741;211783.62962963;2560.25925925926;86.3333333333333
34010;2023;27;23;4;85.1851851851852;14.8148148148148;189877.222222222;2615.03703703704;73.4814814814815
34011;2023;3;3;0;100;0;152233.333333333;1757;88.3333333333333
34012;2023;3;3;0;100;0;390666.666666667;4653.66666666667;84.6666666666667
34013;2023;26;23;3;88.4615384615385;11.5384615384615;205435;2317.88461538462;81.1923076923077
34014;2023;13;13;0;100;0;611646.153846154;4459.92307692308;131.307692307692
34015;2023;7;7;0;100;0;179214.285714286;2205.28571428571;78
34016;2023;3;3;0;100;0;307933.333333333;2526.33333333333;136
34017;2023;7;7;0;100;0;203839.285714286;2461.28571428571;79.7142857142857
34018;2023;20;19;1;95;5;188309.5;2429.8;75.6
34019;2023;8;8;0;100;0;132000;1350.625;101.25
34020;2023;4;4;0;100;0;197875;2006.75;93.5
34021;2023;7;7;0;100;0;201571.428571429;1715.14285714286;111.571428571429
34022;2023;82;51;31;62.1951219512195;37.8048780487805;365203.707317073;4021.0243902439;89.1585365853659
34023;2023;271;54;217;19.9261992619926;80.0738007380074;183431.339483395;4275.42435424354;44.9261992619926
34024;2023;23;13;10;56.5217391304348;43.4782608695652;320198.608695652;3898.08695652174;81.3913043478261
34025;2023;41;39;2;95.1219512195122;4.8780487804878;214777.731707317;2443.43902439024;87.1219512195122
34026;2023;3;3;0;100;0;76873.3333333333;1273.66666666667;59.6666666666667
34027;2023;18;16;2;88.8888888888889;11.1111111111111;474900.555555556;4000.05555555556;120.444444444444
34028;2023;127;76;51;59.8425196850394;40.1574803149606;119758.291338583;1524.03149606299;78.8188976377953
34029;2023;11;11;0;100;0;200581.727272727;2453.90909090909;77.1818181818182
34030;2023;1;1;0;100;0;221250;2837;78
34031;2023;71;64;7;90.1408450704225;9.85915492957746;182394.084507042;2335.74647887324;79.0704225352113
34032;2023;1300;468;832;36;64;147749.365384615;1992.41692307692;73.4953846153846
34033;2023;27;23;4;85.1851851851852;14.8148148148148;312075;2981.07407407407;102.333333333333
34034;2023;2;2;0;100;0;127805;1420;84
34035;2023;7;7;0;100;0;423614.285714286;2919.28571428571;139.142857142857
34036;2023;19;18;1;94.7368421052632;5.26315789473684;268451.631578947;2741.84210526316;106.736842105263
34037;2023;43;34;9;79.0697674418605;20.9302325581395;171226.279069767;2157.41860465116;80.4883720930233
34038;2023;28;22;6;78.5714285714286;21.4285714285714;148164.214285714;1570.21428571429;95.6428571428571
34039;2023;23;12;11;52.1739130434783;47.8260869565217;274188.47826087;4259.17391304348;63.4782608695652
34040;2023;1;1;0;100;0;80000;2500;32
34041;2023;13;12;1;92.3076923076923;7.69230769230769;239118.384615385;2670.84615384615;89.2307692307692
34042;2023;3;2;1;66.6666666666667;33.3333333333333;291083.333333333;3027.66666666667;90.6666666666667
34043;2023;1;1;0;100;0;425749;3735;114
34044;2023;5;4;1;80;20;216600;1412.4;112.2
34045;2023;8;8;0;100;0;138976.25;1555.5;91.125
34046;2023;4;4;0;100;0;383087.5;3608.75;109.75
34047;2023;5;5;0;100;0;210047.2;2421.6;92.2
34049;2023;6;6;0;100;0;99833.3333333333;1268.83333333333;70.8333333333333
34050;2023;24;15;9;62.5;37.5;304625.541666667;3761.125;79.5416666666667
34051;2023;32;31;1;96.875;3.125;259543.625;2733.5;98.84375
34052;2023;73;67;6;91.7808219178082;8.21917808219178;196624.780821918;2044.01369863014;96.3561643835616
34054;2023;2;2;0;100;0;23000;502;46
34055;2023;2;2;0;100;0;287895;1596.5;175
34056;2023;16;15;1;93.75;6.25;183749.5625;2107.6875;83.125
34057;2023;440;135;305;30.6818181818182;69.3181818181818;330530.665909091;4291.18181818182;73.3772727272727
34058;2023;67;53;14;79.1044776119403;20.8955223880597;434464.104477612;4519.31343283582;94.134328358209
34059;2023;4;4;0;100;0;106500;1195.25;92.75
34060;2023;6;6;0;100;0;264508.333333333;2600.83333333333;99.5
34061;2023;14;14;0;100;0;159413.5;1775.14285714286;95.3571428571429
34062;2023;5;5;0;100;0;162516.4;1816.6;84.4
34063;2023;49;48;1;97.9591836734694;2.04081632653061;224390.428571429;2138.81632653061;102.30612244898
34064;2023;8;7;1;87.5;12.5;91236.875;1138.375;82.875
34065;2023;12;12;0;100;0;184138.333333333;1912;92.4166666666667
34066;2023;1;1;0;100;0;1650890;6766;244
34067;2023;13;11;2;84.6153846153846;15.3846153846154;263906.384615385;3381.92307692308;83.4615384615385
34068;2023;14;14;0;100;0;216490;2006.85714285714;106.642857142857
34069;2023;73;68;5;93.1506849315068;6.84931506849315;179340.136986301;1959.52054794521;90.2876712328767
34070;2023;13;12;1;92.3076923076923;7.69230769230769;183977.769230769;1993.84615384615;101.615384615385
34071;2023;4;4;0;100;0;114937.5;1300.25;94
34073;2023;22;20;2;90.9090909090909;9.09090909090909;225407.272727273;2324.40909090909;97.2272727272727
34074;2023;41;40;1;97.5609756097561;2.4390243902439;206635.024390244;1932.36585365854;108.975609756098
34075;2023;11;11;0;100;0;156742.454545455;1608.54545454545;90.4545454545455
34076;2023;17;17;0;100;0;277161.176470588;2943.05882352941;96.0588235294118
34077;2023;42;29;13;69.0476190476191;30.952380952381;400752.333333333;4134.47619047619;95.7619047619048
34078;2023;13;13;0;100;0;478769.230769231;3627.76923076923;119.692307692308
34079;2023;130;71;59;54.6153846153846;45.3846153846154;227771.284615385;2587.46923076923;85.5307692307692
34080;2023;11;11;0;100;0;151334.545454545;1745.09090909091;86.2727272727273
34081;2023;34;29;5;85.2941176470588;14.7058823529412;277122.529411765;2749.14705882353;100.058823529412
34082;2023;9;9;0;100;0;467073.888888889;4348.11111111111;111.333333333333
34084;2023;24;23;1;95.8333333333333;4.16666666666667;240985.75;2268.25;103.916666666667
34085;2023;12;12;0;100;0;317345.666666667;2961.16666666667;110.333333333333
34086;2023;11;11;0;100;0;101410.818181818;1181.81818181818;80.9090909090909
34087;2023;19;15;4;78.9473684210526;21.0526315789474;331703.684210526;3673.47368421053;87
34088;2023;71;64;7;90.1408450704225;9.85915492957746;326020.929577465;3447.18309859155;95.9014084507042
34089;2023;18;17;1;94.4444444444444;5.55555555555556;175946.111111111;1951.44444444444;86.6111111111111
34090;2023;116;77;39;66.3793103448276;33.6206896551724;361671.482758621;4187.96551724138;87.6034482758621
34092;2023;16;16;0;100;0;152168.625;1461.375;88.4375
34093;2023;2;2;0;100;0;84000;1142.5;73
34094;2023;16;16;0;100;0;317259;3253.375;92.375
34095;2023;81;57;24;70.3703703703704;29.6296296296296;284352.604938272;3538.02469135802;80.8148148148148
34096;2023;14;14;0;100;0;300258.571428571;2665.71428571429;105.928571428571
34097;2023;10;10;0;100;0;198879.9;1854.7;105
34098;2023;4;4;0;100;0;146778.75;1618.5;86.75
34101;2023;84;79;5;94.0476190476191;5.95238095238095;204721.369047619;2619.88095238095;77.6071428571429
34102;2023;4;3;1;75;25;463145;4517.75;141
34103;2023;8;8;0;100;0;233406.5;2596.25;100
34104;2023;1;1;0;100;0;219000;3221;68
34105;2023;5;5;0;100;0;170000;1892.6;81.8
34106;2023;1;1;0;100;0;28000;848;33
34107;2023;9;8;1;88.8888888888889;11.1111111111111;115622.222222222;1607.66666666667;74.4444444444444
34108;2023;412;182;230;44.1747572815534;55.8252427184466;231977.856796117;3810.33980582524;63.4660194174757
34109;2023;21;21;0;100;0;146095.80952381;1771.04761904762;83.1428571428571
34110;2023;4;4;0;100;0;358773;3192;106.25
34111;2023;56;24;32;42.8571428571429;57.1428571428571;147755.089285714;1873.125;79.25
34113;2023;86;55;31;63.953488372093;36.046511627907;254061.465116279;3244.53488372093;76.3604651162791
34114;2023;62;55;7;88.7096774193548;11.2903225806452;246222.306451613;3008.37096774194;82.7903225806452
34115;2023;5;5;0;100;0;104675.2;1191.8;83.2
34116;2023;125;47;78;37.6;62.4;247105.928;3389.632;70.128
34117;2023;20;15;5;75;25;89911;1016.65;81.45
34119;2023;30;27;3;90;10;145825.5;1856.76666666667;79.4
34120;2023;66;34;32;51.5151515151515;48.4848484848485;332200.954545455;4111.63636363636;81.3181818181818
34121;2023;3;3;0;100;0;160500;2278;72.3333333333333
34122;2023;4;4;0;100;0;249245;2716.5;89.5
34123;2023;184;113;71;61.4130434782609;38.5869565217391;305013.429347826;3563.38043478261;84.1684782608696
34124;2023;1;1;0;100;0;250000;3333;75
34126;2023;69;27;42;39.1304347826087;60.8695652173913;116523.333333333;2197.02898550725;54.1739130434783
34127;2023;34;32;2;94.1176470588235;5.88235294117647;313997.058823529;3596.64705882353;93.1470588235294
34128;2023;23;21;2;91.304347826087;8.69565217391304;210940.652173913;2174.39130434783;94.4347826086957
34129;2023;205;90;115;43.9024390243902;56.0975609756098;385377.063414634;4818.80487804878;80.8439024390244
34130;2023;35;35;0;100;0;251148.885714286;2554.6;98.3714285714286
34131;2023;9;9;0;100;0;378971.666666667;3776.88888888889;102.666666666667
34132;2023;3;3;0;100;0;195870;2269.66666666667;81.6666666666667
34133;2023;1;0;1;0;100;95000;1792;53
34134;2023;27;22;5;81.4814814814815;18.5185185185185;335311;3622.55555555556;91.7407407407407
34135;2023;49;46;3;93.8775510204082;6.12244897959184;184355.714285714;1959.59183673469;94.469387755102
34136;2023;16;16;0;100;0;221230.25;2508.8125;102.0625
34137;2023;1;1;0;100;0;742000;7000;106
34138;2023;4;4;0;100;0;142981;2190.75;70.5
34139;2023;14;14;0;100;0;289226.785714286;2436.14285714286;119.214285714286
34140;2023;34;32;2;94.1176470588235;5.88235294117647;251808.029411765;2678.73529411765;102.676470588235
34141;2023;9;8;1;88.8888888888889;11.1111111111111;165667.888888889;1671.33333333333;95.8888888888889
34142;2023;118;60;58;50.8474576271186;49.1525423728814;141291.720338983;1722.72881355932;78.9576271186441
34143;2023;34;30;4;88.2352941176471;11.7647058823529;268667.411764706;3790.44117647059;76.2058823529412
34144;2023;11;10;1;90.9090909090909;9.09090909090909;123321.727272727;1466.36363636364;85
34145;2023;388;196;192;50.5154639175258;49.4845360824742;210039.863402062;2779.69329896907;75.6546391752577
34146;2023;35;31;4;88.5714285714286;11.4285714285714;283583.228571429;3256.17142857143;89.9142857142857
34147;2023;56;54;2;96.4285714285714;3.57142857142857;222866.553571429;2366.33928571429;90.8035714285714
34148;2023;60;54;6;90;10;216081.866666667;2219.95;95.75
34149;2023;11;11;0;100;0;192650.909090909;1915;97.2727272727273
34150;2023;308;153;155;49.6753246753247;50.3246753246753;210779.691558442;4029.16233766234;55.5616883116883
34151;2023;86;63;23;73.2558139534884;26.7441860465116;243043.430232558;3009.6976744186;82.1162790697674
34152;2023;3;3;0;100;0;245666.666666667;2289.66666666667;120.333333333333
34153;2023;12;11;1;91.6666666666667;8.33333333333333;420964.166666667;4237.83333333333;101.25
34154;2023;359;131;228;36.4902506963788;63.5097493036212;303379.080779944;4993.39832869081;61.3175487465181
34155;2023;32;32;0;100;0;241608.65625;2471.09375;96.4375
34157;2023;191;107;84;56.020942408377;43.979057591623;278516.706806283;3673.94240837696;75.7748691099476
34159;2023;33;28;5;84.8484848484848;15.1515151515152;321108.666666667;4027.66666666667;83.3333333333333
34160;2023;4;4;0;100;0;226500;2389.5;89.75
34161;2023;52;51;1;98.0769230769231;1.92307692307692;240298.019230769;2463.11538461538;97.75
34162;2023;73;58;15;79.4520547945205;20.5479452054795;177243.01369863;2285.09589041096;78.5068493150685
34163;2023;39;38;1;97.4358974358974;2.56410256410256;334851.58974359;3335.89743589744;101.487179487179
34164;2023;3;3;0;100;0;384333.333333333;3508.66666666667;107.333333333333
34165;2023;30;22;8;73.3333333333333;26.6666666666667;245021;2983.96666666667;79.2333333333333
34166;2023;54;49;5;90.7407407407407;9.25925925925926;223419.185185185;2361.16666666667;91.9444444444444
34167;2023;6;6;0;100;0;387871.666666667;2546.5;124.833333333333
34168;2023;2;2;0;100;0;82875;1471;57.5
34169;2023;42;30;12;71.4285714285714;28.5714285714286;685063.761904762;5589.38095238095;125.333333333333
34170;2023;10;9;1;90;10;167554;1672.9;94.2
34172;2023;4604;460;4144;9.99131190269331;90.0086880973067;207953.235664639;3568.90486533449;59.1822328410078
34173;2023;15;15;0;100;0;256137.266666667;3612.33333333333;83
34174;2023;7;7;0;100;0;248411.428571429;2616.57142857143;96.2857142857143
34175;2023;2;2;0;100;0;158250;1872.5;90
34176;2023;27;26;1;96.2962962962963;3.7037037037037;399818.888888889;4082;96.8148148148148
34177;2023;1;0;1;0;100;80000;1290;62
34178;2023;51;47;4;92.156862745098;7.84313725490196;151813.333333333;1856.19607843137;83.8823529411765
34179;2023;18;15;3;83.3333333333333;16.6666666666667;389634.166666667;3806.66666666667;101.888888888889
34180;2023;20;18;2;90;10;151124.5;1944.9;76.9
34181;2023;25;25;0;100;0;195455;2356.8;85.36
34182;2023;27;26;1;96.2962962962963;3.7037037037037;260621.111111111;2615.14814814815;102.111111111111
34183;2023;65;58;7;89.2307692307692;10.7692307692308;174565.292307692;1962.55384615385;86.1846153846154
34184;2023;11;11;0;100;0;115426.727272727;1697.36363636364;67.2727272727273
34185;2023;5;5;0;100;0;372767;3248.8;115.8
34186;2023;5;5;0;100;0;88950;1244.2;78.6
34187;2023;8;7;1;87.5;12.5;84598.75;977.5;104.125
34188;2023;2;2;0;100;0;190850;2111;88.5
34189;2023;34;31;3;91.1764705882353;8.82352941176471;131261.617647059;1767.20588235294;77.0882352941177
34190;2023;3;3;0;100;0;82516.6666666667;893;114
34191;2023;4;4;0;100;0;77846.25;2022.5;47.75
34192;2023;213;17;196;7.981220657277;92.018779342723;249876.394366197;5562.86384976526;46.8215962441315
34193;2023;6;6;0;100;0;172330;1845.33333333333;80.6666666666667
34194;2023;64;58;6;90.625;9.375;208282.34375;2394.21875;87.4375
34195;2023;2;2;0;100;0;202257;2198.5;92.5
34196;2023;3;2;1;66.6666666666667;33.3333333333333;70000;1099.66666666667;66
34197;2023;13;13;0;100;0;166768.461538462;2076.38461538462;75
34198;2023;114;87;27;76.3157894736842;23.6842105263158;421520.201754386;4754.42105263158;91.1929824561404
34199;2023;128;66;62;51.5625;48.4375;214998.3125;2451.28125;87.921875
34200;2023;4;4;0;100;0;301200;1826.75;146.75
34201;2023;4;4;0;100;0;166292.5;1499;112.75
34202;2023;81;59;22;72.8395061728395;27.1604938271605;316768.024691358;3631.95061728395;86.9382716049383
34203;2023;17;16;1;94.1176470588235;5.88235294117647;262386.588235294;2908.58823529412;92.7058823529412
34204;2023;23;21;2;91.304347826087;8.69565217391304;251751.173913043;2842.17391304348;87.4782608695652
34206;2023;8;7;1;87.5;12.5;230909.75;2474;98.125
34207;2023;52;51;1;98.0769230769231;1.92307692307692;242708.019230769;2754.53846153846;86.9615384615385
34208;2023;3;3;0;100;0;240850;2226.66666666667;103
34209;2023;130;115;15;88.4615384615385;11.5384615384615;199954.446153846;3594.99230769231;60.3230769230769
34210;2023;30;28;2;93.3333333333333;6.66666666666667;255215.7;2764.06666666667;87.5333333333333
34211;2023;13;13;0;100;0;125091.769230769;1451.69230769231;83.8461538461538
34212;2023;2;2;0;100;0;294000;2592.5;115
34213;2023;71;49;22;69.0140845070423;30.9859154929577;275486.943661972;3286.28169014085;86.4084507042254
34214;2023;18;16;2;88.8888888888889;11.1111111111111;201358.611111111;2053.5;96.2777777777778
34215;2023;9;8;1;88.8888888888889;11.1111111111111;175694.444444444;2039.22222222222;94.1111111111111
34216;2023;5;5;0;100;0;221000;2218.4;100.2
34217;2023;62;41;21;66.1290322580645;33.8709677419355;363349.35483871;4173.41935483871;85.1935483870968
34218;2023;5;5;0;100;0;335327;2227.2;146.2
34219;2023;12;12;0;100;0;111279.583333333;1457.66666666667;76.5833333333333
34220;2023;1;1;0;100;0;356800;3273;109
34221;2023;7;7;0;100;0;174015.714285714;2340;88.2857142857143
34222;2023;5;5;0;100;0;466750;4078;113.6
34223;2023;19;19;0;100;0;206925;2067.42105263158;95.1578947368421
34224;2023;25;22;3;88;12;284659;2758.36;104
34225;2023;57;55;2;96.4912280701754;3.50877192982456;191623.105263158;1926.68421052632;99.7017543859649
34226;2023;34;34;0;100;0;168947.058823529;1692.08823529412;97.4705882352941
34227;2023;30;25;5;83.3333333333333;16.6666666666667;396901.9;3841.86666666667;102.7
34228;2023;1;1;0;100;0;135000;1421;95
34229;2023;15;14;1;93.3333333333333;6.66666666666667;194049.666666667;1991.66666666667;107.733333333333
34230;2023;5;5;0;100;0;112908.2;1568.6;74
34232;2023;17;15;2;88.2352941176471;11.7647058823529;155441.176470588;2076.35294117647;78.6470588235294
34233;2023;3;3;0;100;0;95550;1162;78.6666666666667
34234;2023;6;6;0;100;0;230984.5;2384.83333333333;97
34235;2023;11;11;0;100;0;147640.818181818;1747.09090909091;83
34236;2023;2;1;1;50;50;1237710;5378.5;185
34237;2023;52;49;3;94.2307692307692;5.76923076923077;188250.173076923;2044.63461538462;91.2884615384615
34239;2023;76;60;16;78.9473684210526;21.0526315789474;231500.434210526;2772.28947368421;85.5526315789474
34240;2023;43;29;14;67.4418604651163;32.5581395348837;403227.76744186;4536.06976744186;88.8372093023256
34241;2023;10;10;0;100;0;268174.6;2737.9;96.3
34242;2023;4;4;0;100;0;335192.5;3204.75;121.25
34243;2023;17;16;1;94.1176470588235;5.88235294117647;197771.411764706;2389.41176470588;83
34244;2023;43;24;19;55.8139534883721;44.1860465116279;316048.953488372;3903.11627906977;80.1395348837209
34245;2023;28;27;1;96.4285714285714;3.57142857142857;135976.25;1609.07142857143;81.5357142857143
34246;2023;23;20;3;86.9565217391304;13.0434782608696;265302.565217391;3241.39130434783;83.2173913043478
34247;2023;44;40;4;90.9090909090909;9.09090909090909;612631.045454545;4471.45454545455;138.636363636364
34248;2023;5;5;0;100;0;426390;2600.2;170.6
34249;2023;23;21;2;91.304347826087;8.69565217391304;434769.782608696;3917.34782608696;111.652173913043
34250;2023;6;6;0;100;0;115941.666666667;1442.66666666667;83.5
34251;2023;5;4;1;80;20;128972.6;1675.8;72.6
34252;2023;4;3;1;75;25;90000;1043.25;74.25
34254;2023;12;11;1;91.6666666666667;8.33333333333333;287878.916666667;3090.33333333333;96.25
34255;2023;113;89;24;78.7610619469027;21.2389380530973;495590.017699115;4345.90265486726;109.035398230088
34256;2023;25;23;2;92;8;354075.44;3662;100.2
34257;2023;4;3;1;75;25;202000;2058.5;97.25
34258;2023;29;29;0;100;0;210079.206896552;2104.27586206897;101.965517241379
34259;2023;54;29;25;53.7037037037037;46.2962962962963;267363.981481481;3021.81481481481;77.0925925925926
34260;2023;11;11;0;100;0;55931.8181818182;821;78
34261;2023;3;2;1;66.6666666666667;33.3333333333333;276725;2958.33333333333;111.666666666667
34262;2023;4;4;0;100;0;256900;1427.75;158
34263;2023;5;4;1;80;20;515148;3239.8;157.6
34265;2023;6;6;0;100;0;604915;4056.83333333333;160.666666666667
34266;2023;6;6;0;100;0;659151.333333333;4653.83333333333;138.833333333333
34267;2023;18;16;2;88.8888888888889;11.1111111111111;256811.666666667;2608.27777777778;97.2222222222222
34268;2023;9;9;0;100;0;251877.777777778;2327;106.333333333333
34269;2023;3;3;0;100;0;174010;1298;122.333333333333
34270;2023;126;83;43;65.8730158730159;34.1269841269841;425847.333333333;4190.81746031746;101.587301587302
34271;2023;4;4;0;100;0;103875;1639.25;67.75
34272;2023;24;24;0;100;0;355598;3906.95833333333;90.8333333333333
34273;2023;1;1;0;100;0;360000;3956;91
34274;2023;15;15;0;100;0;299823.866666667;2984;95.6666666666667
34276;2023;40;37;3;92.5;7.5;406168.925;4072.875;98.75
34277;2023;4;4;0;100;0;124230;2222;58.75
34278;2023;2;2;0;100;0;247327;2315.5;106.5
34279;2023;9;9;0;100;0;133502.777777778;1580.22222222222;86.8888888888889
34280;2023;2;2;0;100;0;285322;3102;93.5
34281;2023;48;47;1;97.9166666666667;2.08333333333333;214470.416666667;2289.54166666667;92
34282;2023;9;7;2;77.7777777777778;22.2222222222222;377004.444444444;3288.77777777778;104.222222222222
34283;2023;2;2;0;100;0;126450;1117.5;105.5
34284;2023;22;19;3;86.3636363636364;13.6363636363636;81281;1318.90909090909;65.8636363636364
34285;2023;8;8;0;100;0;253012.5;2809.375;81.5
34286;2023;1;0;1;0;100;151100;1558;97
34287;2023;4;4;0;100;0;116950;2347.75;49.75
34288;2023;10;10;0;100;0;368955;2918.2;131.6
34289;2023;45;45;0;100;0;224865.666666667;2466.44444444444;91.8666666666667
34290;2023;4;4;0;100;0;545675;4529.25;120.5
34291;2023;12;12;0;100;0;103925;2103.08333333333;57.75
34292;2023;9;9;0;100;0;271922.777777778;2477.22222222222;116.666666666667
34293;2023;36;36;0;100;0;134485.277777778;1773.69444444444;76.0277777777778
34294;2023;7;7;0;100;0;332171.857142857;3054.85714285714;110.142857142857
34295;2023;41;37;4;90.2439024390244;9.75609756097561;338060.609756098;3499.34146341463;95.4634146341463
34296;2023;9;9;0;100;0;361355.555555556;3266.44444444444;116.333333333333
34297;2023;3;2;1;66.6666666666667;33.3333333333333;331700;3023.66666666667;107
34298;2023;63;61;2;96.8253968253968;3.17460317460317;277021.380952381;2790.93650793651;97.6507936507936
34299;2023;144;104;40;72.2222222222222;27.7777777777778;259150.388888889;3295.53472222222;79.3541666666667
34300;2023;92;88;4;95.6521739130435;4.34782608695652;234181.043478261;2411.60869565217;94.7934782608696
34301;2023;1099;138;961;12.5568698817106;87.4431301182894;238534.440400364;3893.56414922657;60.0136487716106
34302;2023;14;14;0;100;0;146121.428571429;1689.35714285714;91.1428571428571
34304;2023;11;11;0;100;0;210783.090909091;2211.09090909091;96.9090909090909
34305;2023;6;6;0;100;0;85416.6666666667;1351.5;61.6666666666667
34306;2023;3;3;0;100;0;173333.333333333;2268;71
34307;2023;23;21;2;91.304347826087;8.69565217391304;474870.434782609;4129.91304347826;113.739130434783
34308;2023;12;11;1;91.6666666666667;8.33333333333333;193563.333333333;2214.83333333333;87.8333333333333
34309;2023;43;39;4;90.6976744186046;9.30232558139535;460058.302325581;4241.23255813954;108.790697674419
34310;2023;45;42;3;93.3333333333333;6.66666666666667;245238.844444444;2630.37777777778;94.3111111111111
34311;2023;20;19;1;95;5;286836;2682.9;98.1
34312;2023;21;20;1;95.2380952380952;4.76190476190476;206048.333333333;1878.52380952381;110.809523809524
34313;2023;3;3;0;100;0;156666.666666667;1574;86.3333333333333
34314;2023;4;3;1;75;25;416397.5;4504.5;89.75
34315;2023;2;2;0;100;0;224800;3278.5;73.5
34316;2023;2;2;0;100;0;141000;1290.5;93.5
34317;2023;2;2;0;100;0;219375;1627;129
34318;2023;4;4;0;100;0;513072.5;3916.25;129
34319;2023;2;2;0;100;0;148000;2417.5;77.5
34320;2023;12;12;0;100;0;400577.5;3503.83333333333;114.166666666667
34321;2023;24;23;1;95.8333333333333;4.16666666666667;352028.291666667;3767.41666666667;92.25
34322;2023;1;1;0;100;0;369700;1232;300
34324;2023;316;99;217;31.3291139240506;68.6708860759494;168191.639240506;3686.60759493671;47.3101265822785
34325;2023;23;21;2;91.304347826087;8.69565217391304;245020.043478261;2497.52173913043;95.5652173913043
34326;2023;1;1;0;100;0;85000;752;113
34327;2023;64;43;21;67.1875;32.8125;327007.796875;3907.171875;86.5625
34328;2023;10;8;2;80;20;183187;2301;76.7
34329;2023;68;58;10;85.2941176470588;14.7058823529412;197301.661764706;3689.04411764706;58.9852941176471
34331;2023;4;4;0;100;0;95340;1098;95.25
34332;2023;145;116;29;80;20;188251.2;3220.00689655172;62.3586206896552
34333;2023;66;65;1;98.4848484848485;1.51515151515152;226554.151515152;6046.51515151515;46.4242424242424
34334;2023;6;6;0;100;0;121450;1560.66666666667;75
34335;2023;7;7;0;100;0;174414.285714286;1994.14285714286;96.8571428571429
34336;2023;84;63;21;75;25;178952.119047619;2313.80952380952;78.2142857142857
34337;2023;96;77;19;80.2083333333333;19.7916666666667;338436.770833333;3826.09375;87.1354166666667
34338;2023;1;0;1;0;100;220000;2750;80
34339;2023;3;3;0;100;0;208366.666666667;1930.33333333333;103.333333333333
34340;2023;15;14;1;93.3333333333333;6.66666666666667;417610.2;3829.2;107.266666666667
34341;2023;33;29;4;87.8787878787879;12.1212121212121;253509.03030303;2798.72727272727;90.2424242424242
34342;2023;3;3;0;100;0;435900;3783.66666666667;116.666666666667
34343;2023;12;9;3;75;25;362133.333333333;3435.75;100.75
34344;2023;750;51;699;6.8;93.2;205505.022666667;5565.48933333333;37.0093333333333
35001;2023;54;38;16;70.3703703703704;29.6296296296296;295758.166666667;3095.27777777778;97.5555555555556
35002;2023;14;14;0;100;0;253251.142857143;2211.5;119.785714285714
35003;2023;13;13;0;100;0;219215.384615385;2458;92.1538461538462
35004;2023;57;52;5;91.2280701754386;8.7719298245614;113932.192982456;1243.0701754386;88.280701754386
35005;2023;4;4;0;100;0;106317.25;1205.75;86.25
35006;2023;39;28;11;71.7948717948718;28.2051282051282;188388.512820513;2092.4358974359;95.1025641025641
35007;2023;2;2;0;100;0;253550;2121;119.5
35008;2023;5;5;0;100;0;276900;1776.8;166.4
35009;2023;16;14;2;87.5;12.5;172103.75;2037.5625;87.875
35010;2023;16;16;0;100;0;221957.8125;2090.8125;108.75
35012;2023;107;82;25;76.6355140186916;23.3644859813084;222388.271028037;2318.68224299065;93.7289719626168
35013;2023;45;45;0;100;0;208750.333333333;2152.24444444444;95.4666666666667
35014;2023;34;34;0;100;0;212793.823529412;2056.67647058824;106.441176470588
35015;2023;19;19;0;100;0;203445.421052632;2040.26315789474;102.315789473684
35016;2023;42;41;1;97.6190476190476;2.38095238095238;222413.380952381;2303.97619047619;99.1190476190476
35017;2023;10;10;0;100;0;207430;2244.8;91.9
35018;2023;16;16;0;100;0;99675;1331;83.25
35019;2023;23;23;0;100;0;144639.173913043;1719.82608695652;91.304347826087
35021;2023;8;8;0;100;0;175812.5;1820.75;97.25
35022;2023;8;8;0;100;0;159906.25;1827.25;88.25
35023;2023;41;35;6;85.3658536585366;14.6341463414634;267426.853658537;2490.70731707317;106.560975609756
35024;2023;137;87;50;63.5036496350365;36.4963503649635;324213.138686131;3387.62773722628;95.1897810218978
35025;2023;9;9;0;100;0;159700;1620.55555555556;94.7777777777778
35026;2023;1;1;0;100;0;260500;1515;172
35027;2023;23;23;0;100;0;175925.739130435;1865.17391304348;96.7826086956522
35028;2023;13;13;0;100;0;145407.692307692;1740.84615384615;83.6153846153846
35029;2023;31;31;0;100;0;188862.258064516;1933.77419354839;104.612903225806
35030;2023;9;9;0;100;0;232388.888888889;2025.33333333333;116.777777777778
35031;2023;49;46;3;93.8775510204082;6.12244897959184;231761.795918367;2354.87755102041;101.387755102041
35032;2023;39;30;9;76.9230769230769;23.0769230769231;262718.076923077;2702.33333333333;98.3589743589744
35033;2023;30;25;5;83.3333333333333;16.6666666666667;232980;2253.9;103.2
35034;2023;21;21;0;100;0;155855.238095238;1584.66666666667;99.2857142857143
35035;2023;7;7;0;100;0;206593;1997.85714285714;109.428571428571
35037;2023;58;43;15;74.1379310344828;25.8620689655172;241752.896551724;2931.77586206897;88.2068965517241
35038;2023;5;5;0;100;0;178140;1513.8;126.2
35039;2023;12;11;1;91.6666666666667;8.33333333333333;298250.916666667;2981.58333333333;100.333333333333
35040;2023;26;23;3;88.4615384615385;11.5384615384615;258309.269230769;2555.15384615385;108.692307692308
35041;2023;8;8;0;100;0;234868.75;2320.5;100.875
35042;2023;8;8;0;100;0;151400;1614.375;93
35044;2023;4;4;0;100;0;164875;2012;94.5
35045;2023;10;10;0;100;0;118757;1723.6;73.6
35046;2023;5;5;0;100;0;131718;1559.8;90.2
35047;2023;221;109;112;49.3212669683258;50.6787330316742;269338.886877828;3276.34841628959;84.3348416289593
35049;2023;100;59;41;59;41;347936.7;4295.98;89.3
35050;2023;8;8;0;100;0;303327;2145.625;140.25
35051;2023;194;99;95;51.0309278350515;48.9690721649485;372338.340206186;4096.52577319588;91.8505154639175
35052;2023;4;4;0;100;0;230712.5;2127;118.25
35054;2023;18;18;0;100;0;225308.333333333;2394.22222222222;94.3888888888889
35055;2023;147;47;100;31.9727891156463;68.0272108843537;259897.619047619;3256.20408163265;80.9931972789116
35056;2023;9;9;0;100;0;224750.111111111;1894.22222222222;121.888888888889
35057;2023;18;13;5;72.2222222222222;27.7777777777778;117406.277777778;1649.61111111111;75.1666666666667
35058;2023;9;9;0;100;0;272010.333333333;2697.66666666667;113.888888888889
35059;2023;62;49;13;79.0322580645161;20.9677419354839;297054.85483871;3102.98387096774;97.9193548387097
35060;2023;9;9;0;100;0;192650.111111111;2993.33333333333;89.4444444444444
35061;2023;8;8;0;100;0;140506.25;1676.875;83.125
35062;2023;15;15;0;100;0;136373.333333333;1359.8;102.133333333333
35063;2023;4;4;0;100;0;193975;1802;124.75
35064;2023;35;35;0;100;0;108020.028571429;1434.11428571429;76.5714285714286
35065;2023;31;21;10;67.741935483871;32.258064516129;218711.225806452;2497.29032258065;88.6129032258064
35066;2023;109;60;49;55.045871559633;44.954128440367;248095.779816514;3130.81651376147;80.0275229357798
35067;2023;14;14;0;100;0;292089.285714286;2944;105
35068;2023;90;66;24;73.3333333333333;26.6666666666667;242294.022222222;2621.05555555556;94.4444444444444
35069;2023;130;90;40;69.2307692307692;30.7692307692308;273806.492307692;2797.00769230769;98.7076923076923
35070;2023;28;17;11;60.7142857142857;39.2857142857143;203765.5;2503.82142857143;84.6428571428571
35071;2023;5;5;0;100;0;134447.6;1415;96
35072;2023;18;18;0;100;0;134358.111111111;1550.77777777778;87.3888888888889
35075;2023;7;7;0;100;0;208500.285714286;1687.85714285714;123.714285714286
35076;2023;53;35;18;66.0377358490566;33.9622641509434;245528.094339623;2878.32075471698;87.4150943396226
35077;2023;5;5;0;100;0;84738;1111.8;81
35078;2023;16;15;1;93.75;6.25;305340.625;2802.3125;114.625
35079;2023;21;21;0;100;0;301809.428571429;2599.52380952381;114.666666666667
35080;2023;27;24;3;88.8888888888889;11.1111111111111;236539.296296296;2461.66666666667;97.0740740740741
35081;2023;7;7;0;100;0;280500;2602.14285714286;114.857142857143
35082;2023;17;17;0;100;0;182362.352941176;1506.41176470588;122.470588235294
35084;2023;3;3;0;100;0;117203.333333333;1717.66666666667;62.6666666666667
35085;2023;79;65;14;82.2784810126582;17.7215189873418;218137.911392405;2347.35443037975;96.126582278481
35086;2023;4;4;0;100;0;169375;1739.5;100.5
35087;2023;7;7;0;100;0;209544;1971.42857142857;113.142857142857
35088;2023;33;28;5;84.8484848484848;15.1515151515152;241358.696969697;2554.84848484848;99.7575757575758
35089;2023;10;10;0;100;0;202605;1773.2;118
35090;2023;29;24;5;82.7586206896552;17.2413793103448;198419.620689655;2179.72413793103;92.448275862069
35091;2023;9;9;0;100;0;207883.333333333;1835.55555555556;114.888888888889
35092;2023;7;7;0;100;0;188285.857142857;2084;95.7142857142857
35093;2023;278;120;158;43.1654676258993;56.8345323741007;459984.758992806;5938.80575539568;77.0215827338129
35094;2023;30;29;1;96.6666666666667;3.33333333333333;163098.5;1952.56666666667;87.2
35095;2023;98;59;39;60.2040816326531;39.7959183673469;195451.663265306;2445.41836734694;82.4183673469388
35096;2023;32;23;9;71.875;28.125;212629.375;2544.53125;89.53125
35097;2023;15;14;1;93.3333333333333;6.66666666666667;163842.2;1744.66666666667;97.4666666666667
35098;2023;10;10;0;100;0;141831.5;1684.1;83.1
35099;2023;42;35;7;83.3333333333333;16.6666666666667;305221.404761905;2864.11904761905;107.619047619048
35101;2023;12;12;0;100;0;183854.166666667;2504.41666666667;81.6666666666667
35102;2023;5;5;0;100;0;185700;1545.8;122.6
35103;2023;13;13;0;100;0;176751.230769231;1558.76923076923;117.307692307692
35104;2023;13;13;0;100;0;204621.307692308;2050.46153846154;110.153846153846
35105;2023;22;22;0;100;0;222188.181818182;2058.59090909091;107.772727272727
35106;2023;18;17;1;94.4444444444444;5.55555555555556;122913.888888889;1550.38888888889;75.7777777777778
35107;2023;16;15;1;93.75;6.25;228315.125;2324.625;104.0625
35108;2023;7;7;0;100;0;186442.857142857;1825.28571428571;107
35109;2023;18;18;0;100;0;220028.388888889;2217.55555555556;105.777777777778
35110;2023;10;10;0;100;0;217592.4;2375.9;96.6
35111;2023;9;9;0;100;0;128540;1492.11111111111;89.6666666666667
35112;2023;1;1;0;100;0;177000;1863;95
35114;2023;6;6;0;100;0;140166.666666667;1821.33333333333;80.1666666666667
35115;2023;276;122;154;44.2028985507246;55.7971014492754;148588.992753623;1954.6268115942;76.5724637681159
35116;2023;28;26;2;92.8571428571429;7.14285714285714;243154.857142857;2407.92857142857;105.821428571429
35117;2023;25;20;5;80;20;137568;1536.92;94
35118;2023;10;10;0;100;0;214858.5;2244.2;96.7
35119;2023;3;3;0;100;0;237000;1805;132.333333333333
35120;2023;54;40;14;74.0740740740741;25.9259259259259;290923.740740741;2970.33333333333;98.5740740740741
35121;2023;22;22;0;100;0;285161.181818182;2436.77272727273;117.272727272727
35122;2023;26;24;2;92.3076923076923;7.69230769230769;299461.538461538;3125.11538461538;97.5769230769231
35123;2023;43;33;10;76.7441860465116;23.2558139534884;223535.581395349;2469.76744186047;94.3023255813954
35124;2023;36;35;1;97.2222222222222;2.77777777777778;177163.166666667;1652.33333333333;105.361111111111
35125;2023;53;43;10;81.1320754716981;18.8679245283019;145498.396226415;1643.62264150943;90.3396226415094
35126;2023;87;76;11;87.3563218390805;12.6436781609195;272666.310344828;2882.94252873563;99.2298850574713
35127;2023;47;43;4;91.4893617021277;8.51063829787234;210916.425531915;2520.63829787234;89.531914893617
35128;2023;12;12;0;100;0;216332.5;2069.41666666667;98.5833333333333
35130;2023;36;33;3;91.6666666666667;8.33333333333333;226627.916666667;2215.61111111111;101.083333333333
35131;2023;44;24;20;54.5454545454545;45.4545454545455;236696.386363636;3051.88636363636;81.6590909090909
35132;2023;17;17;0;100;0;225552.941176471;2137.11764705882;106.117647058824
35133;2023;48;48;0;100;0;203557.958333333;2167.35416666667;98.6666666666667
35134;2023;5;5;0;100;0;233200;2281;99.4
35135;2023;20;17;3;85;15;191091.75;2238.2;91.65
35136;2023;95;64;31;67.3684210526316;32.6315789473684;211439.610526316;2562.90526315789;87.6842105263158
35137;2023;16;15;1;93.75;6.25;248942.5;2078.25;120.875
35138;2023;9;9;0;100;0;195697.333333333;2110.77777777778;92.6666666666667
35139;2023;75;49;26;65.3333333333333;34.6666666666667;240137.373333333;2804.92;89.8666666666667
35140;2023;7;7;0;100;0;126677.142857143;1419;83.4285714285714
35141;2023;3;3;0;100;0;215000;1945;109.666666666667
35142;2023;13;12;1;92.3076923076923;7.69230769230769;173730.769230769;1844.15384615385;103.846153846154
35143;2023;10;10;0;100;0;183889;1934.6;86.6
35144;2023;9;9;0;100;0;261615.555555556;2542.77777777778;100.666666666667
35145;2023;19;19;0;100;0;128863.157894737;1595.26315789474;80.7894736842105
35146;2023;5;5;0;100;0;235617;2509;95.6
35149;2023;19;19;0;100;0;263947.894736842;2757.10526315789;104.631578947368
35150;2023;37;37;0;100;0;213284.864864865;2112.13513513513;102.027027027027
35151;2023;2;2;0;100;0;122460;1576;70
35152;2023;85;64;21;75.2941176470588;24.7058823529412;276815.658823529;2884.44705882353;100.070588235294
35153;2023;6;6;0;100;0;228261.666666667;2192.16666666667;115
35154;2023;14;14;0;100;0;167235.714285714;1881.57142857143;85.8571428571429
35155;2023;7;7;0;100;0;281034.285714286;2593.14285714286;121.285714285714
35156;2023;6;6;0;100;0;217616.666666667;1830;128.833333333333
35157;2023;12;12;0;100;0;129732.5;1192.41666666667;108.916666666667
35159;2023;3;3;0;100;0;171666.666666667;1849.33333333333;90.6666666666667
35160;2023;5;5;0;100;0;113720;1550.6;73
35161;2023;17;17;0;100;0;193837.647058824;2090.29411764706;95.5882352941177
35162;2023;40;39;1;97.5;2.5;123531.125;1379.3;93.125
35163;2023;13;13;0;100;0;93497.2307692308;1274.92307692308;77.8461538461538
35164;2023;10;10;0;100;0;169908;1434.4;124.7
35165;2023;13;13;0;100;0;132797;1367.23076923077;101.692307692308
35166;2023;7;7;0;100;0;177357.142857143;1699.71428571429;105.428571428571
35167;2023;37;36;1;97.2972972972973;2.7027027027027;146604.864864865;1486.83783783784;98.5945945945946
35168;2023;70;70;0;100;0;140034.714285714;1556.15714285714;90.5
35169;2023;16;16;0;100;0;180230.0625;1848.6875;101.625
35170;2023;9;9;0;100;0;156771.666666667;1714.33333333333;93.5555555555556
35171;2023;26;26;0;100;0;182762.884615385;1727.34615384615;105.576923076923
35172;2023;14;14;0;100;0;189714.285714286;2174.28571428571;90
35173;2023;99;63;36;63.6363636363636;36.3636363636364;282214.353535354;2916.88888888889;95.989898989899
35174;2023;10;10;0;100;0;122620;1445.9;84.5
35175;2023;12;12;0;100;0;156624.166666667;1747.83333333333;84.5833333333333
35176;2023;111;108;3;97.2972972972973;2.7027027027027;166492.585585586;1890.6036036036;88.054054054054
35177;2023;52;38;14;73.0769230769231;26.9230769230769;330587.942307692;3137.57692307692;104.826923076923
35178;2023;24;24;0;100;0;220163;2169.04166666667;103.208333333333
35179;2023;79;70;9;88.6075949367088;11.3924050632911;218339.379746835;2411.70886075949;93.253164556962
35180;2023;9;9;0;100;0;177675.555555556;2133.11111111111;88.1111111111111
35181;2023;22;22;0;100;0;421093.181818182;3840.90909090909;115.545454545455
35183;2023;11;11;0;100;0;191933.454545455;1520.81818181818;123.818181818182
35184;2023;54;45;9;83.3333333333333;16.6666666666667;249795.425925926;2588.01851851852;98.4074074074074
35186;2023;17;17;0;100;0;252599.117647059;2526.76470588235;102.470588235294
35187;2023;14;14;0;100;0;173754.357142857;2256;78.1428571428571
35188;2023;66;38;28;57.5757575757576;42.4242424242424;228318.484848485;2660.27272727273;86.0606060606061
35189;2023;46;28;18;60.8695652173913;39.1304347826087;325600.195652174;3467.9347826087;95.6739130434783
35190;2023;7;7;0;100;0;151328.571428571;1336.42857142857;120.571428571429
35191;2023;21;21;0;100;0;100330.952380952;1233.7619047619;86.6190476190476
35192;2023;5;5;0;100;0;125093.8;1897.8;67
35193;2023;26;25;1;96.1538461538462;3.84615384615385;272195.807692308;2546.76923076923;107.346153846154
35194;2023;8;8;0;100;0;239879;2160.125;109.625
35195;2023;19;16;3;84.2105263157895;15.7894736842105;195815;2137.05263157895;94.2105263157895
35196;2023;70;38;32;54.2857142857143;45.7142857142857;242260.471428571;2931.47142857143;86.0428571428571
35197;2023;15;15;0;100;0;287843.733333333;2671.13333333333;109
35198;2023;13;13;0;100;0;240802.307692308;1665.07692307692;143.538461538462
35199;2023;3;3;0;100;0;166230;2035;79.3333333333333
35200;2023;3;3;0;100;0;193950;1378;143.333333333333
35201;2023;10;10;0;100;0;167251;1491.6;119.6
35202;2023;14;14;0;100;0;104984.571428571;1321.14285714286;77.5714285714286
35203;2023;2;2;0;100;0;186900;1482.5;127.5
35204;2023;25;22;3;88;12;296553.44;2834.4;106
35205;2023;7;7;0;100;0;167857.142857143;2183.85714285714;75.2857142857143
35206;2023;152;54;98;35.5263157894737;64.4736842105263;211509.855263158;2752.43421052632;78.1578947368421
35207;2023;67;36;31;53.7313432835821;46.2686567164179;262439.014925373;3035.49253731343;88.955223880597
35208;2023;62;52;10;83.8709677419355;16.1290322580645;268528.290322581;2836.40322580645;96.6451612903226
35210;2023;127;80;47;62.992125984252;37.007874015748;329686.763779528;3499.92913385827;95.1259842519685
35211;2023;33;33;0;100;0;189875.696969697;1973.27272727273;97.0909090909091
35212;2023;19;19;0;100;0;198735.263157895;1873.21052631579;108.052631578947
35214;2023;9;9;0;100;0;163642.222222222;2226.88888888889;88.4444444444444
35215;2023;17;17;0;100;0;200758.764705882;1985.82352941176;108.941176470588
35216;2023;18;9;9;50;50;210220.555555556;2493.77777777778;84.8333333333333
35217;2023;17;17;0;100;0;150988.235294118;1404.29411764706;111.705882352941
35218;2023;9;9;0;100;0;241253.222222222;2303.22222222222;101.666666666667
35219;2023;38;36;2;94.7368421052632;5.26315789473684;159773.421052632;1720.10526315789;93.4210526315789
35220;2023;37;36;1;97.2972972972973;2.7027027027027;249945.216216216;2089.18918918919;121.540540540541
35221;2023;24;23;1;95.8333333333333;4.16666666666667;140897.5;1697.04166666667;83.3333333333333
35222;2023;26;26;0;100;0;151827.807692308;1802.19230769231;92.0769230769231
35223;2023;50;44;6;88;12;195766.72;2143.04;93.74
35224;2023;39;39;0;100;0;223247.871794872;2187.58974358974;100.282051282051
35225;2023;16;13;3;81.25;18.75;190334;2045.6875;98.125
35226;2023;30;28;2;93.3333333333333;6.66666666666667;181935.5;2183.23333333333;96.5333333333333
35227;2023;20;17;3;85;15;244115.65;2609.45;96.35
35228;2023;125;91;34;72.8;27.2;273184.544;3105.752;89.512
35229;2023;12;12;0;100;0;293720.583333333;2179;137.25
35230;2023;2;2;0;100;0;104450;1558.5;93
35231;2023;12;8;4;66.6666666666667;33.3333333333333;215153.333333333;2126.16666666667;95.8333333333333
35232;2023;7;7;0;100;0;159428.428571429;1339.28571428571;116.857142857143
35233;2023;17;17;0;100;0;252789.352941176;2443.82352941176;101.647058823529
35234;2023;10;10;0;100;0;165750;1694.1;100.5
35235;2023;10;10;0;100;0;156600;1653.6;89.9
35236;2023;128;79;49;61.71875;38.28125;191283.4609375;2181.765625;89.9140625
35237;2023;16;16;0;100;0;114777.75;1635;72.8125
35238;2023;3154;391;2763;12.3969562460368;87.6030437539632;254654.467343056;4061.46385542169;63.0459733671528
35239;2023;46;41;5;89.1304347826087;10.8695652173913;157021.065217391;1956.67391304348;82.9565217391304
35240;2023;98;44;54;44.8979591836735;55.1020408163265;256164.653061224;2909.47959183673;91.1224489795918
35241;2023;23;11;12;47.8260869565217;52.1739130434783;402266.391304348;4276.69565217391;88.5652173913043
35242;2023;4;4;0;100;0;102500;1166.25;96.25
35243;2023;25;24;1;96;4;180366.48;1869.8;100.08
35244;2023;4;4;0;100;0;153937.5;1249.25;123.5
35245;2023;47;39;8;82.9787234042553;17.0212765957447;222666.85106383;2468.34042553192;92.1489361702128
35246;2023;11;11;0;100;0;203855.454545455;1936.27272727273;104.272727272727
35247;2023;24;17;7;70.8333333333333;29.1666666666667;115795.416666667;1692.75;71.5
35248;2023;9;9;0;100;0;88444.4444444444;1169.66666666667;80.3333333333333
35249;2023;18;18;0;100;0;148034.388888889;1551;94.1111111111111
35250;2023;38;32;6;84.2105263157895;15.7894736842105;232367.921052632;2553.47368421053;93.1315789473684
35251;2023;42;31;11;73.8095238095238;26.1904761904762;254439.738095238;2642.95238095238;97.6428571428571
35252;2023;8;8;0;100;0;195199.375;1930.25;106.75
35253;2023;32;28;4;87.5;12.5;224039.1875;2287.125;99.96875
35255;2023;9;9;0;100;0;272466.666666667;3209;90.2222222222222
35256;2023;48;38;10;79.1666666666667;20.8333333333333;627476.9375;6226.33333333333;101.375
35257;2023;31;29;2;93.5483870967742;6.45161290322581;191358.064516129;1909.03225806452;100.870967741935
35259;2023;9;9;0;100;0;176353.222222222;2144.66666666667;93
35260;2023;14;14;0;100;0;144176.642857143;1716.5;88.4285714285714
35261;2023;2;2;0;100;0;122050;1441.5;118
35262;2023;6;6;0;100;0;191333.333333333;1809.16666666667;105.5
35263;2023;31;30;1;96.7741935483871;3.2258064516129;436768.064516129;3894.48387096774;108.193548387097
35264;2023;14;13;1;92.8571428571429;7.14285714285714;287735.714285714;2274.64285714286;137
35265;2023;27;21;6;77.7777777777778;22.2222222222222;192309.814814815;2296.33333333333;85.7037037037037
35266;2023;41;26;15;63.4146341463415;36.5853658536585;269035.975609756;2868.0243902439;96.8780487804878
35268;2023;7;7;0;100;0;173714.285714286;1224.14285714286;140.285714285714
35271;2023;30;30;0;100;0;128135.633333333;1561.56666666667;95.4666666666667
35272;2023;10;10;0;100;0;214930;1921.7;117
35273;2023;26;26;0;100;0;192172.807692308;1840.57692307692;111.076923076923
35274;2023;12;11;1;91.6666666666667;8.33333333333333;226179.166666667;2328.08333333333;99
35275;2023;48;35;13;72.9166666666667;27.0833333333333;261270.333333333;3001.3125;90.0208333333333
35276;2023;7;7;0;100;0;205021.571428571;2202.85714285714;91.1428571428571
35277;2023;7;7;0;100;0;126472.857142857;1248.14285714286;103.857142857143
35278;2023;121;52;69;42.9752066115703;57.0247933884297;391106.512396694;3910.99173553719;98.5371900826446
35279;2023;19;19;0;100;0;235338.421052632;2608.57894736842;91.2631578947368
35280;2023;14;14;0;100;0;169705.714285714;1973.28571428571;102.642857142857
35281;2023;199;45;154;22.6130653266332;77.3869346733668;223832.085427136;3292.90452261307;68.6884422110553
35282;2023;28;28;0;100;0;157638.107142857;1803.03571428571;89.5
35283;2023;4;4;0;100;0;201362.5;1999;104.5
35284;2023;24;20;4;83.3333333333333;16.6666666666667;371008.041666667;3518.54166666667;106.625
35285;2023;21;21;0;100;0;170141.428571429;1642.33333333333;102.619047619048
35286;2023;3;3;0;100;0;123750.333333333;1089;111.333333333333
35287;2023;41;32;9;78.0487804878049;21.9512195121951;550657.243902439;6356.09756097561;88.390243902439
35288;2023;745;278;467;37.3154362416107;62.6845637583893;374935.766442953;4962.15570469799;75.1597315436242
35289;2023;12;12;0;100;0;105680.916666667;1345.33333333333;79.25
35290;2023;9;9;0;100;0;165405.555555556;1608.88888888889;115.888888888889
35291;2023;7;7;0;100;0;188247.142857143;2066.14285714286;97.2857142857143
35292;2023;26;26;0;100;0;139854.846153846;1456.46153846154;97.2692307692308
35294;2023;23;23;0;100;0;168510.217391304;1773.65217391304;94.695652173913
35295;2023;7;7;0;100;0;176658.571428571;1880.42857142857;100.571428571429
35296;2023;16;16;0;100;0;181067.625;2158.625;94.125
35297;2023;62;38;24;61.2903225806452;38.7096774193548;128659.64516129;1707.11290322581;78.2258064516129
35299;2023;52;41;11;78.8461538461538;21.1538461538462;286708.461538462;3216.01923076923;89.1346153846154
35300;2023;27;25;2;92.5925925925926;7.40740740740741;180560.851851852;2212.48148148148;99.4814814814815
35302;2023;4;4;0;100;0;216400;2383.75;94.75
35304;2023;16;15;1;93.75;6.25;153359.875;2075.6875;73.3125
35305;2023;1;1;0;100;0;21000;700;30
35306;2023;22;20;2;90.9090909090909;9.09090909090909;322935.454545455;3473.72727272727;102.454545454545
35307;2023;9;9;0;100;0;152458.333333333;1472.44444444444;99.5555555555556
35308;2023;58;57;1;98.2758620689655;1.72413793103448;188419.017241379;2019.55172413793;94.2241379310345
35309;2023;10;10;0;100;0;187496.7;1784.3;106
35310;2023;7;7;0;100;0;214638.571428571;2085.14285714286;102.714285714286
35311;2023;10;10;0;100;0;187349;1516;127.6
35312;2023;21;21;0;100;0;197621.428571429;2244.14285714286;90.0952380952381
35314;2023;12;12;0;100;0;484704.083333333;4264.5;110.083333333333
35315;2023;5;5;0;100;0;356820;2903.4;117.6
35316;2023;18;18;0;100;0;156752.222222222;1428.27777777778;113.277777777778
35317;2023;2;2;0;100;0;204854;1777;109.5
35318;2023;12;12;0;100;0;225979.416666667;1968.33333333333;116.083333333333
35319;2023;16;15;1;93.75;6.25;196939.75;2423.8125;81.75
35320;2023;3;3;0;100;0;161666.666666667;1575.66666666667;116
35321;2023;8;8;0;100;0;187462.5;1814.875;101.875
35322;2023;17;17;0;100;0;196433.411764706;2094.82352941176;95.5882352941177
35324;2023;3;3;0;100;0;185666.666666667;2066;94.3333333333333
35325;2023;2;2;0;100;0;127500;1097.5;112.5
35326;2023;21;20;1;95.2380952380952;4.76190476190476;180938.095238095;1718.61904761905;104.857142857143
35327;2023;42;40;2;95.2380952380952;4.76190476190476;263916.714285714;2708.52380952381;104.190476190476
35328;2023;24;24;0;100;0;140138.25;1692.41666666667;85.4583333333333
35329;2023;9;9;0;100;0;213611.111111111;1722.88888888889;126.111111111111
35330;2023;4;4;0;100;0;184500;1954.75;94.5
35331;2023;28;27;1;96.4285714285714;3.57142857142857;247898.214285714;2369.96428571429;111.142857142857
35332;2023;15;15;0;100;0;102479.933333333;1135.13333333333;92.0666666666667
35333;2023;16;15;1;93.75;6.25;221264.375;2176.5;105.0625
35334;2023;80;57;23;71.25;28.75;342012.225;3434.0625;100.2875
35335;2023;8;8;0;100;0;151912.5;1448.375;102.375
35336;2023;3;3;0;100;0;128333.333333333;1708.33333333333;86.3333333333333
35337;2023;42;30;12;71.4285714285714;28.5714285714286;203309.5;2292.52380952381;88.2857142857143
35338;2023;13;13;0;100;0;204461.538461538;2238.15384615385;93.4615384615385
35339;2023;8;8;0;100;0;173851.875;1516.625;114.25
35340;2023;16;16;0;100;0;201076.875;2062.625;102.125
35342;2023;2;2;0;100;0;83750;1187.5;67.5
35343;2023;14;14;0;100;0;157057.5;1605.07142857143;104.214285714286
35345;2023;8;8;0;100;0;179725;1891.125;97
35346;2023;2;2;0;100;0;108100;910.5;108
35347;2023;33;32;1;96.969696969697;3.03030303030303;189184.606060606;2093.57575757576;94.0606060606061
35350;2023;5;5;0;100;0;144239.4;1541.2;97.8
35351;2023;14;13;1;92.8571428571429;7.14285714285714;220028.571428571;2481.07142857143;92.5
35352;2023;75;54;21;72;28;314881.92;3029.46666666667;103
35353;2023;63;33;30;52.3809523809524;47.6190476190476;269997.238095238;3119.98412698413;89.5238095238095
35354;2023;5;5;0;100;0;153300;1359.2;114.4
35355;2023;16;15;1;93.75;6.25;147394.375;1764.6875;90.125
35356;2023;16;14;2;87.5;12.5;297154.375;2791.875;108
35357;2023;4;4;0;100;0;181875;1497;137.75
35358;2023;11;11;0;100;0;277658;2661.27272727273;102.545454545455
35359;2023;9;8;1;88.8888888888889;11.1111111111111;158207.888888889;1770.22222222222;96.8888888888889
35360;2023;229;134;95;58.5152838427948;41.4847161572052;235586.397379913;2733.56331877729;88.5327510917031
35361;2023;20;20;0;100;0;190831.05;2100.8;91.75
35362;2023;20;10;10;50;50;204973.75;2539.8;76
35363;2023;43;27;16;62.7906976744186;37.2093023255814;261899.674418605;2742.76744186047;95.8837209302326
36001;2023;23;22;1;95.6521739130435;4.34782608695652;83448.0869565217;957.782608695652;85.9565217391304
36002;2023;2;2;0;100;0;72500;1006.5;69.5
36003;2023;9;9;0;100;0;106000;1124.88888888889;97.8888888888889
36004;2023;4;4;0;100;0;140837.5;848.25;175
36005;2023;41;40;1;97.5609756097561;2.4390243902439;126856.097560976;1383.48780487805;97.2682926829268
36006;2023;78;73;5;93.5897435897436;6.41025641025641;110427.423076923;1164.66666666667;91.4358974358974
36007;2023;13;13;0;100;0;102153.846153846;1223.07692307692;88.6153846153846
36008;2023;4;4;0;100;0;159375;1928.5;91.25
36009;2023;12;12;0;100;0;129391.666666667;1276.66666666667;94.0833333333333
36010;2023;14;14;0;100;0;74553.2142857143;944.428571428571;83
36011;2023;1;1;0;100;0;51500;792;65
36012;2023;6;6;0;100;0;53316.6666666667;840.166666666667;66.3333333333333
36013;2023;9;9;0;100;0;73777.7777777778;914.444444444444;78.4444444444444
36014;2023;5;5;0;100;0;87600;1003;101.6
36015;2023;2;2;0;100;0;138850;1296;100.5
36016;2023;11;11;0;100;0;91863.6363636364;922;103.090909090909
36017;2023;14;14;0;100;0;111615.285714286;991.142857142857;109.142857142857
36018;2023;95;84;11;88.4210526315789;11.5789473684211;97673.2421052632;1124.72631578947;87.2
36020;2023;1;1;0;100;0;23500;480;49
36021;2023;7;7;0;100;0;116857.142857143;1052.14285714286;103.428571428571
36022;2023;5;5;0;100;0;55200;737.4;79
36023;2023;3;3;0;100;0;35166.6666666667;690;50.6666666666667
36024;2023;1;1;0;100;0;82000;695;118
36025;2023;11;11;0;100;0;153579;1168.54545454545;123.090909090909
36026;2023;7;7;0;100;0;130028.571428571;1216.42857142857;106.857142857143
36027;2023;3;3;0;100;0;134646;1632.33333333333;106.666666666667
36028;2023;3;3;0;100;0;59116.6666666667;936.333333333333;62.6666666666667
36029;2023;2;2;0;100;0;167500;1580;117
36030;2023;3;3;0;100;0;83333.3333333333;825;106.333333333333
36031;2023;45;44;1;97.7777777777778;2.22222222222222;124192.044444444;1324.31111111111;95.1555555555556
36032;2023;12;12;0;100;0;108942.25;1057.25;103.083333333333
36033;2023;5;5;0;100;0;119698.4;1186.6;108.6
36034;2023;39;39;0;100;0;109258.974358974;1122.74358974359;96.4615384615385
36035;2023;17;17;0;100;0;82155.7058823529;909.705882352941;92.1764705882353
36037;2023;3;3;0;100;0;73333.3333333333;972.333333333333;78.6666666666667
36038;2023;1;1;0;100;0;55000;1146;48
36040;2023;3;3;0;100;0;88000;1099.66666666667;83.3333333333333
36041;2023;2;2;0;100;0;155500;1206.5;135
36042;2023;7;7;0;100;0;107346.857142857;981.142857142857;112.428571428571
36043;2023;6;6;0;100;0;45133.3333333333;753.5;61.5
36044;2023;584;355;229;60.7876712328767;39.2123287671233;112782.626712329;1386.56164383562;81.7945205479452
36045;2023;39;37;2;94.8717948717949;5.12820512820513;87791.2564102564;958.307692307692;91.9230769230769
36046;2023;63;54;9;85.7142857142857;14.2857142857143;97039.0476190476;1106.68253968254;88.8253968253968
36047;2023;6;6;0;100;0;76916.6666666667;796.166666666667;97.5
36048;2023;6;6;0;100;0;90120.3333333333;956.166666666667;102.5
36049;2023;1;1;0;100;0;31000;443;70
36050;2023;8;8;0;100;0;136167.75;1674.625;84.625
36051;2023;3;3;0;100;0;168065;1652.33333333333;95
36053;2023;8;8;0;100;0;147750;1382.5;87.875
36054;2023;2;2;0;100;0;108000;1307;85
36055;2023;12;11;1;91.6666666666667;8.33333333333333;89908.8333333333;958.083333333333;92.75
36056;2023;12;12;0;100;0;133666.666666667;1088.25;106.666666666667
36057;2023;11;11;0;100;0;154299.818181818;1356.36363636364;119.363636363636
36058;2023;12;12;0;100;0;117239.166666667;1262.83333333333;93.5833333333333
36059;2023;2;2;0;100;0;116650;1073;106.5
36060;2023;20;20;0;100;0;90572.4;1154.6;78.25
36061;2023;6;6;0;100;0;80500;1649;54.3333333333333
36062;2023;11;11;0;100;0;168160;1376.81818181818;94.3636363636364
36063;2023;70;66;4;94.2857142857143;5.71428571428571;140396.914285714;1561.91428571429;90.4
36064;2023;7;7;0;100;0;149500.571428571;1615.57142857143;90
36065;2023;6;6;0;100;0;101073.333333333;973.333333333333;103
36066;2023;7;7;0;100;0;82142.8571428571;1086.57142857143;87.5714285714286
36067;2023;3;3;0;100;0;85968;839.333333333333;104.666666666667
36068;2023;6;6;0;100;0;61000;750.333333333333;79.8333333333333
36069;2023;30;27;3;90;10;79310;1016.8;82.6666666666667
36070;2023;25;25;0;100;0;140272;1447.12;99.2
36071;2023;5;5;0;100;0;271966.2;1929;133.2
36073;2023;3;3;0;100;0;58834;1101.66666666667;66.3333333333333
36074;2023;16;16;0;100;0;83226.1875;860.625;89.75
36075;2023;1;1;0;100;0;99000;1238;80
36076;2023;2;2;0;100;0;140675;1067.5;132.5
36077;2023;3;3;0;100;0;54333.3333333333;863.333333333333;67
36078;2023;6;6;0;100;0;123373.333333333;1415.16666666667;99.6666666666667
36079;2023;1;1;0;100;0;65000;1226;53
36081;2023;6;6;0;100;0;82028;896.5;91.6666666666667
36082;2023;5;5;0;100;0;76900;785.8;98.4
36083;2023;1;1;0;100;0;140000;583;240
36084;2023;1;1;0;100;0;27500;404;68
36085;2023;4;4;0;100;0;108500;1076.75;107.75
36086;2023;5;5;0;100;0;94690;1062.8;110.4
36087;2023;5;5;0;100;0;98400;812.6;133
36088;2023;142;132;10;92.9577464788732;7.04225352112676;88706.7676056338;1038.01408450704;85.5070422535211
36089;2023;4;4;0;100;0;142725;1555.5;90.5
36090;2023;2;2;0;100;0;127500;1168;101.5
36091;2023;6;6;0;100;0;150083.333333333;1549.66666666667;106.666666666667
36092;2023;1;1;0;100;0;25000;410;61
36093;2023;28;26;2;92.8571428571429;7.14285714285714;91658.0357142857;1073.85714285714;81.1071428571429
36094;2023;11;11;0;100;0;93121.6363636364;1155.27272727273;78.0909090909091
36095;2023;1;1;0;100;0;150000;667;225
36096;2023;2;2;0;100;0;61000;991.5;62
36097;2023;3;3;0;100;0;138000;1263.66666666667;105.666666666667
36098;2023;2;2;0;100;0;90000;705.5;135
36099;2023;6;6;0;100;0;50066.6666666667;755.666666666667;69
36100;2023;2;2;0;100;0;127000;1047;108
36101;2023;9;9;0;100;0;137666.666666667;1390.22222222222;102.333333333333
36102;2023;2;2;0;100;0;2,00E+05;1596.5;119
36103;2023;16;16;0;100;0;96156.25;1000.8125;95.8125
36104;2023;3;3;0;100;0;42333.3333333333;807.333333333333;55.3333333333333
36105;2023;3;3;0;100;0;49300;578.666666666667;88.3333333333333
36106;2023;1;1;0;100;0;30000;405;74
36107;2023;13;13;0;100;0;113175.384615385;1276.61538461538;95.4615384615385
36108;2023;1;1;0;100;0;107000;1408;76
36109;2023;10;10;0;100;0;173527.9;1472.2;127.9
36110;2023;1;1;0;100;0;55000;671;82
36111;2023;1;1;0;100;0;115800;1412;82
36112;2023;9;9;0;100;0;119424.444444444;1212;110.777777777778
36113;2023;19;19;0;100;0;107144.736842105;1166.42105263158;92.7894736842105
36114;2023;2;2;0;100;0;78750;1257;63.5
36115;2023;1;1;0;100;0;54000;1350;40
36116;2023;2;2;0;100;0;95000;832.5;114.5
36117;2023;6;6;0;100;0;77000;951.333333333333;85.3333333333333
36118;2023;4;4;0;100;0;66856.25;871.5;76
36119;2023;7;7;0;100;0;66500;739.142857142857;85.5714285714286
36120;2023;10;10;0;100;0;112940;1321.4;92.4
36122;2023;2;2;0;100;0;34100;1075;33
36123;2023;13;13;0;100;0;166761.538461538;1707.92307692308;101.692307692308
36124;2023;6;6;0;100;0;67610.6666666667;957.833333333333;76
36125;2023;1;1;0;100;0;166000;1258;132
36126;2023;11;11;0;100;0;65966.3636363636;904.545454545455;75
36127;2023;18;18;0;100;0;116108.333333333;1168.55555555556;93.8888888888889
36128;2023;13;13;0;100;0;136679.076923077;1414.07692307692;95.7692307692308
36129;2023;5;5;0;100;0;95483.2;984.2;95.2
36130;2023;1;1;0;100;0;60000;667;90
36131;2023;7;7;0;100;0;106822.857142857;1095.28571428571;100.571428571429
36133;2023;3;3;0;100;0;66466.6666666667;824;80.6666666666667
36134;2023;4;4;0;100;0;85890.75;937;97.75
36135;2023;3;3;0;100;0;81666.6666666667;1172.66666666667;76.6666666666667
36136;2023;5;5;0;100;0;113799.8;1187.8;90.2
36137;2023;6;6;0;100;0;88687.5;828.833333333333;98.5
36138;2023;3;3;0;100;0;122766.666666667;1260;102
36139;2023;11;10;1;90.9090909090909;9.09090909090909;106763.636363636;1168.81818181818;81.8181818181818
36140;2023;13;13;0;100;0;96471.3846153846;1416.53846153846;74.5384615384615
36141;2023;20;20;0;100;0;115385;1286.65;91.35
36142;2023;11;11;0;100;0;147954.545454545;1583.63636363636;96.9090909090909
36143;2023;6;6;0;100;0;88000;807.833333333333;109.5
36144;2023;2;2;0;100;0;215000;2267.5;116.5
36145;2023;5;5;0;100;0;150678.6;1911.8;85.6
36146;2023;8;8;0;100;0;104714.625;1064.625;97.875
36147;2023;2;2;0;100;0;96250;1219;82.5
36148;2023;7;7;0;100;0;89628.5714285714;1123.28571428571;74.2857142857143
36149;2023;13;13;0;100;0;97400.7692307692;967.923076923077;100.692307692308
36150;2023;11;11;0;100;0;66301.1818181818;797.272727272727;86.5454545454545
36152;2023;9;9;0;100;0;102261.444444444;1084.88888888889;92.7777777777778
36153;2023;4;4;0;100;0;57861.25;775;70
36154;2023;20;20;0;100;0;102573.2;1198.75;84.1
36155;2023;10;10;0;100;0;82780;914.2;96.4
36156;2023;15;15;0;100;0;114699.333333333;1182.73333333333;95.3333333333333
36157;2023;2;2;0;100;0;177000;1860;96.5
36158;2023;14;14;0;100;0;83135.7142857143;1158.64285714286;82.4285714285714
36159;2023;60;58;2;96.6666666666667;3.33333333333333;190230.533333333;1898.3;100.316666666667
36160;2023;2;2;0;100;0;42500;655;65
36161;2023;11;11;0;100;0;96809.7272727273;1196;84
36162;2023;16;15;1;93.75;6.25;106531.25;913.625;114.5
36163;2023;10;10;0;100;0;107470.5;1078.4;103.6
36164;2023;2;2;0;100;0;50750;731.5;70
36165;2023;14;14;0;100;0;95892.8571428571;1092.21428571429;87.2142857142857
36166;2023;3;3;0;100;0;75666.6666666667;1022;69.3333333333333
36167;2023;1;1;0;100;0;177000;983;180
36168;2023;18;17;1;94.4444444444444;5.55555555555556;68795.8333333333;856.166666666667;78.4444444444444
36169;2023;7;7;0;100;0;96029.8571428571;1043.71428571429;92
36170;2023;1;1;0;100;0;165000;1486;111
36171;2023;28;28;0;100;0;90789.2857142857;1013.75;89.25
36172;2023;10;10;0;100;0;115900;1195.6;112.6
36173;2023;5;5;0;100;0;80500;979.4;86.6
36174;2023;5;5;0;100;0;86652;940.6;88.8
36175;2023;6;6;0;100;0;47083.3333333333;750.833333333333;61.8333333333333
36176;2023;9;9;0;100;0;70614.6666666667;894.555555555556;81.5555555555556
36177;2023;5;5;0;100;0;79400;863.4;91.4
36178;2023;1;1;0;100;0;227500;1865;122
36179;2023;3;3;0;100;0;108333.333333333;929.666666666667;102
36180;2023;19;19;0;100;0;138052.631578947;1428.21052631579;93.7368421052632
36182;2023;13;13;0;100;0;92099.6923076923;1044.46153846154;89.5384615384615
36184;2023;3;3;0;100;0;90166.6666666667;867.666666666667;94.6666666666667
36185;2023;4;4;0;100;0;52825;689.75;79.5
36186;2023;1;1;0;100;0;35000;565;62
36187;2023;1;1;0;100;0;92000;613;150
36188;2023;5;5;0;100;0;104797.6;1130;92.6
36189;2023;10;10;0;100;0;79757;970.5;83.1
36190;2023;1;1;0;100;0;55900;776;72
36191;2023;2;2;0;100;0;79500;1325;60
36192;2023;26;26;0;100;0;106205.769230769;1113.11538461538;95.8846153846154
36193;2023;8;8;0;100;0;130075.625;1100.875;108.375
36194;2023;21;21;0;100;0;77131.2380952381;909.428571428571;86.2857142857143
36195;2023;9;9;0;100;0;112922.222222222;1484.77777777778;82.1111111111111
36197;2023;2;2;0;100;0;135700;1652.5;92.5
36198;2023;3;3;0;100;0;99000;1293;75.3333333333333
36199;2023;10;10;0;100;0;142870;1203.1;119.9
36200;2023;29;26;3;89.6551724137931;10.3448275862069;75599.8620689655;1040.51724137931;74.1379310344828
36202;2023;20;20;0;100;0;184751.6;1881.3;100.35
36204;2023;3;3;0;100;0;105500;853.333333333333;116
36205;2023;2;2;0;100;0;182000;3146.5;57.5
36207;2023;12;12;0;100;0;91314.8333333333;923.75;91
36208;2023;9;9;0;100;0;62366.1111111111;911.222222222222;72.7777777777778
36209;2023;4;4;0;100;0;74250;1023.75;70.75
36210;2023;4;4;0;100;0;93250;1200.25;79.5
36211;2023;5;5;0;100;0;166000;1496.4;107.6
36212;2023;1;1;0;100;0;134700;1347;100
36213;2023;3;3;0;100;0;121333.333333333;1096;107.666666666667
36214;2023;4;4;0;100;0;58750;793.5;77
36215;2023;7;7;0;100;0;167816.285714286;1399.71428571429;122.857142857143
36217;2023;2;2;0;100;0;127500;859;170.5
36218;2023;1;1;0;100;0;50000;538;93
36219;2023;6;6;0;100;0;120856.666666667;1269.5;91.8333333333333
36220;2023;6;6;0;100;0;110183.333333333;1232.83333333333;95.1666666666667
36221;2023;7;7;0;100;0;154628.571428571;1152.14285714286;122
36222;2023;4;4;0;100;0;123750;1016.5;108
36223;2023;4;4;0;100;0;71715.5;855;79.75
36224;2023;8;7;1;87.5;12.5;89125;1190;84.125
36225;2023;2;2;0;100;0;134000;1144.5;122
36226;2023;4;4;0;100;0;115550;1013.75;127.75
36227;2023;3;3;0;100;0;58000;812.666666666667;75
36228;2023;30;30;0;100;0;86842.8666666667;1064.26666666667;85.2
36229;2023;10;10;0;100;0;66030;717.1;97.4
36230;2023;26;26;0;100;0;98642.3076923077;1060.11538461538;93.1538461538462
36231;2023;3;3;0;100;0;146883.333333333;1448.66666666667;114.333333333333
36232;2023;14;14;0;100;0;100992.5;1081.5;89.4285714285714
36233;2023;11;11;0;100;0;127427.272727273;882;123.363636363636
36234;2023;4;4;0;100;0;71325;1074.75;72.25
36235;2023;6;6;0;100;0;74583.3333333333;1394.83333333333;64.8333333333333
36236;2023;12;12;0;100;0;88666.6666666667;1093.25;77.4166666666667
36237;2023;14;14;0;100;0;68881.2142857143;741.571428571429;90.7857142857143
36238;2023;4;4;0;100;0;66725;1101.25;69
36239;2023;7;7;0;100;0;119985.714285714;1346.57142857143;83.5714285714286
36240;2023;4;4;0;100;0;83070.5;900;91
36241;2023;33;28;5;84.8484848484848;15.1515151515152;114800.696969697;1472.9696969697;86.4848484848485
36242;2023;2;2;0;100;0;87500;715;120
36243;2023;1;1;0;100;0;60000;769;78
36244;2023;18;18;0;100;0;124395.388888889;1122.72222222222;109.666666666667
36247;2023;11;11;0;100;0;125869.818181818;1297;96.1818181818182
36248;2023;2;2;0;100;0;101250;949;104.5
37001;2023;10;10;0;100;0;152740;1408.5;95.7
37002;2023;16;16;0;100;0;272756.25;2142.5;117.375
37003;2023;186;122;64;65.5913978494624;34.4086021505376;216707.290322581;2592.47311827957;84.6021505376344
37004;2023;3;3;0;100;0;213266.666666667;1653.66666666667;128.666666666667
37005;2023;5;5;0;100;0;91900;1160.4;95.6
37006;2023;30;30;0;100;0;262103.5;2485;108.3
37007;2023;5;5;0;100;0;258800;1701.4;140
37008;2023;25;25;0;100;0;230842.32;2194.56;106.24
37009;2023;1;1;0;100;0;1,00E+05;1000;100
37010;2023;20;20;0;100;0;195414.05;1988.05;106.1
37011;2023;15;9;6;60;40;157966.666666667;1811.53333333333;84.2666666666667
37012;2023;5;5;0;100;0;175268.6;1608.2;113.2
37013;2023;6;6;0;100;0;140250;1252.83333333333;114.666666666667
37014;2023;38;34;4;89.4736842105263;10.5263157894737;208577.894736842;2316.47368421053;94.8947368421053
37015;2023;22;21;1;95.4545454545455;4.54545454545455;249849.454545455;2457.09090909091;100
37016;2023;9;9;0;100;0;204188.888888889;2124.66666666667;98.4444444444444
37018;2023;76;59;17;77.6315789473684;22.3684210526316;308776.618421053;3017.23684210526;103.881578947368
37019;2023;5;5;0;100;0;129538;1531.4;85.8
37020;2023;22;21;1;95.4545454545455;4.54545454545455;124656.818181818;1522.72727272727;84.5909090909091
37021;2023;12;11;1;91.6666666666667;8.33333333333333;230991.666666667;2223.75;110.166666666667
37022;2023;27;27;0;100;0;171475;1954.81481481481;91.6666666666667
37023;2023;3;3;0;100;0;119333.333333333;1449.33333333333;78.6666666666667
37024;2023;9;9;0;100;0;151322;1509.77777777778;99.2222222222222
37025;2023;5;5;0;100;0;305380;2340.6;135.8
37026;2023;9;9;0;100;0;94444.4444444444;1153.44444444444;73.1111111111111
37027;2023;71;66;5;92.9577464788732;7.04225352112676;203215.845070423;2262.95774647887;95.8732394366197
37028;2023;14;14;0;100;0;117302.357142857;1108.78571428571;98.3571428571429
37029;2023;9;9;0;100;0;142421.111111111;1367.22222222222;102.333333333333
37030;2023;5;5;0;100;0;171700;2007.2;82
37031;2023;64;63;1;98.4375;1.5625;182037.453125;1824.484375;102.75
37032;2023;5;5;0;100;0;129810;1708;80
37033;2023;3;3;0;100;0;90316.6666666667;1580;59
37034;2023;4;4;0;100;0;110020;1538.75;80.25
37035;2023;4;4;0;100;0;85000;982;87.25
37036;2023;3;3;0;100;0;232326.666666667;1462;162.666666666667
37037;2023;2;2;0;100;0;192500;1629;117.5
37038;2023;14;14;0;100;0;164764.285714286;1626.78571428571;99.9285714285714
37039;2023;4;4;0;100;0;128354.5;1301;99.5
37040;2023;5;5;0;100;0;162060;1514.6;104
37041;2023;7;7;0;100;0;162285.714285714;1418.85714285714;111.285714285714
37042;2023;7;7;0;100;0;214628.571428571;1739;112
37043;2023;19;19;0;100;0;271601.526315789;2263.94736842105;122.368421052632
37044;2023;7;7;0;100;0;111321.428571429;1153.71428571429;75.7142857142857
37045;2023;15;15;0;100;0;106285.866666667;1200.46666666667;91.2666666666667
37046;2023;9;9;0;100;0;120333.333333333;1685.77777777778;76.3333333333333
37047;2023;10;10;0;100;0;269500;2327.9;118.2
37048;2023;5;5;0;100;0;102980;1069;96.2
37049;2023;10;10;0;100;0;191500;2003.3;97.9
37050;2023;166;75;91;45.1807228915663;54.8192771084337;200469.072289157;2748.73493975904;74.2349397590361
37051;2023;15;15;0;100;0;127983.333333333;1580.2;82.5333333333333
37052;2023;16;16;0;100;0;196462.5;2141.375;97.8125
37054;2023;29;29;0;100;0;308033.482758621;3052.68965517241;104.448275862069
37055;2023;6;6;0;100;0;197533.333333333;1489.16666666667;145.833333333333
37056;2023;6;6;0;100;0;206166.666666667;2296.33333333333;90.5
37057;2023;9;9;0;100;0;179220;1847.33333333333;97.3333333333333
37058;2023;28;28;0;100;0;162982.892857143;1603.07142857143;99.3571428571429
37059;2023;15;15;0;100;0;339623.2;2721.46666666667;123.533333333333
37060;2023;14;14;0;100;0;250171.428571429;2325.07142857143;106.928571428571
37061;2023;6;6;0;100;0;68666.6666666667;929.833333333333;73.8333333333333
37062;2023;17;17;0;100;0;156211.176470588;2429.88235294118;91.7647058823529
37063;2023;43;36;7;83.7209302325581;16.2790697674419;117512.441860465;1428.02325581395;82.2093023255814
37064;2023;2;2;0;100;0;35750;449;77.5
37065;2023;5;5;0;100;0;136500;1282.6;95.2
37066;2023;6;6;0;100;0;133750;1525.83333333333;90.5
37067;2023;11;11;0;100;0;164192;2362.72727272727;73.4545454545455
37068;2023;10;10;0;100;0;115930;1580.9;86.9
37069;2023;5;5;0;100;0;147300;2087.8;74
37070;2023;4;4;0;100;0;219514;2478;92.5
37072;2023;125;93;32;74.4;25.6;167257.68;1821.592;90.088
37073;2023;13;13;0;100;0;177343.307692308;1808.92307692308;105.153846153846
37074;2023;26;26;0;100;0;152322.115384615;1679.69230769231;92.6153846153846
37075;2023;9;9;0;100;0;233444.444444444;2476.33333333333;103.888888888889
37076;2023;4;4;0;100;0;132500;2135.75;64.25
37077;2023;44;43;1;97.7272727272727;2.27272727272727;233462;2213.68181818182;106.545454545455
37078;2023;4;4;0;100;0;114750;1522.5;76.75
37079;2023;25;25;0;100;0;190111.4;2276.56;82.72
37080;2023;3;3;0;100;0;137833.333333333;1665;83.3333333333333
37081;2023;23;23;0;100;0;172976.347826087;1970.82608695652;89.8695652173913
37082;2023;5;5;0;100;0;140580;1461.6;90
37083;2023;27;24;3;88.8888888888889;11.1111111111111;201544.925925926;2177.22222222222;89.7037037037037
37084;2023;3;3;0;100;0;143333.333333333;1759.33333333333;84
37085;2023;12;12;0;100;0;237058.333333333;2283.33333333333;122.833333333333
37086;2023;4;4;0;100;0;128737.5;1753.5;75.5
37087;2023;3;3;0;100;0;78500;1073;69
37088;2023;1;1;0;100;0;156000;2080;75
37089;2023;9;9;0;100;0;237673.888888889;2316.77777777778;95.4444444444444
37090;2023;2;2;0;100;0;160000;1310.5;97.5
37091;2023;24;23;1;95.8333333333333;4.16666666666667;196987.916666667;2034.91666666667;102.375
37092;2023;7;7;0;100;0;221312.714285714;2186.57142857143;105.571428571429
37093;2023;8;8;0;100;0;151903.875;1388;107.875
37094;2023;10;10;0;100;0;93686.6;1256.6;78.6
37095;2023;5;5;0;100;0;187340;1898.8;103.4
37096;2023;6;6;0;100;0;151750;2431.5;65.6666666666667
37097;2023;8;8;0;100;0;208500;2408.25;101.625
37098;2023;5;5;0;100;0;181400;1874.6;93.2
37099;2023;6;6;0;100;0;274203.333333333;2420.83333333333;114.166666666667
37100;2023;8;8;0;100;0;216813.75;2091.75;106.75
37101;2023;4;4;0;100;0;263750;1294.5;147.75
37103;2023;5;5;0;100;0;166404;1486;111
37104;2023;53;52;1;98.1132075471698;1.88679245283019;266284.075471698;2694.45283018868;101.169811320755
37105;2023;7;7;0;100;0;134784;1126.85714285714;119
37106;2023;7;7;0;100;0;150892.857142857;1386.14285714286;103.857142857143
37107;2023;5;5;0;100;0;59980;774.2;83.8
37108;2023;2;2;0;100;0;305000;2201.5;146
37109;2023;99;89;10;89.8989898989899;10.1010101010101;366038.676767677;3236.55555555556;115.40404040404
37110;2023;14;14;0;100;0;257835.714285714;2150.21428571429;112.142857142857
37111;2023;20;20;0;100;0;193835;1798.75;118.6
37112;2023;9;9;0;100;0;122726.444444444;1311.22222222222;97.3333333333333
37113;2023;12;12;0;100;0;104950;1057.58333333333;93.5
37114;2023;7;7;0;100;0;89857.1428571429;942;96.2857142857143
37115;2023;62;58;4;93.5483870967742;6.45161290322581;96280.0483870968;1207.08064516129;80.0322580645161
37116;2023;5;5;0;100;0;122402;1456.4;86
37117;2023;8;8;0;100;0;136002.5;1393.5;97.875
37118;2023;19;19;0;100;0;179460.526315789;1852.15789473684;102.842105263158
37119;2023;17;16;1;94.1176470588235;5.88235294117647;129476.470588235;1305.82352941176;104.882352941176
37122;2023;463;212;251;45.7883369330454;54.2116630669546;172485.401727862;2384.16198704104;72.4859611231102
37123;2023;55;55;0;100;0;221295.290909091;2200.21818181818;102.818181818182
37124;2023;27;27;0;100;0;287200.777777778;2794.48148148148;108.37037037037
37125;2023;9;9;0;100;0;190643;1869.22222222222;101.555555555556
37126;2023;1;1;0;100;0;130000;897;145
37127;2023;1;1;0;100;0;160000;1569;102
37128;2023;11;11;0;100;0;168808.181818182;1891.81818181818;90.1818181818182
37129;2023;12;12;0;100;0;194197.916666667;1702.25;109.833333333333
37130;2023;36;35;1;97.2222222222222;2.77777777777778;124942.5;1210.94444444444;102.5
37131;2023;19;19;0;100;0;170184.473684211;2032.42105263158;87.6842105263158
37132;2023;88;64;24;72.7272727272727;27.2727272727273;170232.136363636;2144.07954545455;83.2954545454545
37133;2023;8;7;1;87.5;12.5;73437.5;896.75;78.125
37134;2023;4;4;0;100;0;211000;1885.75;114
37136;2023;6;6;0;100;0;252516.666666667;1884.5;134.666666666667
37137;2023;2;2;0;100;0;66800;506.5;132
37138;2023;11;11;0;100;0;190385.636363636;1857.63636363636;100.727272727273
37139;2023;37;36;1;97.2972972972973;2.7027027027027;230888.027027027;2636.16216216216;89.6216216216216
37140;2023;1;1;0;100;0;155000;1192;130
37141;2023;11;11;0;100;0;184818.181818182;1867.27272727273;98.0909090909091
37142;2023;4;4;0;100;0;128230;1475;88.75
37143;2023;19;19;0;100;0;165697.368421053;1505.78947368421;118.210526315789
37144;2023;9;9;0;100;0;144155.555555556;1750.55555555556;86.7777777777778
37145;2023;3;3;0;100;0;158800;1816.33333333333;87.6666666666667
37146;2023;2;2;0;100;0;92500;1025;92
37147;2023;5;5;0;100;0;177600;1674.8;108.6
37148;2023;7;7;0;100;0;113828.571428571;1294;91.4285714285714
37149;2023;6;6;0;100;0;177166.666666667;1459;124.166666666667
37150;2023;10;10;0;100;0;257720;2157.7;117.7
37151;2023;34;30;4;88.2352941176471;11.7647058823529;364852.382352941;3301.29411764706;110.911764705882
37152;2023;16;16;0;100;0;326545.5;2886.375;118
37153;2023;52;50;2;96.1538461538462;3.84615384615385;252663.846153846;2372.38461538462;108.923076923077
37154;2023;53;51;2;96.2264150943396;3.77358490566038;261149.320754717;2777.81132075472;96.811320754717
37155;2023;7;7;0;100;0;167667.571428571;1473.28571428571;117.285714285714
37156;2023;109;98;11;89.9082568807339;10.0917431192661;249381.95412844;2590.14678899083;97.4954128440367
37157;2023;6;6;0;100;0;95750;1318.16666666667;74
37158;2023;7;7;0;100;0;191496.571428571;1895.85714285714;102.571428571429
37159;2023;85;78;7;91.7647058823529;8.23529411764706;246762.941176471;2591.91764705882;96.5294117647059
37160;2023;8;8;0;100;0;163857.125;1655.25;102.75
37161;2023;11;11;0;100;0;223692.818181818;2339.36363636364;96.4545454545455
37162;2023;4;4;0;100;0;196000;2048;105.75
37163;2023;29;29;0;100;0;183707.310344828;2543.93103448276;83.6206896551724
37165;2023;5;5;0;100;0;218008;1328.8;133
37166;2023;8;8;0;100;0;233580.75;1886.625;128.25
37167;2023;16;15;1;93.75;6.25;174492.8125;1865.125;98.1875
37168;2023;3;3;0;100;0;56801.3333333333;951.666666666667;59.3333333333333
37169;2023;13;13;0;100;0;173538.461538462;1725.07692307692;102.461538461538
37170;2023;18;18;0;100;0;205749.555555556;1936.33333333333;106.777777777778
37171;2023;14;14;0;100;0;217692.857142857;2773.21428571429;96.6428571428571
37172;2023;34;30;4;88.2352941176471;11.7647058823529;239497.705882353;2578.38235294118;98.0294117647059
37173;2023;10;10;0;100;0;97573.8;1025.7;104
37174;2023;8;8;0;100;0;113912.5;1561.625;71.875
37175;2023;11;11;0;100;0;296547.454545455;2362.90909090909;126.545454545455
37176;2023;8;8;0;100;0;160324.375;1673.375;103.125
37177;2023;9;9;0;100;0;99533.3333333333;1148.88888888889;90.1111111111111
37178;2023;10;10;0;100;0;117700;1764.5;70
37179;2023;17;17;0;100;0;323581.764705882;3022.76470588235;110.588235294118
37180;2023;4;4;0;100;0;135739.25;1212.5;130.25
37181;2023;3;3;0;100;0;106193.333333333;1162;105.666666666667
37182;2023;17;17;0;100;0;233853.058823529;2666.05882352941;92
37183;2023;17;17;0;100;0;210148.764705882;1741.29411764706;118.352941176471
37184;2023;6;6;0;100;0;66094.6666666667;875.666666666667;82.3333333333333
37185;2023;12;11;1;91.6666666666667;8.33333333333333;246826.666666667;2587.25;94.0833333333333
37186;2023;11;11;0;100;0;281144.909090909;2375.18181818182;117.909090909091
37187;2023;3;3;0;100;0;135333.333333333;1652.66666666667;82.3333333333333
37188;2023;12;12;0;100;0;126931.666666667;1659.41666666667;76.1666666666667
37189;2023;14;14;0;100;0;48739.3571428571;780.642857142857;61.6428571428571
37190;2023;2;2;0;100;0;70320;643.5;108
37191;2023;3;3;0;100;0;106318;1112.66666666667;96
37192;2023;19;19;0;100;0;186860.684210526;1956.73684210526;96.3684210526316
37193;2023;14;14;0;100;0;164889.357142857;1784.42857142857;103.142857142857
37194;2023;22;22;0;100;0;208816.363636364;2150.68181818182;100.363636363636
37195;2023;142;42;100;29.5774647887324;70.4225352112676;181841.246478873;3070.92253521127;62.1760563380282
37196;2023;25;22;3;88;12;123034.68;1360.36;94.92
37197;2023;5;5;0;100;0;190956.6;1761.4;107.4
37198;2023;9;9;0;100;0;166000;1299.88888888889;125.888888888889
37199;2023;4;4;0;100;0;141463;1569.5;93.25
37200;2023;16;16;0;100;0;166537.5;1721.5;95.9375
37201;2023;10;10;0;100;0;181960;1624.5;115.9
37202;2023;6;6;0;100;0;286501.333333333;2408.66666666667;114.166666666667
37203;2023;37;34;3;91.8918918918919;8.10810810810811;300771.567567568;3093.32432432432;104.054054054054
37204;2023;11;11;0;100;0;236227.272727273;2255.09090909091;108.181818181818
37205;2023;17;17;0;100;0;275747.058823529;2849.94117647059;97.1764705882353
37206;2023;27;24;3;88.8888888888889;11.1111111111111;251145.481481481;2536.74074074074;100.962962962963
37207;2023;3;3;0;100;0;143333.333333333;1667;83.3333333333333
37208;2023;179;125;54;69.8324022346369;30.1675977653631;307030.089385475;3100.3687150838;100.519553072626
37210;2023;3;3;0;100;0;176539;2089.66666666667;83.3333333333333
37211;2023;34;34;0;100;0;221860.294117647;2122.35294117647;106.411764705882
37212;2023;12;12;0;100;0;123670.833333333;1466.58333333333;87.25
37213;2023;6;6;0;100;0;113066.666666667;1543.66666666667;79.8333333333333
37214;2023;235;118;117;50.2127659574468;49.7872340425532;314940.489361702;3397.62553191489;89.7489361702128
37216;2023;14;14;0;100;0;231649.642857143;1782.92857142857;130
37217;2023;24;24;0;100;0;203211.416666667;2087.83333333333;97.375
37218;2023;10;10;0;100;0;78815;1009.4;84.4
37219;2023;7;7;0;100;0;302992.857142857;2307.42857142857;132
37220;2023;5;5;0;100;0;122800;1440.4;95
37221;2023;7;7;0;100;0;115915.714285714;1602.14285714286;74.5714285714286
37222;2023;9;9;0;100;0;185775.555555556;1868.44444444444;94.8888888888889
37223;2023;4;4;0;100;0;137050;1606;86
37224;2023;14;14;0;100;0;184375.714285714;1990.57142857143;99.1428571428571
37225;2023;34;34;0;100;0;220713.529411765;2295.08823529412;97.9411764705882
37226;2023;61;60;1;98.3606557377049;1.63934426229508;149040.163934426;1778.13114754098;91.1967213114754
37228;2023;10;10;0;100;0;162612.4;1566.9;98.1
37229;2023;3;3;0;100;0;170150;1705.33333333333;101.333333333333
37230;2023;8;8;0;100;0;227887.5;2603.5;95.625
37231;2023;21;18;3;85.7142857142857;14.2857142857143;130158.238095238;1597.14285714286;80.7142857142857
37232;2023;30;30;0;100;0;172820;1702.1;107
37233;2023;135;72;63;53.3333333333333;46.6666666666667;177199.814814815;2312.03703703704;78.437037037037
37234;2023;3;3;0;100;0;152200;1879;93.3333333333333
37236;2023;3;3;0;100;0;240666.666666667;1739.66666666667;138.666666666667
37237;2023;8;7;1;87.5;12.5;232397.875;2145.625;107.75
37238;2023;5;5;0;100;0;113100;1228.8;93
37240;2023;5;5;0;100;0;189394;1907.2;103
37241;2023;16;16;0;100;0;156337.5;1949.3125;78.9375
37242;2023;26;26;0;100;0;155280.615384615;1580.53846153846;99.4230769230769
37243;2023;28;28;0;100;0;291345.535714286;2752.82142857143;108.607142857143
37244;2023;2;2;0;100;0;135500;1495.5;96.5
37245;2023;14;14;0;100;0;224075.928571429;2209.5;104.714285714286
37246;2023;2;2;0;100;0;78350;793.5;98
37247;2023;9;9;0;100;0;142188.888888889;1456.77777777778;98.4444444444444
37248;2023;3;3;0;100;0;147000;1707;83.3333333333333
37249;2023;12;12;0;100;0;224322.916666667;2276.33333333333;108.083333333333
37250;2023;27;26;1;96.2962962962963;3.7037037037037;234102.185185185;2614.66666666667;94.2962962962963
37251;2023;13;13;0;100;0;180573;1814.53846153846;95.8461538461538
37252;2023;2;2;0;100;0;85000;1752.5;47.5
37253;2023;3;3;0;100;0;203333.333333333;2089.66666666667;100.666666666667
37254;2023;13;13;0;100;0;172615.615384615;2199.07692307692;87.6153846153846
37255;2023;1;1;0;100;0;85000;3036;28
37256;2023;2;2;0;100;0;76500;867.5;88
37257;2023;12;11;1;91.6666666666667;8.33333333333333;180558.083333333;1945.66666666667;97.5
37258;2023;3;3;0;100;0;230940;2016.33333333333;118
37259;2023;7;7;0;100;0;87071.4285714286;865.714285714286;98.5714285714286
37260;2023;12;12;0;100;0;142816.666666667;1443.25;98.5
37261;2023;2056;504;1552;24.5136186770428;75.4863813229572;203256.916828794;3166.69503891051;64.738326848249
37262;2023;4;4;0;100;0;619237.5;3144.75;178.25
37263;2023;21;21;0;100;0;203389.714285714;2180.90476190476;92.0952380952381
37264;2023;11;11;0;100;0;231356.363636364;2896.09090909091;88.2727272727273
37265;2023;3;3;0;100;0;180078.333333333;1263.66666666667;142.333333333333
37266;2023;68;64;4;94.1176470588235;5.88235294117647;287184.691176471;2896.61764705882;102.602941176471
37267;2023;41;41;0;100;0;290548.853658537;2638.9756097561;112
37268;2023;2;2;0;100;0;74500;935;81
37269;2023;7;7;0;100;0;121800;1488.85714285714;84
37270;2023;21;21;0;100;0;226801.428571429;2631.80952380952;87.1904761904762
37271;2023;9;9;0;100;0;158498.888888889;1754.77777777778;91.3333333333333
37272;2023;13;13;0;100;0;198950;2317.15384615385;89.3076923076923
37273;2023;54;47;7;87.037037037037;12.962962962963;219901.037037037;2502.98148148148;91.6481481481482
37274;2023;6;6;0;100;0;144884.666666667;1356.33333333333;117.333333333333
37275;2023;4;4;0;100;0;94310.25;1068;87.75
37276;2023;10;10;0;100;0;199462.6;2203.4;92
37277;2023;12;12;0;100;0;97762.5;1249;77.5
37278;2023;17;16;1;94.1176470588235;5.88235294117647;174055.882352941;2158.23529411765;79.7647058823529
37279;2023;7;7;0;100;0;126841.142857143;1514.85714285714;77.8571428571429
37280;2023;3;3;0;100;0;62773.3333333333;1061;61
37281;2023;39;35;4;89.7435897435898;10.2564102564103;251228.205128205;2848.89743589744;91.2820512820513
37282;2023;28;28;0;100;0;88995.3571428571;1196.71428571429;78.6071428571429
38001;2023;77;62;15;80.5194805194805;19.4805194805195;211504.597402597;2413;88.1558441558442
38002;2023;48;5;43;10.4166666666667;89.5833333333333;137214.479166667;3388.02083333333;43.0833333333333
38003;2023;8;8;0;100;0;263600;2466.75;103.125
38004;2023;17;10;7;58.8235294117647;41.1764705882353;176821.176470588;1830.17647058824;93.8823529411765
38005;2023;13;5;8;38.4615384615385;61.5384615384615;131113.076923077;2719.38461538462;50.6923076923077
38006;2023;51;14;37;27.4509803921569;72.5490196078431;155954.431372549;2246.82352941176;65.9803921568627
38009;2023;4;4;0;100;0;326512.5;2649.5;119.75
38010;2023;2;2;0;100;0;346325;4054;85.5
38011;2023;9;6;3;66.6666666666667;33.3333333333333;305736.666666667;3505.33333333333;89.4444444444444
38012;2023;38;27;11;71.0526315789474;28.9473684210526;193208;2308.21052631579;84.1578947368421
38013;2023;45;40;5;88.8888888888889;11.1111111111111;289916.2;2906.22222222222;103.733333333333
38015;2023;14;12;2;85.7142857142857;14.2857142857143;277600;2752.35714285714;102.142857142857
38017;2023;12;12;0;100;0;353250;3386.08333333333;107.333333333333
38018;2023;1;1;0;100;0;274295;2588;106
38019;2023;19;15;4;78.9473684210526;21.0526315789474;216464.473684211;2626.94736842105;84.4210526315789
38020;2023;23;1;22;4.34782608695652;95.6521739130435;119961.304347826;3643.95652173913;33.5652173913044
38022;2023;85;66;19;77.6470588235294;22.3529411764706;195007.494117647;2246.49411764706;90.3411764705882
38023;2023;1;1;0;100;0;348401;2639;132
38026;2023;12;10;2;83.3333333333333;16.6666666666667;215331.666666667;2293.75;92.1666666666667
38027;2023;17;17;0;100;0;314181.470588235;2876.05882352941;107.235294117647
38029;2023;20;18;2;90;10;230125.8;2380.6;98.15
38030;2023;9;7;2;77.7777777777778;22.2222222222222;248526.666666667;2616.44444444444;93
38031;2023;1;1;0;100;0;216000;4154;52
38032;2023;1;1;0;100;0;135000;1800;75
38033;2023;2;2;0;100;0;267550;1941;134.5
38034;2023;63;43;20;68.2539682539683;31.7460317460317;177223.603174603;2017.25396825397;87.4444444444444
38035;2023;15;15;0;100;0;217316.666666667;2101.13333333333;113.333333333333
38036;2023;1;1;0;100;0;365420;3263;112
38037;2023;8;8;0;100;0;291606.25;2587.625;120.625
38038;2023;5;4;1;80;20;219200;2707.4;82.8
38039;2023;20;15;5;75;25;453701;4454.25;108
38040;2023;2;2;0;100;0;184675;3284.5;56.5
38041;2023;2;2;0;100;0;235300;1796;140
38042;2023;7;7;0;100;0;218771.428571429;2407.57142857143;98.5714285714286
38043;2023;13;11;2;84.6153846153846;15.3846153846154;317793.769230769;3061.23076923077;104.307692307692
38044;2023;15;14;1;93.3333333333333;6.66666666666667;251546.4;2514.33333333333;103.266666666667
38045;2023;11;11;0;100;0;590558.181818182;5388.18181818182;109.636363636364
38046;2023;7;7;0;100;0;193327.857142857;1700.28571428571;117.142857142857
38047;2023;1;1;0;100;0;325000;2708;120
38048;2023;5;5;0;100;0;256965.2;2892.2;92.6
38049;2023;2;2;0;100;0;239000;1929.5;124.5
38050;2023;6;6;0;100;0;190948.333333333;2137.66666666667;101
38051;2023;5;4;1;80;20;170734;2090.8;83.8
38052;2023;37;26;11;70.2702702702703;29.7297297297297;253757.972972973;3092.13513513513;84.5135135135135
38053;2023;356;107;249;30.0561797752809;69.9438202247191;200228.792134831;2785.56460674157;73.8174157303371
38054;2023;16;16;0;100;0;184868.9375;2129.375;93.1875
38055;2023;9;9;0;100;0;212602.777777778;2263.33333333333;97.8888888888889
38056;2023;2;2;0;100;0;283900;1916.5;147.5
38057;2023;4;2;2;50;50;409021.25;3645;105.5
38058;2023;17;16;1;94.1176470588235;5.88235294117647;294082.352941176;2525.94117647059;124.352941176471
38059;2023;12;9;3;75;25;481307.583333333;3682.66666666667;130.583333333333
38061;2023;33;19;14;57.5757575757576;42.4242424242424;258208.181818182;2888.93939393939;87.6363636363636
38062;2023;5;5;0;100;0;326218;2693;128.4
38063;2023;5;4;1;80;20;321596;3267.6;118
38064;2023;21;20;1;95.2380952380952;4.76190476190476;304869.523809524;3100.57142857143;101.52380952381
38065;2023;21;19;2;90.4761904761905;9.52380952380952;252321.619047619;2174.19047619048;118.714285714286
38067;2023;9;8;1;88.8888888888889;11.1111111111111;303001.555555556;3279.77777777778;95.8888888888889
38068;2023;12;10;2;83.3333333333333;16.6666666666667;540945.833333333;4388.58333333333;125.166666666667
38069;2023;20;18;2;90;10;221184.5;2128.2;109.8
38070;2023;14;9;5;64.2857142857143;35.7142857142857;243870.357142857;2731.28571428571;88.2142857142857
38071;2023;28;18;10;64.2857142857143;35.7142857142857;290777.5;3194.46428571429;90.5
38072;2023;20;20;0;100;0;211377.5;1941.8;110.45
38073;2023;4;4;0;100;0;186500;3654.75;102.5
38074;2023;4;4;0;100;0;295945;3424.25;84
38075;2023;25;22;3;88;12;333464.44;3415.52;97.4
38076;2023;15;14;1;93.3333333333333;6.66666666666667;236924.666666667;2499.86666666667;96.8666666666667
38077;2023;10;10;0;100;0;340410;2898.2;121.5
38078;2023;3;3;0;100;0;264666.666666667;1921.66666666667;143
38080;2023;10;10;0;100;0;223642;2086.2;116.3
38081;2023;17;15;2;88.2352941176471;11.7647058823529;273102.058823529;2840.76470588235;101.058823529412
38082;2023;20;13;7;65;35;194434.25;2299.9;83.75
38083;2023;5;4;1;80;20;220900;2420.4;90.4
38084;2023;11;11;0;100;0;305109.818181818;2499.09090909091;120.727272727273
38085;2023;64;53;11;82.8125;17.1875;293175.546875;3152.671875;92.046875
38086;2023;1;1;0;100;0;240000;1463;164
38087;2023;46;32;14;69.5652173913043;30.4347826086957;284442.326086957;3113.67391304348;91.5652173913043
38089;2023;2;2;0;100;0;325650;2087.5;156
38090;2023;4;3;1;75;25;138425;2449.75;50.75
38091;2023;7;7;0;100;0;276831.428571429;2478.71428571429;109.285714285714
38093;2023;5;4;1;80;20;200800;2422;87.2
38094;2023;18;15;3;83.3333333333333;16.6666666666667;218666.666666667;2596.72222222222;84.3333333333333
38095;2023;17;14;3;82.3529411764706;17.6470588235294;285213.705882353;2631.11764705882;107.941176470588
38097;2023;37;31;6;83.7837837837838;16.2162162162162;315448.216216216;3507.45945945946;92.3243243243243
38098;2023;7;7;0;100;0;262703.571428571;2460.28571428571;108.714285714286
38099;2023;5;5;0;100;0;278500;2972.4;97.2
38100;2023;37;15;22;40.5405405405405;59.4594594594595;202509.72972973;2676.45945945946;73.1081081081081
38103;2023;4;3;1;75;25;272715;2946;89.25
38104;2023;12;12;0;100;0;267677.25;2402.16666666667;112.416666666667
38105;2023;21;17;4;80.9523809523809;19.047619047619;262064.047619048;2715.42857142857;97.5714285714286
38106;2023;1;1;0;100;0;40000;769;52
38107;2023;8;8;0;100;0;317778.125;3347.625;95.5
38108;2023;3;2;1;66.6666666666667;33.3333333333333;183333.333333333;1655.33333333333;110.666666666667
38109;2023;6;6;0;100;0;311408.333333333;2570.33333333333;121.666666666667
38110;2023;20;17;3;85;15;333646;3386.7;100.2
38111;2023;63;42;21;66.6666666666667;33.3333333333333;368420.428571429;3817.34920634921;97.2063492063492
38112;2023;2;1;1;50;50;171000;2361.5;70.5
38113;2023;4;4;0;100;0;162235.25;1733.75;82
38114;2023;9;9;0;100;0;293193.333333333;2565.33333333333;115.888888888889
38115;2023;2;2;0;100;0;245500;3126.5;80.5
38117;2023;4;4;0;100;0;191206.25;1910.25;107
38118;2023;14;14;0;100;0;228277.857142857;2627.64285714286;89.0714285714286
38120;2023;2;2;0;100;0;383750;3985.5;97.5
38124;2023;33;25;8;75.7575757575758;24.2424242424242;229677.575757576;2369.90909090909;96.6666666666667
38126;2023;26;14;12;53.8461538461538;46.1538461538462;519455.846153846;5039.88461538462;112.923076923077
38128;2023;11;11;0;100;0;107909.090909091;1724.09090909091;72.1818181818182
38129;2023;14;4;10;28.5714285714286;71.4285714285714;266130.357142857;4970.35714285714;45.9285714285714
38130;2023;57;28;29;49.1228070175439;50.8771929824561;174954.614035088;2101.68421052632;83.4385964912281
38131;2023;12;12;0;100;0;297458.333333333;2395.25;124.083333333333
38132;2023;1;1;0;100;0;211830;2118;100
38133;2023;40;29;11;72.5;27.5;352789.725;3680.45;97.625
38134;2023;5;4;1;80;20;214200;2611.4;94.6
38135;2023;15;15;0;100;0;282270;2446.66666666667;116.333333333333
38136;2023;4;4;0;100;0;255225;2635.5;98
38137;2023;2;2;0;100;0;358105;2341;157
38138;2023;44;17;27;38.6363636363636;61.3636363636364;204219.886363636;2983.59090909091;67.5
38139;2023;13;13;0;100;0;300956.923076923;2174.92307692308;136.769230769231
38140;2023;55;26;29;47.2727272727273;52.7272727272727;339670.490909091;3830.58181818182;89.6363636363636
38141;2023;8;8;0;100;0;345956.25;2720.75;125.75
38144;2023;22;21;1;95.4545454545455;4.54545454545455;378654.318181818;4088.22727272727;98.8181818181818
38146;2023;7;7;0;100;0;366665.714285714;3267.71428571429;114.142857142857
38147;2023;9;8;1;88.8888888888889;11.1111111111111;229521.111111111;2436.22222222222;95.6666666666667
38148;2023;29;27;2;93.1034482758621;6.89655172413793;263292.310344828;2569.86206896552;107.275862068966
38149;2023;19;14;5;73.6842105263158;26.3157894736842;271526.842105263;2894.89473684211;96.9473684210526
38150;2023;72;27;45;37.5;62.5;230626.805555556;3035.16666666667;75.5
38151;2023;297;37;260;12.4579124579125;87.5420875420875;157742.707070707;2182.23905723906;72.3367003367003
38152;2023;6;6;0;100;0;249583.333333333;2534.16666666667;103.666666666667
38153;2023;3;3;0;100;0;447126;2994;150.333333333333
38154;2023;4;4;0;100;0;109250;1867;81.25
38155;2023;25;17;8;68;32;186846.32;2166.64;86.48
38156;2023;5;2;3;40;60;129500;2415.2;65
38157;2023;23;20;3;86.9565217391304;13.0434782608696;317283;2891.08695652174;113.391304347826
38158;2023;105;18;87;17.1428571428571;82.8571428571429;229115.980952381;3045.4;75.4380952380952
38159;2023;5;3;2;60;40;202400;1870.8;116
38160;2023;15;12;3;80;20;267992.933333333;2665.53333333333;107.666666666667
38161;2023;14;13;1;92.8571428571429;7.14285714285714;259743.571428571;2315.92857142857;114.714285714286
38162;2023;7;7;0;100;0;272952.285714286;2618;108
38163;2023;15;4;11;26.6666666666667;73.3333333333333;119857.8;2243.26666666667;52.9333333333333
38166;2023;2;1;1;50;50;326250;3376;97.5
38167;2023;7;7;0;100;0;233667.142857143;2400.42857142857;94
38169;2023;240;34;206;14.1666666666667;85.8333333333333;157518.945833333;2324.55416666667;67.1625
38170;2023;35;9;26;25.7142857142857;74.2857142857143;258445;3269.4;76.8285714285714
38171;2023;1;1;0;100;0;137350;2113;65
38172;2023;12;6;6;50;50;233475;3068.08333333333;78.9166666666667
38173;2023;2;2;0;100;0;180000;2486;71
38174;2023;5;5;0;100;0;197070;2008.6;101.2
38175;2023;39;13;26;33.3333333333333;66.6666666666667;233954;2950.17948717949;77.2051282051282
38176;2023;14;14;0;100;0;352546.857142857;3480.28571428571;105.357142857143
38177;2023;2;1;1;50;50;169629.5;1883.5;92.5
38179;2023;91;23;68;25.2747252747253;74.7252747252747;236678.164835165;3577.97802197802;65.989010989011
38180;2023;10;8;2;80;20;232030;2047.2;120.4
38181;2023;14;9;5;64.2857142857143;35.7142857142857;254794.285714286;3048.42857142857;85
38182;2023;34;27;7;79.4117647058823;20.5882352941176;196256.911764706;2124.91176470588;94.4705882352941
38183;2023;2;2;0;100;0;252000;2499;100.5
38184;2023;13;12;1;92.3076923076923;7.69230769230769;319640;4082.46153846154;94
38185;2023;2252;70;2182;3.10834813499112;96.8916518650089;170733.363232682;2779.89431616341;62.8805506216696
38186;2023;18;4;14;22.2222222222222;77.7777777777778;115817.777777778;2834.83333333333;43.1666666666667
38187;2023;20;12;8;60;40;153548.75;2202.7;60.45
38188;2023;9;8;1;88.8888888888889;11.1111111111111;665504.444444444;4464.55555555556;150.222222222222
38189;2023;60;46;14;76.6666666666667;23.3333333333333;316264.383333333;3752.58333333333;86.0666666666667
38190;2023;11;10;1;90.9090909090909;9.09090909090909;272210;2978.63636363636;98.8181818181818
38191;2023;170;3;167;1.76470588235294;98.2352941176471;237019.070588235;6792.30588235294;33.9529411764706
38192;2023;1;1;0;100;0;412856;6352;65
38193;2023;156;81;75;51.9230769230769;48.0769230769231;223322.711538462;2660.15384615385;85.7564102564103
38194;2023;28;22;6;78.5714285714286;21.4285714285714;209732.857142857;2253.10714285714;94.7857142857143
38195;2023;7;5;2;71.4285714285714;28.5714285714286;216242.857142857;2360.42857142857;92.2857142857143
38197;2023;16;10;6;62.5;37.5;318757.5;3771.5;85
38198;2023;11;9;2;81.8181818181818;18.1818181818182;192160;1791.81818181818;108.909090909091
38199;2023;7;6;1;85.7142857142857;14.2857142857143;360757.142857143;3396.85714285714;106.428571428571
38200;2023;17;12;5;70.5882352941177;29.4117647058824;362555.764705882;3599.47058823529;97.2352941176471
38203;2023;8;5;3;62.5;37.5;178749.5;2214.75;80.875
38204;2023;4;4;0;100;0;232827.5;4039.25;80.5
38205;2023;34;10;24;29.4117647058824;70.5882352941177;223869.705882353;3931.58823529412;51.9117647058824
38206;2023;6;6;0;100;0;335453.333333333;3042.5;107.666666666667
38207;2023;5;5;0;100;0;155592;1811;80.6
38208;2023;3;3;0;100;0;186370;1903.33333333333;117.666666666667
38209;2023;2;2;0;100;0;90000;2452;78.5
38210;2023;2;2;0;100;0;481813.5;3242;151.5
38211;2023;3;3;0;100;0;237450;2168.66666666667;119
38212;2023;15;13;2;86.6666666666667;13.3333333333333;129585.333333333;1580.26666666667;83.3333333333333
38213;2023;8;8;0;100;0;213808.75;1732.375;126.25
38214;2023;14;7;7;50;50;276373.571428571;3045.92857142857;86.3571428571429
38215;2023;14;10;4;71.4285714285714;28.5714285714286;420110.714285714;4155.92857142857;109.357142857143
38216;2023;2;2;0;100;0;197500;3485.5;64.5
38218;2023;17;17;0;100;0;221382.058823529;1862.17647058824;122.235294117647
38219;2023;1;1;0;100;0;85000;1977;43
38222;2023;4;4;0;100;0;163975;2873.25;59.5
38223;2023;9;9;0;100;0;380911.111111111;2612.77777777778;141.222222222222
38224;2023;2;2;0;100;0;184500;1649;114.5
38225;2023;39;11;28;28.2051282051282;71.7948717948718;253274.333333333;4072.82051282051;61.6923076923077
38226;2023;11;11;0;100;0;197300;2285.54545454545;87.9090909090909
38228;2023;7;7;0;100;0;234843.857142857;2917.28571428571;89.5714285714286
38229;2023;210;35;175;16.6666666666667;83.3333333333333;325474.238095238;3850.18095238095;83.5666666666667
38230;2023;12;11;1;91.6666666666667;8.33333333333333;369960;3539.33333333333;110.833333333333
38231;2023;9;9;0;100;0;218333.333333333;2154.22222222222;108.666666666667
38232;2023;3;3;0;100;0;171666.666666667;2708.66666666667;83.3333333333333
38236;2023;12;11;1;91.6666666666667;8.33333333333333;260367.5;2712.41666666667;105
38237;2023;3;2;1;66.6666666666667;33.3333333333333;302000;4744.66666666667;56.6666666666667
38238;2023;15;14;1;93.3333333333333;6.66666666666667;277298.066666667;2774.8;101.4
38239;2023;67;42;25;62.6865671641791;37.3134328358209;234616.537313433;2379.46268656716;101.402985074627
38240;2023;5;5;0;100;0;263860;2636;101
38242;2023;8;5;3;62.5;37.5;121100;1442.25;81.25
38243;2023;3;2;1;66.6666666666667;33.3333333333333;210983.333333333;2103;100
38244;2023;3;3;0;100;0;233333.333333333;2291.66666666667;103.333333333333
38245;2023;3;3;0;100;0;257750;2758;95
38246;2023;7;7;0;100;0;260894.285714286;2339.57142857143;110.285714285714
38247;2023;34;27;7;79.4117647058823;20.5882352941176;153469.411764706;2264.55882352941;72.8823529411765
38248;2023;3;3;0;100;0;234933.333333333;3140;79.6666666666667
38249;2023;45;18;27;40;60;422725.711111111;4398.53333333333;98.2888888888889
38250;2023;4;4;0;100;0;200980.5;2253;88.5
38252;2023;2;2;0;100;0;671600;4107;162.5
38253;2023;212;12;200;5.66037735849057;94.3396226415094;186059.787735849;5164.17452830189;36.0471698113208
38254;2023;7;7;0;100;0;151935;1826.85714285714;83
38256;2023;24;22;2;91.6666666666667;8.33333333333333;275192.875;2737.54166666667;101.5
38257;2023;2;2;0;100;0;137000;1523.5;91.5
38259;2023;6;6;0;100;0;244000;2329;104.333333333333
38260;2023;1;1;0;100;0;341000;3875;88
38261;2023;56;36;20;64.2857142857143;35.7142857142857;206509;2411.85714285714;87.0535714285714
38263;2023;3;3;0;100;0;349633.333333333;3370.66666666667;104
38264;2023;15;3;12;20;80;82897.3333333333;2446.2;34.7333333333333
38265;2023;18;12;6;66.6666666666667;33.3333333333333;149543.277777778;2093.33333333333;74.3333333333333
38266;2023;7;6;1;85.7142857142857;14.2857142857143;131017.857142857;1614.57142857143;78.2857142857143
38267;2023;6;6;0;100;0;218949.166666667;2169.83333333333;123.5
38268;2023;3;3;0;100;0;375943.333333333;2917.66666666667;121.333333333333
38269;2023;46;18;28;39.1304347826087;60.8695652173913;139648.782608696;1747.30434782609;78.5869565217391
38270;2023;14;9;5;64.2857142857143;35.7142857142857;276824.285714286;2725.5;98.9285714285714
38271;2023;6;4;2;66.6666666666667;33.3333333333333;373150;4189;93.3333333333333
38272;2023;3;3;0;100;0;242240;2745.33333333333;98
38273;2023;2;2;0;100;0;193332.5;3059.5;87.5
38276;2023;26;22;4;84.6153846153846;15.3846153846154;268307.038461538;2833.92307692308;97.8076923076923
38277;2023;2;1;1;50;50;340900;3007.5;113.5
38278;2023;2;2;0;100;0;379279.5;2795.5;135
38279;2023;8;6;2;75;25;284237.5;3013.625;93.75
38280;2023;1;1;0;100;0;210000;2625;80
38281;2023;25;13;12;52;48;269958;2924.6;90.16
38282;2023;10;10;0;100;0;262808;3318.6;80.2
38284;2023;9;9;0;100;0;266894.444444444;2673.77777777778;98.4444444444444
38285;2023;4;4;0;100;0;149712.5;2215;84
38287;2023;6;5;1;83.3333333333333;16.6666666666667;197880.833333333;2357.33333333333;92.1666666666667
38288;2023;19;19;0;100;0;354813.684210526;3444.26315789474;105.894736842105
38289;2023;18;4;14;22.2222222222222;77.7777777777778;228010.611111111;4588.55555555556;49.9444444444444
38290;2023;10;10;0;100;0;150905;1860.6;98.6
38291;2023;11;11;0;100;0;204968.181818182;2049;106.272727272727
38292;2023;21;20;1;95.2380952380952;4.76190476190476;324970.285714286;2802.80952380952;116.666666666667
38294;2023;6;6;0;100;0;354851.666666667;3198.5;112
38295;2023;6;6;0;100;0;270983.333333333;2537;105.5
38296;2023;7;7;0;100;0;246082.857142857;2570.71428571429;99.7142857142857
38297;2023;18;18;0;100;0;188631.666666667;2325.16666666667;82.4444444444444
38298;2023;76;44;32;57.8947368421053;42.1052631578947;166467.986842105;1929.21052631579;86.3552631578947
38299;2023;1;1;0;100;0;80000;1600;50
38300;2023;2;2;0;100;0;251800;2204.5;116.5
38301;2023;1;1;0;100;0;2,00E+05;2778;72
38303;2023;3;3;0;100;0;286333.333333333;2737;102.333333333333
38304;2023;12;10;2;83.3333333333333;16.6666666666667;211809.166666667;2121.83333333333;97.8333333333333
38307;2023;2;2;0;100;0;319250;2149;148
38308;2023;1;1;0;100;0;219000;1991;110
38309;2023;15;7;8;46.6666666666667;53.3333333333333;286862;3320.2;87.4
38310;2023;7;7;0;100;0;304452.857142857;2545;120.285714285714
38311;2023;17;17;0;100;0;196860;1967.64705882353;102.941176470588
38314;2023;64;28;36;43.75;56.25;209681.859375;2862.25;74.3125
38315;2023;51;26;25;50.9803921568627;49.0196078431373;173006.862745098;2090.6862745098;82.7058823529412
38316;2023;62;22;40;35.4838709677419;64.5161290322581;192746.709677419;2691.1935483871;72
38317;2023;141;13;128;9.21985815602837;90.7801418439716;136739.85106383;2000.55319148936;68.7801418439716
38318;2023;52;23;29;44.2307692307692;55.7692307692308;218027.673076923;2518.40384615385;86.5576923076923
38319;2023;10;6;4;60;40;110506;1460.7;78.1
38320;2023;21;20;1;95.2380952380952;4.76190476190476;254268.476190476;2405.09523809524;99
38321;2023;2;2;0;100;0;217500;2620;89.5
38323;2023;14;14;0;100;0;265878.571428571;2627.5;104.142857142857
38324;2023;7;7;0;100;0;278827.142857143;2799;99.7142857142857
38325;2023;3;3;0;100;0;373536.666666667;3655;95.6666666666667
38326;2023;2;2;0;100;0;155710;1641;105
38328;2023;1;1;0;100;0;320000;3077;104
38329;2023;2;2;0;100;0;74150;945.5;79.5
38330;2023;1;1;0;100;0;201100;1350;149
38331;2023;10;9;1;90;10;323222;2558.7;125.3
38332;2023;27;15;12;55.5555555555556;44.4444444444444;194043.37037037;2428.40740740741;81.2962962962963
38333;2023;4;2;2;50;50;159000;1924;81
38334;2023;8;8;0;100;0;396206.25;4573.5;85.625
38335;2023;9;9;0;100;0;218611.111111111;2155.55555555556;106.444444444444
38336;2023;22;21;1;95.4545454545455;4.54545454545455;274693.636363636;2721.59090909091;100.272727272727
38337;2023;81;25;56;30.8641975308642;69.1358024691358;187681.716049383;2406.87654320988;79.6666666666667
38338;2023;7;7;0;100;0;233264.285714286;2313.71428571429;93.4285714285714
38339;2023;9;7;2;77.7777777777778;22.2222222222222;338328.444444444;3215;106.666666666667
38340;2023;17;9;8;52.9411764705882;47.0588235294118;236629.705882353;2828.41176470588;84.1764705882353
38341;2023;5;5;0;100;0;301200;2839.6;109.8
38342;2023;2;2;0;100;0;135445;1415;92.5
38343;2023;8;8;0;100;0;328019.375;2488.625;143.125
38344;2023;107;51;56;47.6635514018692;52.3364485981308;177773.897196262;2063.58878504673;83.9158878504673
38345;2023;5;5;0;100;0;261498;2984.8;93.8
38346;2023;4;4;0;100;0;262062.5;2818;97
38347;2023;9;9;0;100;0;209011.111111111;2744.33333333333;82.5555555555556
38348;2023;41;36;5;87.8048780487805;12.1951219512195;367442.170731707;3355.29268292683;110.512195121951
38349;2023;20;18;2;90;10;240170;2623.4;91.75
38350;2023;2;2;0;100;0;279500;3144;88.5
38351;2023;9;9;0;100;0;280755.777777778;2526.77777777778;119.666666666667
38352;2023;18;17;1;94.4444444444444;5.55555555555556;321971.888888889;3091.44444444444;105.277777777778
38353;2023;5;5;0;100;0;304890;2838.4;107.2
38354;2023;4;4;0;100;0;235172.5;1666.5;134
38355;2023;1;1;0;100;0;416750;3969;105
38356;2023;5;5;0;100;0;326510;2728.6;132.2
38357;2023;29;27;2;93.1034482758621;6.89655172413793;234932.413793103;2349.86206896552;99.3103448275862
38358;2023;5;5;0;100;0;275014;2207.6;141.4
38359;2023;9;9;0;100;0;183234.444444444;1910.33333333333;98.8888888888889
38360;2023;4;4;0;100;0;239337.5;2250.25;110.5
38361;2023;1;1;0;100;0;223250;1583;141
38362;2023;8;7;1;87.5;12.5;307682.5;2888.75;119.25
38363;2023;10;10;0;100;0;232912;2764.9;104.6
38364;2023;5;5;0;100;0;189800;2105.8;88.8
38365;2023;5;5;0;100;0;343900;2751.2;128.6
38366;2023;2;2;0;100;0;185000;1850;100
38368;2023;10;9;1;90;10;275473.2;2725.1;100.1
38369;2023;8;8;0;100;0;283580;2516.125;112.25
38370;2023;4;4;0;100;0;287300;2766.25;110
38372;2023;6;6;0;100;0;186483.333333333;2254.83333333333;83.8333333333333
38373;2023;7;4;3;57.1428571428571;42.8571428571429;252570;2794.42857142857;92.4285714285714
38374;2023;25;23;2;92;8;289381.32;2855.64;101.48
38375;2023;1;1;0;100;0;118000;2458;48
38376;2023;9;9;0;100;0;177442.666666667;2214.55555555556;87.6666666666667
38377;2023;57;40;17;70.1754385964912;29.8245614035088;203666.280701754;2383.66666666667;83.9824561403509
38378;2023;36;30;6;83.3333333333333;16.6666666666667;289533.055555556;2864.77777777778;102.972222222222
38379;2023;3;3;0;100;0;151333.333333333;1389.66666666667;100.666666666667
38380;2023;3;3;0;100;0;165210;1700.33333333333;99.6666666666667
38381;2023;18;18;0;100;0;312844.722222222;2894.27777777778;106.944444444444
38382;2023;162;39;123;24.0740740740741;75.9259259259259;234058.845679012;2919.37654320988;78.1851851851852
38383;2023;23;21;2;91.304347826087;8.69565217391304;303902.347826087;3453.69565217391;87.5217391304348
38384;2023;26;18;8;69.2307692307692;30.7692307692308;239221.692307692;2356.07692307692;106.192307692308
38386;2023;21;18;3;85.7142857142857;14.2857142857143;165913.666666667;1799.90476190476;99.0952380952381
38387;2023;3;1;2;33.3333333333333;66.6666666666667;175990;1990.66666666667;86.6666666666667
38388;2023;13;12;1;92.3076923076923;7.69230769230769;349678.461538462;4818;83.3846153846154
38389;2023;33;26;7;78.7878787878788;21.2121212121212;299947.636363636;2908.90909090909;108.060606060606
38390;2023;7;4;3;57.1428571428571;42.8571428571429;200992.857142857;2270.57142857143;92.2857142857143
38391;2023;2;2;0;100;0;187425;1675.5;105
38392;2023;6;6;0;100;0;196383.333333333;1812.33333333333;107.666666666667
38393;2023;21;20;1;95.2380952380952;4.76190476190476;225479.523809524;2323.95238095238;98.2380952380952
38394;2023;14;12;2;85.7142857142857;14.2857142857143;221996.428571429;2268.28571428571;98.6428571428571
38395;2023;13;13;0;100;0;428929.076923077;3960.53846153846;117.923076923077
38396;2023;7;4;3;57.1428571428571;42.8571428571429;106423.428571429;1565.28571428571;69.1428571428571
38397;2023;54;30;24;55.5555555555556;44.4444444444444;557771.537037037;4887.81481481481;112.240740740741
38398;2023;11;11;0;100;0;226327.272727273;2312.09090909091;101.545454545455
38399;2023;51;39;12;76.4705882352941;23.5294117647059;218656.68627451;2586.62745098039;85.6862745098039
38400;2023;31;27;4;87.0967741935484;12.9032258064516;405078.387096774;3402.25806451613;119.838709677419
38401;2023;18;15;3;83.3333333333333;16.6666666666667;235055.555555556;2607.5;90.3333333333333
38402;2023;4;4;0;100;0;323452.5;2673.25;119
38403;2023;4;4;0;100;0;246750;2135;139
38405;2023;11;10;1;90.9090909090909;9.09090909090909;254602.545454545;2571.09090909091;112.090909090909
38406;2023;2;2;0;100;0;315212.5;2042.5;153
38407;2023;12;12;0;100;0;312823.333333333;3051.75;101
38408;2023;25;23;2;92;8;370943.2;4081.68;95.28
38409;2023;7;7;0;100;0;239605.714285714;2203.85714285714;110
38410;2023;8;6;2;75;25;267437.5;2877.25;110.875
38412;2023;25;20;5;80;20;204310.6;2148.96;91.96
38413;2023;5;5;0;100;0;243950;2511.4;90.2
38415;2023;11;11;0;100;0;310604.545454545;2669.63636363636;116.818181818182
38416;2023;120;43;77;35.8333333333333;64.1666666666667;164950.641666667;2155.175;76.6833333333333
38417;2023;4;4;0;100;0;289800;3574;79.5
38418;2023;2;2;0;100;0;252500;2426.5;94
38420;2023;1;1;0;100;0;117000;1950;60
38421;2023;340;35;305;10.2941176470588;89.7058823529412;168666.438235294;2602.77941176471;65.3441176470588
38422;2023;43;19;24;44.1860465116279;55.8139534883721;391859.813953488;4232.72093023256;92.0697674418605
38423;2023;51;15;36;29.4117647058824;70.5882352941177;234491.137254902;2943.82352941176;76.8235294117647
38424;2023;2;2;0;100;0;89700;1648;57
38425;2023;49;43;6;87.7551020408163;12.2448979591837;226682.591836735;2393.83673469388;93.3673469387755
38426;2023;2;2;0;100;0;199980;2704;72.5
38427;2023;1;1;0;100;0;328200;1954;168
38429;2023;4;4;0;100;0;181250;2446.75;72.25
38430;2023;5;5;0;100;0;224600;2578;82.4
38431;2023;22;14;8;63.6363636363636;36.3636363636364;464795;4417.63636363636;110.954545454545
38432;2023;8;4;4;50;50;226737.5;2051.75;114.875
38433;2023;9;3;6;33.3333333333333;66.6666666666667;252602.222222222;3279.22222222222;79.5555555555556
38434;2023;5;3;2;60;40;223580;2102.4;111.4
38436;2023;14;14;0;100;0;357082.071428571;3496.71428571429;104
38437;2023;1;1;0;100;0;110000;1833;60
38438;2023;2;2;0;100;0;360000;4019;91.5
38439;2023;23;19;4;82.6086956521739;17.3913043478261;199225.652173913;2224.17391304348;89.8260869565217
38440;2023;5;4;1;80;20;206250;2258;94.2
38442;2023;26;9;17;34.6153846153846;65.3846153846154;169869.923076923;3072.73076923077;51.5384615384615
38443;2023;1;1;0;100;0;294650;3311;89
38444;2023;3;3;0;100;0;158333.333333333;1890.66666666667;70.6666666666667
38445;2023;2;2;0;100;0;410555;3946.5;104
38446;2023;8;8;0;100;0;212196.875;2401.25;98.375
38448;2023;13;13;0;100;0;375525.615384615;3442.46153846154;108.461538461538
38449;2023;50;45;5;90;10;272387.22;3032.1;90.28
38450;2023;10;10;0;100;0;311450;2870.5;107.5
38451;2023;25;22;3;88;12;349314.52;3610.24;101.6
38452;2023;5;5;0;100;0;219150;2572.2;87.6
38453;2023;10;9;1;90;10;212725;2251.5;94.3
38454;2023;13;13;0;100;0;248306.153846154;2583.61538461538;95.9230769230769
38455;2023;35;34;1;97.1428571428571;2.85714285714286;369646.942857143;3017.77142857143;124.314285714286
38456;2023;7;7;0;100;0;202828.571428571;2111.42857142857;97.8571428571429
38457;2023;19;15;4;78.9473684210526;21.0526315789474;182094.736842105;2053.05263157895;90.6842105263158
38458;2023;3;3;0;100;0;189383.333333333;1645;126
38459;2023;4;4;0;100;0;306365;5256;105.25
38460;2023;1;0;1;0;100;270000;3000;90
38462;2023;4;4;0;100;0;175875;2007.75;106.5
38463;2023;18;12;6;66.6666666666667;33.3333333333333;209535.555555556;2294.77777777778;91.3888888888889
38464;2023;20;19;1;95;5;213926.45;2272.3;96.8
38465;2023;10;10;0;100;0;278238;2394.9;124.3
38466;2023;10;7;3;70;30;492951;4033.9;124
38467;2023;13;13;0;100;0;288558.461538462;2775.07692307692;107
38468;2023;47;26;21;55.3191489361702;44.6808510638298;189736.553191489;2296.44680851064;82.1063829787234
38469;2023;2;2;0;100;0;260000;2140.5;100
38470;2023;7;6;1;85.7142857142857;14.2857142857143;223155.714285714;2524.71428571429;83.1428571428571
38471;2023;4;3;1;75;25;449823.75;3953.75;110.25
38472;2023;1;1;0;100;0;7,00E+05;5512;127
38473;2023;13;13;0;100;0;241379.692307692;2366.92307692308;106.461538461538
38474;2023;124;35;89;28.2258064516129;71.7741935483871;213177.927419355;2787.45967741935;74.6532258064516
38475;2023;20;19;1;95;5;355401.45;3449.8;106.25
38476;2023;7;7;0;100;0;274714.285714286;2723.57142857143;100
38478;2023;9;9;0;100;0;199838.888888889;2610.33333333333;76.7777777777778
38479;2023;19;18;1;94.7368421052632;5.26315789473684;224764.736842105;2395.42105263158;97.6315789473684
38480;2023;23;20;3;86.9565217391304;13.0434782608696;326842.608695652;3411.65217391304;102.95652173913
38481;2023;10;10;0;100;0;278077.7;3007.3;92.6
38483;2023;18;16;2;88.8888888888889;11.1111111111111;253558;2584.77777777778;101.388888888889
38484;2023;13;11;2;84.6153846153846;15.3846153846154;355599.153846154;3612.30769230769;95.2307692307692
38485;2023;153;27;126;17.6470588235294;82.3529411764706;200065.614379085;2541.35294117647;75.1111111111111
38486;2023;60;24;36;40;60;364814;3766.26666666667;96.4333333333333
38487;2023;23;21;2;91.304347826087;8.69565217391304;385999.130434783;3920.04347826087;99.7391304347826
38488;2023;7;7;0;100;0;257674.428571429;2438.42857142857;106.714285714286
38490;2023;16;15;1;93.75;6.25;235508.125;2483.0625;95.25
38492;2023;3;3;0;100;0;397720;2934.33333333333;134.333333333333
38494;2023;6;6;0;100;0;239773.333333333;2764.66666666667;89.1666666666667
38495;2023;4;3;1;75;25;187880.5;1660;121
38496;2023;7;7;0;100;0;233315.714285714;2129.85714285714;112.857142857143
38498;2023;2;2;0;100;0;2,00E+05;2174;92.5
38499;2023;4;3;1;75;25;209500;2294.75;92
38500;2023;3;3;0;100;0;134736.333333333;1348.33333333333;104
38501;2023;30;14;16;46.6666666666667;53.3333333333333;242438.366666667;3205.73333333333;77.4666666666667
38503;2023;16;10;6;62.5;37.5;270075.625;3298.625;79.1875
38504;2023;9;8;1;88.8888888888889;11.1111111111111;283332.222222222;3098.44444444444;94.2222222222222
38505;2023;11;10;1;90.9090909090909;9.09090909090909;199982.727272727;1843;108.090909090909
38507;2023;85;73;12;85.8823529411765;14.1176470588235;330931;3789.47058823529;91.1764705882353
38508;2023;5;4;1;80;20;263655;2747.6;96.6
38509;2023;91;39;52;42.8571428571429;57.1428571428571;170705.747252747;2340.34065934066;75.5604395604396
38511;2023;31;17;14;54.8387096774194;45.1612903225806;294272.903225806;3573.51612903226;82.7741935483871
38512;2023;6;6;0;100;0;271210;3050;95
38513;2023;2;2;0;100;0;410150;4319;109
38514;2023;3;3;0;100;0;192666.666666667;2014.33333333333;103.666666666667
38515;2023;23;19;4;82.6086956521739;17.3913043478261;279845.565217391;3260.69565217391;90.8695652173913
38516;2023;60;14;46;23.3333333333333;76.6666666666667;366651.366666667;4097.61666666667;82.8666666666667
38517;2023;71;42;29;59.1549295774648;40.8450704225352;204632.85915493;2315.30985915493;87.4225352112676
38518;2023;6;6;0;100;0;85611.6666666667;1213.5;67
38519;2023;19;16;3;84.2105263157895;15.7894736842105;390991.105263158;3253.52631578947;115.052631578947
38520;2023;7;7;0;100;0;297785.714285714;3399.57142857143;86.1428571428571
38522;2023;2;1;1;50;50;85000;1682;58.5
38523;2023;9;9;0;100;0;305715.555555556;2793.44444444444;112.333333333333
38524;2023;45;23;22;51.1111111111111;48.8888888888889;308508.444444444;3564.08888888889;85.3333333333333
38525;2023;4;4;0;100;0;213297.5;2142.25;105.5
38526;2023;3;3;0;100;0;205921.333333333;2301;91
38527;2023;11;5;6;45.4545454545455;54.5454545454545;286487.272727273;5010.18181818182;60.2727272727273
38528;2023;12;12;0;100;0;347613.333333333;3937.5;104
38529;2023;31;16;15;51.6129032258064;48.3870967741936;322366.548387097;3567.45161290323;90.6451612903226
38530;2023;24;18;6;75;25;275574.833333333;2756.20833333333;100.333333333333
38531;2023;3;3;0;100;0;194500;1705.33333333333;134.333333333333
38532;2023;6;5;1;83.3333333333333;16.6666666666667;226135.833333333;3174.66666666667;77.1666666666667
38533;2023;3;3;0;100;0;300842.666666667;2981.33333333333;110
38535;2023;2;2;0;100;0;252500;4164;61
38536;2023;8;7;1;87.5;12.5;352922.5;3208.875;113.375
38537;2023;83;39;44;46.9879518072289;53.0120481927711;221427.626506024;2944.3734939759;76.578313253012
38538;2023;38;19;19;50;50;287903.289473684;3371.86842105263;87.0263157894737
38539;2023;8;8;0;100;0;282633.125;2634.625;103.875
38540;2023;8;8;0;100;0;363362.5;2825.5;128.875
38542;2023;6;6;0;100;0;279041.666666667;3175.33333333333;89.5
38543;2023;18;17;1;94.4444444444444;5.55555555555556;225472.166666667;2058.22222222222;111.777777777778
38544;2023;359;75;284;20.891364902507;79.108635097493;198710.777158774;2614.38997214485;75.4011142061281
38545;2023;47;26;21;55.3191489361702;44.6808510638298;276422.553191489;3397.1914893617;83.2127659574468
38546;2023;10;10;0;100;0;219311;2449.5;91.2
38547;2023;64;20;44;31.25;68.75;206769.296875;2878.515625;73.9375
38548;2023;166;18;148;10.8433734939759;89.1566265060241;179113.608433735;3805.63253012048;46.4819277108434
38550;2023;2;2;0;100;0;450000;7516;99
38551;2023;1;1;0;100;0;95000;2209;43
38552;2023;3;2;1;66.6666666666667;33.3333333333333;145290;1942;68.3333333333333
38553;2023;123;97;26;78.8617886178862;21.1382113821138;237637.130081301;2631.66666666667;91.2113821138211
38554;2023;11;9;2;81.8181818181818;18.1818181818182;295058.181818182;2899.27272727273;101.909090909091
38555;2023;6;6;0;100;0;201856.666666667;2547.66666666667;98.5
38556;2023;9;9;0;100;0;272195.555555556;2694.55555555556;96.6666666666667
38557;2023;30;24;6;80;20;401728.266666667;4159.93333333333;97.6333333333333
38558;2023;11;6;5;54.5454545454545;45.4545454545455;357387;3986.54545454545;95.6363636363636
38559;2023;38;18;20;47.3684210526316;52.6315789473684;182135.526315789;2182.42105263158;82.6052631578947
38560;2023;9;9;0;100;0;203632.444444444;2100.22222222222;100.888888888889
38561;2023;7;6;1;85.7142857142857;14.2857142857143;149799.428571429;2017;86.8571428571429
38562;2023;58;17;41;29.3103448275862;70.6896551724138;160036.724137931;2263.77586206897;68.4827586206897
38563;2023;232;58;174;25;75;214263.094827586;2566.86637931034;80.676724137931
38564;2023;2;2;0;100;0;217500;2133.5;109
38565;2023;82;40;42;48.780487804878;51.219512195122;265345.548780488;3114.20731707317;85.5121951219512
38566;2023;8;8;0;100;0;273812.5;3083;98.625
38567;2023;61;2;59;3.27868852459016;96.7213114754098;107715.737704918;3173.7868852459;33.0491803278689
39001;2023;6;6;0;100;0;133791.666666667;1557;82.6666666666667
39002;2023;1;1;0;100;0;65000;591;110
39006;2023;3;1;2;33.3333333333333;66.6666666666667;85444.3333333333;922;91.6666666666667
39007;2023;3;3;0;100;0;126666.666666667;1508.33333333333;78
39008;2023;6;6;0;100;0;167633.333333333;1353.66666666667;124.166666666667
39009;2023;3;3;0;100;0;193950;1412.33333333333;160.666666666667
39010;2023;2;2;0;100;0;79500;707;110
39011;2023;5;5;0;100;0;126270;1294;96
39013;2023;43;35;8;81.3953488372093;18.6046511627907;155118.790697674;1800.6511627907;90.7906976744186
39014;2023;2;2;0;100;0;170200;1160;151
39016;2023;9;9;0;100;0;167833.333333333;1590.55555555556;104.444444444444
39017;2023;17;17;0;100;0;194395.352941176;1608.05882352941;111.705882352941
39018;2023;6;6;0;100;0;131841.666666667;1414;93.5
39019;2023;3;3;0;100;0;223750;1903.33333333333;124.666666666667
39020;2023;2;2;0;100;0;105000;723;141
39021;2023;4;4;0;100;0;294750;1776.25;165
39022;2023;8;8;0;100;0;170125;1456.125;122.75
39024;2023;4;4;0;100;0;98090;1143;98.5
39025;2023;3;3;0;100;0;90560;1455.33333333333;62
39026;2023;2;2;0;100;0;231500;2134;108.5
39027;2023;1;1;0;100;0;160000;1067;150
39028;2023;4;4;0;100;0;134625;1417;98
39029;2023;6;6;0;100;0;182200;1596.33333333333;119.666666666667
39030;2023;9;8;1;88.8888888888889;11.1111111111111;183444.444444444;1988.88888888889;95.4444444444444
39032;2023;2;2;0;100;0;207500;2049;102
39034;2023;5;5;0;100;0;189358.8;1670.6;116.8
39035;2023;1;1;0;100;0;168000;3231;52
39037;2023;4;4;0;100;0;187750;1793.75;109
39038;2023;2;2;0;100;0;244500;2190;108.5
39039;2023;1;0;1;0;100;128000;877;146
39040;2023;1;1;0;100;0;137000;1096;125
39041;2023;1;1;0;100;0;135000;1588;85
39042;2023;3;3;0;100;0;206000;1816;108
39043;2023;20;19;1;95;5;148369.75;1623.4;91.65
39045;2023;1;1;0;100;0;67000;713;94
39047;2023;6;2;4;33.3333333333333;66.6666666666667;129956.666666667;2129.66666666667;67.6666666666667
39048;2023;8;8;0;100;0;208781.25;1495.75;147.375
39049;2023;4;4;0;100;0;227250;2047;113
39050;2023;2;1;1;50;50;253500;3060;87.5
39051;2023;2;2;0;100;0;172500;1973;86.5
39053;2023;1;1;0;100;0;187000;2338;80
39056;2023;22;21;1;95.4545454545455;4.54545454545455;185974.090909091;2019.59090909091;92.5
39057;2023;1;1;0;100;0;230000;2875;80
39058;2023;1;1;0;100;0;230000;2949;78
39059;2023;34;15;19;44.1176470588235;55.8823529411765;207024.558823529;2902.20588235294;74.2352941176471
39061;2023;1;1;0;100;0;165000;868;190
39062;2023;2;2;0;100;0;239050;2276.5;105
39063;2023;3;2;1;66.6666666666667;33.3333333333333;154250;2303.66666666667;69.3333333333333
39065;2023;1;1;0;100;0;152000;1086;140
39068;2023;2;2;0;100;0;140025;1165.5;112.5
39070;2023;1;1;0;100;0;263150;2175;121
39072;2023;4;3;1;75;25;95285;1091;92.5
39073;2023;1;1;0;100;0;265900;2532;105
39076;2023;3;3;0;100;0;151666.666666667;1148.33333333333;115.666666666667
39078;2023;3;2;1;66.6666666666667;33.3333333333333;237450;1914.66666666667;118.333333333333
39079;2023;2;2;0;100;0;140880;1264;120
39080;2023;1;1;0;100;0;67000;1081;62
39081;2023;2;2;0;100;0;127500;1638.5;78.5
39083;2023;2;1;1;50;50;283955;2381;123
39084;2023;1;1;0;100;0;199600;2626;76
39085;2023;4;4;0;100;0;191395;2652.5;74.5
39086;2023;4;4;0;100;0;127550;1760.5;87
39088;2023;8;7;1;87.5;12.5;147130.875;1261;112.625
39091;2023;1;1;0;100;0;105000;724;145
39092;2023;2;2;0;100;0;80000;842;93
39093;2023;3;3;0;100;0;234333.333333333;1953.66666666667;129.666666666667
39094;2023;1;1;0;100;0;190300;1962;97
39095;2023;1;1;0;100;0;165000;1058;156
39096;2023;1;1;0;100;0;152500;1794;85
39097;2023;104;39;65;37.5;62.5;149318.471153846;1765.36538461538;83.9903846153846
39099;2023;2;2;0;100;0;184225;1442;126
39100;2023;2;2;0;100;0;186875;1321.5;145
39101;2023;20;17;3;85;15;171834.5;2082.6;84.9
39102;2023;4;3;1;75;25;174125;1577.5;105.75
39103;2023;9;8;1;88.8888888888889;11.1111111111111;132489.444444444;1475.77777777778;106.777777777778
39104;2023;13;12;1;92.3076923076923;7.69230769230769;160188.461538462;1563.61538461538;103.076923076923
39105;2023;1;1;0;100;0;190000;2088;91
39106;2023;1;1;0;100;0;104500;871;120
39107;2023;2;2;0;100;0;208350;1254.5;138.5
39109;2023;3;3;0;100;0;225833.333333333;1740.33333333333;141.333333333333
39112;2023;3;3;0;100;0;121333.333333333;1381.33333333333;84.6666666666667
39114;2023;3;2;1;66.6666666666667;33.3333333333333;636666.666666667;6900.33333333333;141.666666666667
39117;2023;1;1;0;100;0;165000;1634;101
39120;2023;1;1;0;100;0;120000;603;199
39121;2023;7;7;0;100;0;159491.428571429;1598.85714285714;107.428571428571
39122;2023;2;2;0;100;0;141600;1756.5;80.5
39124;2023;8;7;1;87.5;12.5;142412.5;1505;92.875
39126;2023;3;3;0;100;0;155121.333333333;2088.66666666667;70.6666666666667
39128;2023;24;22;2;91.6666666666667;8.33333333333333;129739.583333333;1446.91666666667;88.4166666666667
39129;2023;4;4;0;100;0;203956;1704.75;119.75
39130;2023;6;6;0;100;0;245443.333333333;2728.83333333333;101.833333333333
39131;2023;6;6;0;100;0;269188.333333333;2877.83333333333;94.5
39133;2023;1;1;0;100;0;551000;1695;325
39134;2023;2;2;0;100;0;137000;1073.5;122.5
39137;2023;3;3;0;100;0;155000;1384;112.333333333333
39138;2023;4;4;0;100;0;170385.25;1903.5;91
39139;2023;1;1;0;100;0;125000;1736;72
39141;2023;2;2;0;100;0;269940;1417.5;210.5
39142;2023;1;1;0;100;0;67000;827;81
39145;2023;3;3;0;100;0;210666.666666667;1541;149.333333333333
39146;2023;4;4;0;100;0;217075;2053.75;121
39147;2023;1;1;0;100;0;75000;484;155
39149;2023;5;5;0;100;0;149594;1394.8;100.6
39150;2023;13;13;0;100;0;172157.307692308;1826.61538461538;92.4615384615385
39151;2023;3;3;0;100;0;196666.666666667;1938;97.6666666666667
39153;2023;11;11;0;100;0;193959.090909091;1827.54545454545;106.909090909091
39154;2023;13;12;1;92.3076923076923;7.69230769230769;183880.769230769;1774.92307692308;106.230769230769
39156;2023;3;3;0;100;0;231416.666666667;1997;115.666666666667
39159;2023;1;1;0;100;0;2,00E+05;2000;100
39160;2023;5;5;0;100;0;154940;1845.6;85
39163;2023;3;2;1;66.6666666666667;33.3333333333333;166666.666666667;1598.33333333333;85.6666666666667
39164;2023;13;10;3;76.9230769230769;23.0769230769231;186629.230769231;1800;107.538461538462
39165;2023;1;1;0;100;0;155000;1292;120
39166;2023;3;3;0;100;0;47926.6666666667;768;65.3333333333333
39167;2023;3;3;0;100;0;139866.666666667;1174.33333333333;120.666666666667
39169;2023;10;10;0;100;0;199321.7;1955.2;99.2
39170;2023;3;3;0;100;0;278666.666666667;2089.33333333333;123.333333333333
39171;2023;9;8;1;88.8888888888889;11.1111111111111;217205.555555556;1800.44444444444;122.222222222222
39172;2023;4;4;0;100;0;325722.5;2515;125
39173;2023;10;7;3;70;30;87800;1109.1;76.4
39174;2023;2;2;0;100;0;266347.5;2242;118.5
39176;2023;3;3;0;100;0;199000;2673.66666666667;73.3333333333333
39177;2023;6;6;0;100;0;174616.666666667;2042.33333333333;85.6666666666667
39178;2023;1;1;0;100;0;236740;2466;96
39179;2023;2;2;0;100;0;156150;930.5;146.5
39180;2023;3;3;0;100;0;83500;1082.66666666667;83
39182;2023;1;1;0;100;0;291000;1854;157
39183;2023;6;6;0;100;0;149736.666666667;1421.16666666667;111.833333333333
39184;2023;3;3;0;100;0;281703.666666667;2570.33333333333;110.666666666667
39185;2023;4;4;0;100;0;198000;1771.25;112.25
39187;2023;2;2;0;100;0;141840;1252;120
39188;2023;6;6;0;100;0;205766.666666667;1677.16666666667;114.666666666667
39189;2023;14;12;2;85.7142857142857;14.2857142857143;141096.428571429;1693.92857142857;84.7142857142857
39190;2023;5;5;0;100;0;208690;1806.2;141.6
39192;2023;1;1;0;100;0;91200;760;120
39193;2023;11;11;0;100;0;194229.272727273;1561.81818181818;121.727272727273
39194;2023;3;3;0;100;0;243206.666666667;2279;107.666666666667
39196;2023;1;1;0;100;0;35000;407;86
39197;2023;7;7;0;100;0;160185.714285714;1556.14285714286;97.8571428571429
39198;2023;305;132;173;43.2786885245902;56.7213114754098;154868.183606557;1872.55737704918;84.9475409836066
39199;2023;13;13;0;100;0;216169.230769231;1974.61538461538;110.461538461538
39200;2023;1;1;0;100;0;55000;743;74
39201;2023;8;5;3;62.5;37.5;188337.5;2350.75;106.375
39202;2023;1;1;0;100;0;226000;1449;156
39204;2023;1;1;0;100;0;90000;1304;69
39205;2023;4;4;0;100;0;182875;2005.75;90.25
39206;2023;2;2;0;100;0;128350;1735;72
39207;2023;1;1;0;100;0;405000;1695;239
39208;2023;1;1;0;100;0;277219;2310;120
39209;2023;8;8;0;100;0;107152.5;1108.625;84.5
39210;2023;3;3;0;100;0;269500;2412.66666666667;112
39211;2023;2;2;0;100;0;81750;730.5;122
39214;2023;3;3;0;100;0;142000;1621;96.3333333333333
39216;2023;5;4;1;80;20;168299.4;1666.2;92.4
39217;2023;5;5;0;100;0;222460;1929.8;115.4
39218;2023;2;2;0;100;0;199510;1445.5;210.5
39219;2023;9;6;3;66.6666666666667;33.3333333333333;191405.555555556;1872.22222222222;105.555555555556
39220;2023;2;2;0;100;0;88500;1720;63
39227;2023;6;4;2;66.6666666666667;33.3333333333333;163797.333333333;1839.83333333333;90.3333333333333
39228;2023;12;11;1;91.6666666666667;8.33333333333333;227696.416666667;2598.66666666667;85.3333333333333
39230;2023;1;1;0;100;0;270000;2500;108
39232;2023;1;1;0;100;0;120000;2727;44
39233;2023;23;18;5;78.2608695652174;21.7391304347826;192288.695652174;2052;91.9565217391304
39235;2023;16;13;3;81.25;18.75;209692.5;1804.1875;116.125
39236;2023;1;1;0;100;0;150000;1364;110
39237;2023;1;1;0;100;0;78000;488;160
39238;2023;1;1;0;100;0;114000;898;127
39240;2023;1;1;0;100;0;340000;2267;150
39241;2023;2;2;0;100;0;260100;2460.5;103.5
39244;2023;2;2;0;100;0;204785;1780;116.5
39245;2023;2;2;0;100;0;156000;1422.5;110
39246;2023;1;0;1;0;100;93000;1576;59
39247;2023;1;1;0;100;0;79000;1274;62
39251;2023;3;3;0;100;0;142583.333333333;1636;84.6666666666667
39252;2023;6;6;0;100;0;180816.666666667;1937;96.8333333333333
39253;2023;3;3;0;100;0;108000;1078.33333333333;100.666666666667
39254;2023;3;3;0;100;0;127933.333333333;1039;121
39255;2023;1;1;0;100;0;147000;1531;96
39258;2023;1;1;0;100;0;170000;2073;82
39259;2023;1;1;0;100;0;210000;1826;115
39262;2023;5;5;0;100;0;171270;1802.2;100
39263;2023;1;1;0;100;0;1,00E+05;1205;83
39265;2023;1;1;0;100;0;125000;781;160
39266;2023;4;4;0;100;0;119195;1017.25;116.25
39267;2023;1;0;1;0;100;146310;1626;90
39269;2023;2;1;1;50;50;175475;1855.5;97
39270;2023;6;6;0;100;0;133083.333333333;1824.16666666667;76.3333333333333
39271;2023;7;7;0;100;0;270255.714285714;2179.14285714286;136.285714285714
39272;2023;1;1;0;100;0;38010;845;45
39273;2023;4;4;0;100;0;121535;890.75;131.75
39274;2023;5;4;1;80;20;311380;3769.6;89.6
39275;2023;13;5;8;38.4615384615385;61.5384615384615;199142.230769231;3051.30769230769;62.2307692307692
39278;2023;1;1;0;100;0;179000;2238;80
39279;2023;5;5;0;100;0;150029.6;1536.2;97.6
39280;2023;1;1;0;100;0;175000;1923;91
39282;2023;2;2;0;100;0;222600;1707;125
39283;2023;2;2;0;100;0;181100;2494.5;63
39284;2023;1;1;0;100;0;208000;2000;104
39285;2023;1;1;0;100;0;247950;1600;155
39286;2023;17;14;3;82.3529411764706;17.6470588235294;148617.647058824;1410.47058823529;104.235294117647
39288;2023;4;4;0;100;0;249682.5;2277.25;109.75
39289;2023;7;6;1;85.7142857142857;14.2857142857143;129193.142857143;1355.42857142857;94.4285714285714
39290;2023;7;7;0;100;0;142407.142857143;1152;120.571428571429
39291;2023;3;3;0;100;0;259333.333333333;1711.33333333333;149.333333333333
39292;2023;1;1;0;100;0;111000;1121;99
39293;2023;3;3;0;100;0;186666.666666667;1633;129.333333333333
39295;2023;1;1;0;100;0;120000;1500;80
39296;2023;2;2;0;100;0;236620;3076;79
39297;2023;8;7;1;87.5;12.5;289480.25;2714;118.5
39299;2023;4;4;0;100;0;92650;955.5;97
39300;2023;202;42;160;20.7920792079208;79.2079207920792;129137.53960396;1654.87128712871;79.6386138613861
39301;2023;3;3;0;100;0;185000;2134.66666666667;92
39302;2023;2;2;0;100;0;278725;2098;134
39304;2023;2;2;0;100;0;213825;2362.5;90.5
39305;2023;3;3;0;100;0;274516.666666667;1844.66666666667;146
39306;2023;12;12;0;100;0;199908.083333333;1938;101.916666666667
39307;2023;6;6;0;100;0;211939.166666667;2467.33333333333;94.3333333333333
39308;2023;1;1;0;100;0;231800;2229;104
39310;2023;3;3;0;100;0;208333.333333333;1826;122.333333333333
39313;2023;5;5;0;100;0;207666.4;2134;99.2
39315;2023;2;2;0;100;0;104900;1328.5;88
39317;2023;1;1;0;100;0;192000;768;250
39318;2023;1;1;0;100;0;280000;3733;75
39319;2023;1;1;0;100;0;165770;1727;96
39320;2023;3;3;0;100;0;100500;1003;100.666666666667
39323;2023;2;2;0;100;0;84495;1709.5;49.5
39325;2023;9;9;0;100;0;167308.333333333;1725.88888888889;96.7777777777778
39327;2023;9;7;2;77.7777777777778;22.2222222222222;142055.555555556;1742.22222222222;80.3333333333333
39328;2023;3;3;0;100;0;172333.333333333;1957.66666666667;88
39330;2023;1;1;0;100;0;120000;945;127
39331;2023;7;7;0;100;0;287742.857142857;1852;162.857142857143
39333;2023;17;11;6;64.7058823529412;35.2941176470588;161764.705882353;1646.70588235294;100.647058823529
39334;2023;2;2;0;100;0;167300;2208;80
39335;2023;6;6;0;100;0;192175;1506;139.166666666667
39336;2023;1;1;0;100;0;254650;1384;184
39337;2023;1;1;0;100;0;1,00E+05;1667;60
39338;2023;2;2;0;100;0;133750;1997.5;71
39339;2023;5;4;1;80;20;148124;1132.8;137
39342;2023;1;1;0;100;0;134500;1245;108
39344;2023;2;2;0;100;0;263769;1570.5;173.5
39345;2023;4;4;0;100;0;227750;1926.5;115.5
39346;2023;4;4;0;100;0;120625;1132;96.25
39348;2023;4;4;0;100;0;145400;1281.5;110.75
39349;2023;4;4;0;100;0;218425;1748.25;120.5
39350;2023;3;3;0;100;0;131266.666666667;1271.33333333333;104.333333333333
39351;2023;3;3;0;100;0;240083.333333333;2267.33333333333;108.333333333333
39352;2023;1;1;0;100;0;279500;3213;87
39353;2023;5;5;0;100;0;112400;1319.4;87.2
39354;2023;3;3;0;100;0;182950;1690.33333333333;116
39355;2023;4;3;1;75;25;120453.25;1268.25;103.5
39356;2023;2;2;0;100;0;224000;1640;137
39360;2023;3;3;0;100;0;153000;926;150
39361;2023;1;1;0;100;0;130000;1182;110
39362;2023;36;25;11;69.4444444444444;30.5555555555556;159632.361111111;1909.75;85.0833333333333
39364;2023;4;4;0;100;0;178994.25;1690.75;109
39365;2023;11;10;1;90.9090909090909;9.09090909090909;163325.454545455;1790.54545454545;112.181818181818
39366;2023;5;5;0;100;0;183687.6;1722.4;108.8
39367;2023;25;16;9;64;36;230447.6;2512.72;89.48
39368;2023;71;12;59;16.9014084507042;83.0985915492958;111434.281690141;1425.38028169014;78.887323943662
39370;2023;5;4;1;80;20;99544.2;1048;97.6
39372;2023;1;1;0;100;0;130000;1008;129
39373;2023;2;2;0;100;0;282595;3226.5;80
39377;2023;1;1;0;100;0;28000;431;65
39378;2023;5;5;0;100;0;152140;1661.4;92.8
39379;2023;5;5;0;100;0;203600;1643.4;124.6
39381;2023;2;2;0;100;0;237625;2221;119
39385;2023;4;4;0;100;0;116000;1331.5;80
39386;2023;3;3;0;100;0;153333.333333333;1609.66666666667;96
39387;2023;3;3;0;100;0;123166.666666667;1369;96.6666666666667
39388;2023;1;1;0;100;0;40000;1538;26
39389;2023;8;8;0;100;0;169813.75;1422.5;116.125
39391;2023;1;1;0;100;0;170677;1985;86
39392;2023;5;4;1;80;20;87800;974.4;106
39393;2023;1;1;0;100;0;85000;702;121
39396;2023;12;11;1;91.6666666666667;8.33333333333333;155050.833333333;1739.91666666667;95.9166666666667
39397;2023;12;12;0;100;0;200370.833333333;2034.5;104.25
39398;2023;7;7;0;100;0;160185.714285714;1672;96.1428571428571
39400;2023;1;1;0;100;0;187000;2101;89
39401;2023;5;5;0;100;0;124600;1455.6;87.8
39402;2023;3;3;0;100;0;137500;1550.66666666667;95.3333333333333
39403;2023;1;1;0;100;0;257000;1890;136
39404;2023;3;3;0;100;0;107733.333333333;994;100
39405;2023;8;6;2;75;25;217025;1858.625;117.5
39406;2023;5;4;1;80;20;228200;2729.2;92.4
39407;2023;2;2;0;100;0;81450;849.5;97
39408;2023;2;2;0;100;0;171750;1385.5;129
39411;2023;14;7;7;50;50;167836.571428571;1672.57142857143;99.7857142857143
39412;2023;3;3;0;100;0;104010;1370;79.3333333333333
39413;2023;4;3;1;75;25;270750;4453.75;77.5
39415;2023;16;16;0;100;0;136709.375;1642.5625;83.3125
39418;2023;1;1;0;100;0;185000;1381;134
39420;2023;2;2;0;100;0;130000;1266;95.5
39422;2023;3;3;0;100;0;204166.666666667;1358.66666666667;141.666666666667
39423;2023;3;3;0;100;0;138333.333333333;1364.66666666667;101
39424;2023;4;3;1;75;25;189000;1831;92.5
39425;2023;1;1;0;100;0;68000;756;90
39426;2023;4;4;0;100;0;140250;1204.5;116.25
39427;2023;1;1;0;100;0;194000;1960;99
39429;2023;7;7;0;100;0;117571.428571429;1403.57142857143;84.8571428571429
39430;2023;2;2;0;100;0;127000;948;139
39431;2023;1;1;0;100;0;85000;934;91
39432;2023;1;1;0;100;0;133900;1674;80
39434;2023;34;22;12;64.7058823529412;35.2941176470588;153382.941176471;1680.47058823529;97.5
39435;2023;11;9;2;81.8181818181818;18.1818181818182;137054.090909091;1605.72727272727;93.3636363636364
39436;2023;1;1;0;100;0;46000;780;59
39437;2023;2;2;0;100;0;194975;1587;146
39439;2023;4;4;0;100;0;236100;2157;108.75
39441;2023;49;12;37;24.4897959183673;75.5102040816327;172805.979591837;3262.24489795918;49.7959183673469
39443;2023;2;2;0;100;0;219750;2025.5;107
39444;2023;1;1;0;100;0;50000;472;106
39445;2023;1;1;0;100;0;175000;1423;123
39446;2023;4;4;0;100;0;265727.5;2378.25;114.75
39447;2023;1;1;0;100;0;265928;2659;100
39448;2023;1;1;0;100;0;175500;2041;86
39449;2023;2;2;0;100;0;173100;2203.5;78
39451;2023;5;4;1;80;20;189180;2296.8;82.4
39452;2023;5;5;0;100;0;200135;1327;153
39453;2023;3;3;0;100;0;212200;2078.66666666667;119.333333333333
39454;2023;1;1;0;100;0;50000;694;72
39455;2023;2;2;0;100;0;166610;1663;99
39456;2023;4;3;1;75;25;190475;2035.5;91
39457;2023;1;1;0;100;0;252100;2192;115
39458;2023;2;2;0;100;0;180100;1542;112.5
39460;2023;2;2;0;100;0;102500;852;141
39462;2023;6;5;1;83.3333333333333;16.6666666666667;201458.333333333;2290.5;100.5
39463;2023;2;1;1;50;50;80000;918;84
39464;2023;2;2;0;100;0;249450;1483.5;156.5
39466;2023;1;1;0;100;0;170000;1417;120
39468;2023;1;1;0;100;0;90000;1125;80
39470;2023;109;15;94;13.7614678899083;86.2385321100918;214188.036697248;3513.77981651376;62.3119266055046
39471;2023;8;8;0;100;0;172441.875;1557.125;110.75
39472;2023;3;3;0;100;0;173166.666666667;2023.66666666667;86
39474;2023;3;3;0;100;0;219333.333333333;2067.33333333333;109.666666666667
39475;2023;13;13;0;100;0;166211.538461538;1690.15384615385;104.923076923077
39476;2023;17;17;0;100;0;172802.941176471;1741.58823529412;101.647058823529
39477;2023;1;1;0;100;0;130000;1494;87
39478;2023;104;23;81;22.1153846153846;77.8846153846154;85336.0961538462;1002.99038461538;83.9134615384615
39479;2023;2;2;0;100;0;95000;1145;84
39480;2023;1;1;0;100;0;228500;1888;121
39481;2023;3;3;0;100;0;180975;1791.33333333333;108
39485;2023;10;9;1;90;10;124974;1216.4;102.6
39486;2023;3;3;0;100;0;141350;1341.33333333333;123
39487;2023;20;15;5;75;25;222494.2;3232.1;74.5
39489;2023;5;5;0;100;0;124400;987.6;115.8
39490;2023;1;1;0;100;0;159000;1013;157
39491;2023;17;11;6;64.7058823529412;35.2941176470588;143412.176470588;1592.82352941176;87.1176470588235
39492;2023;1;1;0;100;0;140000;1148;122
39493;2023;4;4;0;100;0;142750;1550.25;84
39494;2023;2;2;0;100;0;395983.5;3181;127
39495;2023;2;2;0;100;0;172230;2108;93.5
39498;2023;5;5;0;100;0;200840;1651.2;125.4
39499;2023;1;1;0;100;0;50000;833;60
39500;2023;36;17;19;47.2222222222222;52.7777777777778;110225.027777778;1325.30555555556;81.1388888888889
39501;2023;16;13;3;81.25;18.75;212532.1875;2061.25;103.875
39502;2023;2;2;0;100;0;115000;1223.5;94
39503;2023;3;3;0;100;0;255666.666666667;1665.66666666667;151
39504;2023;4;4;0;100;0;205125;1608.75;127.25
39507;2023;3;3;0;100;0;101000;895.333333333333;104.333333333333
39508;2023;8;8;0;100;0;148695;1429.5;107.375
39510;2023;8;7;1;87.5;12.5;318500;3712.25;99.375
39513;2023;1;1;0;100;0;361450;1599;226
39514;2023;3;3;0;100;0;177033.333333333;1866;95
39517;2023;2;2;0;100;0;100500;952;95.5
39518;2023;1;1;0;100;0;219000;2235;98
39519;2023;2;2;0;100;0;223000;1732;127
39520;2023;6;6;0;100;0;136416.666666667;1550.33333333333;89.5
39522;2023;2;2;0;100;0;197000;2044;102
39523;2023;3;3;0;100;0;280343.333333333;2288;122.666666666667
39525;2023;3;3;0;100;0;213950;1849.33333333333;116.666666666667
39526;2023;71;63;8;88.7323943661972;11.2676056338028;148179.154929577;1653.47887323944;90.1408450704225
39527;2023;2;2;0;100;0;230000;1610;160
39528;2023;5;5;0;100;0;129200;1226.6;117.8
39529;2023;1;1;0;100;0;1,00E+05;870;115
39530;2023;4;4;0;100;0;180750;2148.5;82.75
39531;2023;2;2;0;100;0;129500;857.5;146
39532;2023;2;2;0;100;0;133811.5;853;161
39533;2023;7;6;1;85.7142857142857;14.2857142857143;165292.857142857;2056.14285714286;86
39534;2023;4;4;0;100;0;190207.5;1880.5;100.5
39535;2023;4;4;0;100;0;176250;1793.75;104.25
39537;2023;3;3;0;100;0;106733.333333333;1029.66666666667;105.333333333333
39538;2023;1;1;0;100;0;230000;1655;139
39539;2023;4;4;0;100;0;113875;1061.25;106.25
39540;2023;1;1;0;100;0;180000;2250;80
39543;2023;1;1;0;100;0;217000;1085;200
39545;2023;1;1;0;100;0;30000;462;65
39546;2023;3;3;0;100;0;270266.666666667;1582.33333333333;179.333333333333
39547;2023;3;3;0;100;0;149583.333333333;2073.66666666667;70
39548;2023;3;3;0;100;0;187366.666666667;1664;137
39550;2023;5;5;0;100;0;124847;1228;96.8
39551;2023;1;1;0;100;0;163800;1280;128
39552;2023;2;2;0;100;0;157375;1680;92.5
39553;2023;8;8;0;100;0;219759.75;1918.75;111.75
39554;2023;3;3;0;100;0;145333.333333333;1539;88.3333333333333
39557;2023;3;3;0;100;0;146000;1630.66666666667;92.6666666666667
39559;2023;6;6;0;100;0;160768.333333333;1926.83333333333;84.3333333333333
39560;2023;1;1;0;100;0;155000;1360;114
39561;2023;3;3;0;100;0;187433.333333333;1674.66666666667;109.666666666667
39567;2023;2;1;1;50;50;186550;2466;75
39569;2023;3;3;0;100;0;98333.3333333333;1253.66666666667;79.3333333333333
39570;2023;2;2;0;100;0;162500;1416;109.5
39571;2023;1;1;0;100;0;275000;2068;133
39572;2023;1;1;0;100;0;194923;1695;115
39573;2023;10;3;7;30;70;119400;1730.1;68.6
39574;2023;4;4;0;100;0;151310.75;1395.75;117
39576;2023;14;14;0;100;0;100107.142857143;1169.35714285714;86
39577;2023;2;2;0;100;0;131525;1251.5;102
39579;2023;8;8;0;100;0;264626.25;2074;132.625
39581;2023;1;1;0;100;0;176000;2514;70
39582;2023;7;7;0;100;0;175714.285714286;1700.42857142857;104.714285714286
39583;2023;2;2;0;100;0;196000;2691;75
39584;2023;2;2;0;100;0;215750;2213.5;98
39586;2023;1;1;0;100;0;220000;1302;169
40001;2023;93;68;25;73.1182795698925;26.8817204301075;132311.11827957;1670.98924731183;84.4408602150538
40002;2023;21;20;1;95.2380952380952;4.76190476190476;201770.333333333;1620.42857142857;120.761904761905
40003;2023;3;3;0;100;0;240560;1887;113.333333333333
40004;2023;23;16;7;69.5652173913043;30.4347826086957;465684.086956522;4834.4347826087;94.3478260869565
40005;2023;5;5;0;100;0;100660;930.8;102.8
40006;2023;4;4;0;100;0;183512.5;1854.25;99
40007;2023;2;2;0;100;0;120060;1001.5;126
40011;2023;1;1;0;100;0;162117;1654;98
40012;2023;3;3;0;100;0;172666.666666667;1673;101.666666666667
40013;2023;1;1;0;100;0;325000;1059;307
40014;2023;5;5;0;100;0;158920;1924.4;83.8
40015;2023;2;2;0;100;0;106000;1573.5;66.5
40016;2023;3;3;0;100;0;122166.666666667;986.333333333333;125.666666666667
40017;2023;8;8;0;100;0;163778;1618.125;110.625
40018;2023;4;4;0;100;0;255706.25;2237.25;117
40019;2023;29;15;14;51.7241379310345;48.2758620689655;172216.896551724;3051.65517241379;56.3793103448276
40020;2023;12;12;0;100;0;221296.083333333;2228.83333333333;100.083333333333
40021;2023;18;18;0;100;0;305266.888888889;3917.72222222222;76.6111111111111
40022;2023;3;3;0;100;0;182433.333333333;1832.66666666667;83.6666666666667
40023;2023;3;3;0;100;0;147000;1504.33333333333;98.3333333333333
40025;2023;9;9;0;100;0;244154.888888889;1887.44444444444;142.222222222222
40026;2023;1;1;0;100;0;195000;1875;104
40027;2023;2;2;0;100;0;173070;1789.5;105.5
40028;2023;1;1;0;100;0;138200;1974;70
40029;2023;5;5;0;100;0;149490.6;1362;113.4
40030;2023;1;1;0;100;0;380350;3043;125
40031;2023;12;12;0;100;0;175583.333333333;1891.41666666667;93.5
40032;2023;3;3;0;100;0;186833.333333333;1891.33333333333;105.666666666667
40034;2023;4;4;0;100;0;272625.75;3028;90.75
40035;2023;2;2;0;100;0;295000;2548.5;116.5
40036;2023;48;33;15;68.75;31.25;347794.3125;4238.85416666667;83.2916666666667
40037;2023;16;16;0;100;0;242691.5;2111.0625;117.6875
40039;2023;2;2;0;100;0;120000;1312.5;90
40040;2023;6;6;0;100;0;189383.333333333;2079.16666666667;94.8333333333333
40041;2023;1;1;0;100;0;278500;1619;172
40042;2023;1;1;0;100;0;292610;4008;73
40043;2023;21;16;5;76.1904761904762;23.8095238095238;154653.095238095;2556.19047619048;62.0952380952381
40044;2023;11;11;0;100;0;275901.818181818;2773.54545454545;103.636363636364
40046;2023;325;173;152;53.2307692307692;46.7692307692308;341123.735384615;4594.81538461538;76.4646153846154
40047;2023;1;1;0;100;0;165000;1387;119
40049;2023;5;5;0;100;0;157200;1699.4;94.8
40050;2023;4;4;0;100;0;255312.5;2142.5;119.75
40051;2023;8;8;0;100;0;305468.75;2640.375;107.125
40052;2023;3;3;0;100;0;200266.666666667;1573.66666666667;176
40053;2023;1;1;0;100;0;2,00E+05;1667;120
40054;2023;3;3;0;100;0;311333.333333333;1928;144.666666666667
40055;2023;17;16;1;94.1176470588235;5.88235294117647;234851.176470588;2187.64705882353;116.588235294118
40056;2023;10;9;1;90;10;161805;1764;96
40057;2023;3;3;0;100;0;115716.666666667;1237.66666666667;102.333333333333
40058;2023;2;2;0;100;0;174000;2308;78.5
40059;2023;8;8;0;100;0;236048.75;2588;97.25
40061;2023;6;6;0;100;0;284700;2587.5;109.5
40062;2023;5;5;0;100;0;154400;1686.2;93
40063;2023;12;12;0;100;0;275743.166666667;2690.41666666667;103.083333333333
40064;2023;1;1;0;100;0;276000;2091;132
40065;2023;263;113;150;42.9657794676806;57.0342205323194;440424.844106464;7341.66920152091;61.6539923954373
40066;2023;5;5;0;100;0;225500;2029;113.8
40067;2023;2;2;0;100;0;188000;1803.5;110.5
40068;2023;9;7;2;77.7777777777778;22.2222222222222;166976.111111111;1882.33333333333;82.1111111111111
40069;2023;5;5;0;100;0;247060;2277.6;113.6
40070;2023;2;2;0;100;0;181700;1984;91.5
40071;2023;6;6;0;100;0;189933.333333333;2075.66666666667;97
40072;2023;4;4;0;100;0;178050.5;1877.5;100.25
40073;2023;1;1;0;100;0;231525;1564;148
40074;2023;1;1;0;100;0;140187;893;157
40075;2023;23;20;3;86.9565217391304;13.0434782608696;292017.52173913;2970.4347826087;100.782608695652
40076;2023;3;3;0;100;0;124640;1039;127.666666666667
40077;2023;7;7;0;100;0;287250;2925.85714285714;99.5714285714286
40078;2023;4;4;0;100;0;249127.5;1905.75;134.5
40079;2023;1;1;0;100;0;70000;636;110
40080;2023;9;9;0;100;0;178527.777777778;1572.66666666667;127.888888888889
40081;2023;6;6;0;100;0;134700;1358.83333333333;97.3333333333333
40082;2023;3;3;0;100;0;194066.666666667;1717.33333333333;118.666666666667
40084;2023;7;7;0;100;0;192932.714285714;1790.57142857143;111.428571428571
40085;2023;4;4;0;100;0;188750;1769.5;113.25
40086;2023;4;4;0;100;0;126875;879.75;154.25
40087;2023;9;9;0;100;0;134594.444444444;1441.77777777778;91.4444444444444
40088;2023;514;140;374;27.2373540856031;72.7626459143969;157186.73540856;2611.81322957198;61.920233463035
40089;2023;7;7;0;100;0;212850;1498.14285714286;142.142857142857
40090;2023;8;8;0;100;0;182928.625;1946.25;94.25
40091;2023;11;11;0;100;0;200472.727272727;1773.18181818182;119.272727272727
40093;2023;2;2;0;100;0;259150;1625.5;144
40094;2023;14;14;0;100;0;269290.857142857;2760.35714285714;98.6428571428571
40095;2023;5;5;0;100;0;283480;2618.8;116.2
40096;2023;3;3;0;100;0;200246.666666667;1729;133
40097;2023;14;5;9;35.7142857142857;64.2857142857143;125014.714285714;2625.64285714286;52.9285714285714
40098;2023;5;5;0;100;0;198853.6;1536.6;135.2
40099;2023;2;2;0;100;0;227250;1951.5;120
40100;2023;5;5;0;100;0;207460;1683;118.6
40101;2023;4;4;0;100;0;258950;2326.25;106.5
40102;2023;17;17;0;100;0;125719.529411765;1327.17647058824;96.6470588235294
40103;2023;6;6;0;100;0;167808.166666667;1743.66666666667;92.3333333333333
40104;2023;14;13;1;92.8571428571429;7.14285714285714;235606.785714286;2039.57142857143;118.214285714286
40105;2023;2;2;0;100;0;219600;2073;113
40106;2023;4;4;0;100;0;260850;2184;119.5
40108;2023;13;13;0;100;0;281034.615384615;3294.07692307692;86.7692307692308
40109;2023;3;3;0;100;0;297133.333333333;1306.33333333333;197
40110;2023;8;8;0;100;0;148349.375;1620.5;91.125
40111;2023;9;9;0;100;0;200044.444444444;1793.11111111111;113
40112;2023;1;1;0;100;0;249000;3037;82
40113;2023;3;3;0;100;0;173300;1446.33333333333;117.333333333333
40114;2023;4;4;0;100;0;405775;2258.75;178.5
40115;2023;2;2;0;100;0;187937.5;1430;136.5
40116;2023;1;1;0;100;0;277200;1912;145
40117;2023;40;37;3;92.5;7.5;180387.5;1753.225;106.4
40118;2023;19;19;0;100;0;263607.894736842;2392.52631578947;118.631578947368
40119;2023;66;61;5;92.4242424242424;7.57575757575758;165879.53030303;1879.07575757576;92.4090909090909
40120;2023;11;11;0;100;0;270965.363636364;2329.90909090909;129.545454545455
40121;2023;3;3;0;100;0;250333.333333333;1303.33333333333;186
40122;2023;6;6;0;100;0;192783.833333333;1657.66666666667;124.666666666667
40123;2023;9;9;0;100;0;336355.555555556;3136.88888888889;109.555555555556
40124;2023;2;2;0;100;0;424250;2011.5;220
40125;2023;14;14;0;100;0;372505.071428571;3030.78571428571;120.642857142857
40126;2023;18;16;2;88.8888888888889;11.1111111111111;218660.666666667;2212.27777777778;100.944444444444
40127;2023;6;6;0;100;0;171158.333333333;1771.33333333333;96.1666666666667
40128;2023;5;5;0;100;0;229993.6;1792;130.4
40129;2023;6;6;0;100;0;346100;3241.33333333333;109
40131;2023;7;7;0;100;0;212210;1272.71428571429;144.428571428571
40132;2023;15;14;1;93.3333333333333;6.66666666666667;227009.4;2102.4;113.733333333333
40133;2023;96;56;40;58.3333333333333;41.6666666666667;394044.416666667;4887.1875;80.6875
40134;2023;28;27;1;96.4285714285714;3.57142857142857;165795.464285714;1956.78571428571;90.4642857142857
40135;2023;18;18;0;100;0;174521.611111111;1645.11111111111;110.833333333333
40137;2023;4;4;0;100;0;208000;2033;111.5
40138;2023;2;2;0;100;0;229055;2017.5;99.5
40139;2023;5;5;0;100;0;235320;2159.2;108
40140;2023;1;1;0;100;0;81455;1164;70
40141;2023;3;3;0;100;0;181200;1590;121.666666666667
40142;2023;10;10;0;100;0;330578.2;2929.1;100.8
40143;2023;3;3;0;100;0;195094.333333333;1227;161.333333333333
40144;2023;3;3;0;100;0;466200;3283.33333333333;174
40145;2023;8;8;0;100;0;175256.25;1709;99.25
40146;2023;2;2;0;100;0;213500;1701.5;124.5
40147;2023;4;4;0;100;0;122742.5;1178.75;117.75
40149;2023;4;4;0;100;0;192275;1858;110.75
40150;2023;55;34;21;61.8181818181818;38.1818181818182;316416.127272727;4261.01818181818;76.6363636363636
40151;2023;3;3;0;100;0;168333.333333333;1773;91
40152;2023;12;12;0;100;0;275806.166666667;2595.83333333333;110.666666666667
40153;2023;3;3;0;100;0;176326;1740.66666666667;105.666666666667
40154;2023;6;6;0;100;0;351333.333333333;2354.83333333333;145.833333333333
40155;2023;12;11;1;91.6666666666667;8.33333333333333;353143.333333333;3335.75;107.166666666667
40156;2023;8;8;0;100;0;255300;2501.375;103.375
40157;2023;38;26;12;68.4210526315789;31.5789473684211;309258.921052632;3725.42105263158;79.5
40158;2023;4;4;0;100;0;121200.75;1538.5;83.5
40159;2023;4;2;2;50;50;154250;1921.25;79.5
40160;2023;3;3;0;100;0;198268.666666667;1604.66666666667;127.333333333333
40161;2023;1;1;0;100;0;102000;1133;90
40162;2023;2;2;0;100;0;202500;2065.5;98
40163;2023;4;4;0;100;0;241750;2427.5;98.5
40165;2023;9;9;0;100;0;217400;2461;91.7777777777778
40167;2023;6;6;0;100;0;171358.333333333;1807.5;103.833333333333
40168;2023;17;17;0;100;0;418873.058823529;3182.94117647059;137.117647058824
40169;2023;2;2;0;100;0;167500;1587.5;105.5
40170;2023;2;2;0;100;0;62000;1000;63
40171;2023;4;4;0;100;0;325060;2044.75;135.25
40172;2023;2;2;0;100;0;120000;999;122
40173;2023;1;1;0;100;0;185000;1445;128
40175;2023;3;3;0;100;0;185963.333333333;1687.33333333333;114
40176;2023;1;1;0;100;0;2,00E+05;820;244
40177;2023;1;1;0;100;0;233400;2483;94
40178;2023;13;13;0;100;0;312618.230769231;2287.07692307692;150.076923076923
40179;2023;20;20;0;100;0;356200;2985.3;117.95
40180;2023;14;14;0;100;0;180285.714285714;2001.42857142857;89.7857142857143
40181;2023;16;12;4;75;25;427868.4375;4926.3125;88.75
40182;2023;9;9;0;100;0;356297.222222222;3854.33333333333;104.444444444444
40183;2023;8;8;0;100;0;317938.875;2224.625;143.125
40184;2023;153;91;62;59.4771241830065;40.5228758169935;261543.568627451;3745.90196078431;75.7712418300654
40185;2023;3;3;0;100;0;117000;1292.33333333333;90.6666666666667
40186;2023;10;10;0;100;0;214206.8;1773.1;126.9
40187;2023;86;39;47;45.3488372093023;54.6511627906977;257914.988372093;5269.39534883721;50.1860465116279
40188;2023;6;6;0;100;0;207533.333333333;2014.33333333333;109.5
40190;2023;4;4;0;100;0;130312.5;1156.75;126.5
40191;2023;7;7;0;100;0;229442.857142857;1964.57142857143;125.285714285714
40192;2023;448;263;185;58.7053571428571;41.2946428571429;165988.75;2253.03794642857;76.4598214285714
40193;2023;1;1;0;100;0;158000;1975;80
40194;2023;17;14;3;82.3529411764706;17.6470588235294;169545.882352941;1763.58823529412;100.411764705882
40195;2023;5;4;1;80;20;159200;1596.8;96.6
40196;2023;5;5;0;100;0;264880;1906.6;141.2
40197;2023;58;57;1;98.2758620689655;1.72413793103448;172444.189655172;1991.8275862069;87.8965517241379
40198;2023;1;1;0;100;0;185090;1424;130
40199;2023;3;3;0;100;0;334684;2893.33333333333;120
40200;2023;5;5;0;100;0;262285.8;2776.2;96.4
40201;2023;11;10;1;90.9090909090909;9.09090909090909;138848.272727273;1352.27272727273;128.727272727273
40202;2023;27;27;0;100;0;272876.111111111;2752.92592592593;99.5925925925926
40203;2023;4;4;0;100;0;192250;2017.25;90.75
40204;2023;7;7;0;100;0;179925.285714286;1671;113.285714285714
40206;2023;4;4;0;100;0;247887.5;2594.75;99.75
40207;2023;6;6;0;100;0;272300;2698.83333333333;111.333333333333
40208;2023;1;1;0;100;0;332800;3053;109
40209;2023;97;50;47;51.5463917525773;48.4536082474227;345206.505154639;4489.48453608247;74.8453608247423
40210;2023;14;13;1;92.8571428571429;7.14285714285714;218385.714285714;2398.64285714286;92.8571428571429
40211;2023;7;6;1;85.7142857142857;14.2857142857143;343192.714285714;3062.85714285714;120.857142857143
40212;2023;8;8;0;100;0;238513.5;2444.125;110.25
40213;2023;4;3;1;75;25;438125;4125;108.5
40214;2023;6;6;0;100;0;305981.166666667;2629.83333333333;122
40215;2023;5;5;0;100;0;220238.4;2180;104.6
40216;2023;5;4;1;80;20;186060.2;1597.6;122.8
40217;2023;117;104;13;88.8888888888889;11.1111111111111;288203.811965812;3111.13675213675;94.1282051282051
40218;2023;6;6;0;100;0;150000;1193;136
40221;2023;3;3;0;100;0;158166.666666667;1619.33333333333;98.3333333333333
40222;2023;9;9;0;100;0;374441.888888889;3105;120.888888888889
40223;2023;2;2;0;100;0;290000;2912;99
40224;2023;44;38;6;86.3636363636364;13.6363636363636;226478.909090909;2236.20454545455;107.113636363636
40225;2023;2;2;0;100;0;205825;1721;120
40227;2023;15;14;1;93.3333333333333;6.66666666666667;288794;2595.93333333333;118.333333333333
40228;2023;11;11;0;100;0;208437.272727273;2610.27272727273;139.545454545455
40229;2023;22;21;1;95.4545454545455;4.54545454545455;262474.045454545;2676.22727272727;100.909090909091
40230;2023;24;21;3;87.5;12.5;217732.916666667;2437.58333333333;92.25
40231;2023;19;19;0;100;0;301814.105263158;3075.36842105263;99.7894736842105
40232;2023;5;5;0;100;0;186134;1838.2;110
40233;2023;29;27;2;93.1034482758621;6.89655172413793;252700.379310345;2284.51724137931;110.758620689655
40234;2023;8;8;0;100;0;188587.5;2041.5;89.25
40235;2023;10;9;1;90;10;166165;1998;95.6
40236;2023;8;8;0;100;0;233500;2332.875;97.375
40237;2023;12;11;1;91.6666666666667;8.33333333333333;189352.25;2072.75;101
40238;2023;6;6;0;100;0;201083.333333333;1838.83333333333;106.5
40240;2023;9;7;2;77.7777777777778;22.2222222222222;186222.222222222;1757.33333333333;106.666666666667
40242;2023;1;1;0;100;0;40000;556;72
40243;2023;37;32;5;86.4864864864865;13.5135135135135;190174.324324324;2013.32432432432;95.4324324324324
40244;2023;13;11;2;84.6153846153846;15.3846153846154;306821.153846154;2769.15384615385;109
40245;2023;23;23;0;100;0;197162.956521739;1748.4347826087;118.565217391304
40246;2023;11;11;0;100;0;233694.545454545;2327.18181818182;101.090909090909
40247;2023;1;1;0;100;0;73000;760;96
40248;2023;17;16;1;94.1176470588235;5.88235294117647;444687.411764706;4698.58823529412;100.529411764706
40249;2023;3;3;0;100;0;191126.666666667;2039.33333333333;96.6666666666667
40250;2023;6;6;0;100;0;230379;2417;97.5
40251;2023;6;6;0;100;0;470650;4165.66666666667;116.333333333333
40252;2023;1;1;0;100;0;280000;2154;130
40253;2023;11;10;1;90.9090909090909;9.09090909090909;147927.272727273;1320.36363636364;107.454545454545
40254;2023;3;3;0;100;0;285200;2426.33333333333;119.333333333333
40255;2023;2;2;0;100;0;135600;2111.5;61
40256;2023;5;5;0;100;0;262678;2362.6;110.4
40257;2023;21;21;0;100;0;291774.19047619;3194.85714285714;92.9047619047619
40258;2023;3;3;0;100;0;206000;2121;100.333333333333
40259;2023;5;5;0;100;0;115050;1188.6;97
40260;2023;5;5;0;100;0;164214;1769.4;96.8
40261;2023;33;31;2;93.9393939393939;6.06060606060606;331290;3263.0303030303;102.848484848485
40262;2023;2;2;0;100;0;153500;1393.5;107
40263;2023;4;4;0;100;0;165250;1625.75;101
40264;2023;20;19;1;95;5;382056.35;3471;110.05
40265;2023;1;1;0;100;0;103450;2028;51
40266;2023;33;22;11;66.6666666666667;33.3333333333333;264803.727272727;3633;77.8181818181818
40267;2023;8;8;0;100;0;201256.25;1583.625;127.875
40269;2023;8;8;0;100;0;316306.25;3190.75;106.875
40270;2023;2;2;0;100;0;162350;1314.5;118
40271;2023;10;10;0;100;0;346460;3223.2;110.4
40272;2023;14;12;2;85.7142857142857;14.2857142857143;330600.071428571;3697.14285714286;88.8571428571429
40273;2023;53;31;22;58.4905660377358;41.5094339622642;391194.547169811;4288.03773584906;91.6037735849057
40274;2023;13;13;0;100;0;216636.307692308;1775.53846153846;124.692307692308
40275;2023;9;9;0;100;0;202813.666666667;2024.44444444444;101.666666666667
40276;2023;5;5;0;100;0;456162.4;4676;99.2
40277;2023;8;8;0;100;0;249637.25;2531.375;97.875
40278;2023;19;19;0;100;0;247973.684210526;2725.84210526316;93.2105263157895
40279;2023;257;129;128;50.1945525291829;49.8054474708171;209968.525291829;2832.92217898833;74.3735408560311
40280;2023;24;16;8;66.6666666666667;33.3333333333333;181431.208333333;2349.83333333333;78.3333333333333
40281;2023;156;96;60;61.5384615384615;38.4615384615385;177900.448717949;2348.21794871795;78.1602564102564
40282;2023;74;65;9;87.8378378378378;12.1621621621622;166678.77027027;1732.37837837838;101.527027027027
40283;2023;36;26;10;72.2222222222222;27.7777777777778;242099.5;2674.25;85.9166666666667
40284;2023;126;69;57;54.7619047619048;45.2380952380952;281860.468253968;3662.96825396825;79.2539682539683
40285;2023;8;8;0;100;0;176469;1750;102
40286;2023;6;6;0;100;0;198025;1577.66666666667;130.833333333333
40287;2023;58;47;11;81.0344827586207;18.9655172413793;355403.310344828;3724.87931034483;98.6034482758621
40288;2023;13;13;0;100;0;140505;1565.30769230769;90.7692307692308
40289;2023;4;4;0;100;0;232183.25;1575.25;182.25
40291;2023;17;15;2;88.2352941176471;11.7647058823529;535500;5188.11764705882;98.6470588235294
40292;2023;16;16;0;100;0;567803.1875;4231.5625;140.4375
40293;2023;13;13;0;100;0;291660.846153846;2735.23076923077;102.384615384615
40294;2023;14;14;0;100;0;236485.714285714;2396.71428571429;99.3571428571429
40295;2023;15;15;0;100;0;248866.333333333;2214.33333333333;115.066666666667
40296;2023;162;75;87;46.2962962962963;53.7037037037037;491014.185185185;6870.24074074074;67.3395061728395
40297;2023;2;2;0;100;0;140000;1331;103
40298;2023;3;3;0;100;0;181433.333333333;1986.66666666667;108
40300;2023;11;11;0;100;0;248863.636363636;2612.90909090909;101.272727272727
40301;2023;2;2;0;100;0;429000;2902;146.5
40303;2023;6;6;0;100;0;206900;3527.33333333333;66.6666666666667
40304;2023;92;39;53;42.3913043478261;57.6086956521739;849469.923913043;9318.42391304348;82.5869565217391
40305;2023;3;3;0;100;0;266706;2367.33333333333;114.333333333333
40306;2023;6;6;0;100;0;255308.333333333;2251.16666666667;123.5
40307;2023;8;8;0;100;0;224422.5;2122.625;112.375
40308;2023;13;13;0;100;0;307280.769230769;2594.92307692308;118.769230769231
40309;2023;13;13;0;100;0;218487.153846154;1932.53846153846;124.615384615385
40310;2023;159;102;57;64.1509433962264;35.8490566037736;336158.477987421;4502.22641509434;76.5849056603774
40311;2023;5;5;0;100;0;279441.4;2725.6;104.4
40312;2023;109;73;36;66.9724770642202;33.0275229357798;353602.073394495;4294.33944954128;83.4954128440367
40313;2023;50;42;8;84;16;173068.4;1899.62;93.46
40314;2023;14;13;1;92.8571428571429;7.14285714285714;244092.214285714;2585.07142857143;92.0714285714286
40315;2023;6;6;0;100;0;245241.666666667;2225;109.333333333333
40316;2023;8;8;0;100;0;190307.5;1653.5;118.25
40317;2023;49;40;9;81.6326530612245;18.3673469387755;491885.102040816;4981.04081632653;100.020408163265
40318;2023;3;3;0;100;0;220333.333333333;1979.33333333333;117.666666666667
40319;2023;6;6;0;100;0;187116.666666667;2057.5;95.6666666666667
40320;2023;7;7;0;100;0;279257.142857143;1825;147
40321;2023;3;3;0;100;0;166833.333333333;1064.33333333333;151.333333333333
40322;2023;2;2;0;100;0;224500;2747.5;80
40323;2023;3;3;0;100;0;185533.333333333;1659.33333333333;114
40324;2023;1;1;0;100;0;307900;2932;105
40325;2023;6;6;0;100;0;204830.5;1586.83333333333;133
40326;2023;39;25;14;64.1025641025641;35.8974358974359;308369.666666667;4053.17948717949;78.6153846153846
40327;2023;2;2;0;100;0;195200;1837.5;106.5
40328;2023;80;27;53;33.75;66.25;294657.675;5720.675;53.8375
40329;2023;5;5;0;100;0;193000;1947.8;100.4
40331;2023;30;30;0;100;0;181458.166666667;1838;103.133333333333
40332;2023;28;28;0;100;0;243675.214285714;2709.28571428571;91.75
40333;2023;8;8;0;100;0;174725;2094.25;83
40334;2023;2;2;0;100;0;185600;1967;96.5
41001;2023;3;3;0;100;0;183666.666666667;1773.33333333333;92.3333333333333
41002;2023;9;9;0;100;0;155158.333333333;1251.77777777778;120.333333333333
41003;2023;6;6;0;100;0;189283.333333333;1586.5;117.5
41004;2023;6;6;0;100;0;83833.3333333333;1031;88.5
41006;2023;3;3;0;100;0;139333.333333333;1244;109.666666666667
41007;2023;8;8;0;100;0;150862.5;1798.875;82.75
41008;2023;12;10;2;83.3333333333333;16.6666666666667;139914.916666667;1695.25;85.4166666666667
41009;2023;4;4;0;100;0;149452.5;1803.25;88
41010;2023;9;9;0;100;0;238739.777777778;2054.77777777778;110.555555555556
41012;2023;3;3;0;100;0;106166.666666667;1396;70
41013;2023;2;1;1;50;50;142500;3338;66
41014;2023;3;3;0;100;0;207000;2127;98.6666666666667
41016;2023;12;12;0;100;0;157893.75;1571.66666666667;96.4166666666667
41017;2023;12;12;0;100;0;137108.333333333;1273.83333333333;106
41018;2023;666;242;424;36.3363363363363;63.6636636636637;141603.205705706;1944.1951951952;73.9054054054054
41019;2023;1;1;0;100;0;85000;590;144
41020;2023;10;10;0;100;0;87500;939.4;92.5
41022;2023;2;2;0;100;0;60900;955;66
41024;2023;3;3;0;100;0;136733.333333333;1172.66666666667;117.666666666667
41025;2023;16;14;2;87.5;12.5;146191.25;1883.75;81.375
41026;2023;3;3;0;100;0;124166.666666667;1404;90.3333333333333
41028;2023;5;5;0;100;0;100700;1063;88.4
41029;2023;8;8;0;100;0;174600;1641.5;101.125
41030;2023;3;3;0;100;0;146666.666666667;1304.33333333333;112
41031;2023;24;24;0;100;0;209658;2306.83333333333;100.333333333333
41032;2023;28;28;0;100;0;206367.5;2020.89285714286;106.071428571429
41035;2023;6;6;0;100;0;143047.5;1200;119.833333333333
41036;2023;7;7;0;100;0;353660.142857143;2191.57142857143;140.857142857143
41037;2023;3;3;0;100;0;131333.333333333;1675.66666666667;87.6666666666667
41038;2023;1;1;0;100;0;110200;1531;72
41039;2023;7;7;0;100;0;162628.571428571;1579.71428571429;109.571428571429
41040;2023;4;4;0;100;0;175875;2021.25;86
41041;2023;3;3;0;100;0;186266.666666667;1128.33333333333;150.666666666667
41042;2023;4;4;0;100;0;64372.5;924.75;65.25
41043;2023;23;23;0;100;0;132311.217391304;1437.60869565217;100.782608695652
41044;2023;15;15;0;100;0;102850;1066.8;97.6666666666667
41045;2023;11;11;0;100;0;167702.181818182;1691.09090909091;101.363636363636
41046;2023;8;8;0;100;0;199931.25;2105.125;96.75
41047;2023;54;29;25;53.7037037037037;46.2962962962963;177708.888888889;2025.48148148148;87.1851851851852
41048;2023;2;2;0;100;0;126000;1160;109.5
41049;2023;9;9;0;100;0;148147;1559.33333333333;97.4444444444444
41050;2023;9;9;0;100;0;266723;2434.44444444444;112.666666666667
41051;2023;17;17;0;100;0;141294.117647059;1555;94
41052;2023;18;18;0;100;0;270306.111111111;2002.44444444444;129.222222222222
41053;2023;3;3;0;100;0;150333.333333333;1703.33333333333;99.3333333333333
41054;2023;6;6;0;100;0;124533.333333333;1308.66666666667;97
41055;2023;30;30;0;100;0;208339.1;1796.2;117.666666666667
41057;2023;5;5;0;100;0;115268;1163.6;95.8
41058;2023;1;1;0;100;0;181350;1796;101
41059;2023;89;86;3;96.6292134831461;3.37078651685393;146720.202247191;1719.75280898876;87.6404494382023
41060;2023;8;8;0;100;0;70198.75;890.375;78
41061;2023;13;13;0;100;0;180647.461538462;1738.23076923077;104.615384615385
41062;2023;6;6;0;100;0;118433.333333333;1683;70.1666666666667
41063;2023;7;7;0;100;0;132642.857142857;1873.42857142857;72.8571428571429
41065;2023;9;8;1;88.8888888888889;11.1111111111111;165000;1653.77777777778;96.2222222222222
41066;2023;1;1;0;100;0;169100;966;175
41067;2023;36;36;0;100;0;189337.25;2038.38888888889;105.694444444444
41068;2023;4;4;0;100;0;234810;2332.25;83.75
41069;2023;4;4;0;100;0;146190.25;1559;84.25
41070;2023;13;13;0;100;0;99292.3076923077;1046.15384615385;93.6923076923077
41071;2023;7;7;0;100;0;152448.571428571;1591.85714285714;99.7142857142857
41072;2023;4;4;0;100;0;127250;1313;91.25
41073;2023;7;7;0;100;0;133389.428571429;2154.71428571429;70.1428571428571
41074;2023;22;22;0;100;0;136783.636363636;1476.59090909091;101.363636363636
41075;2023;8;8;0;100;0;67803.125;974;74.875
41077;2023;1;1;0;100;0;30000;429;70
41078;2023;7;6;1;85.7142857142857;14.2857142857143;95000;1160.85714285714;85.1428571428571
41079;2023;3;3;0;100;0;129000;1488.66666666667;87.6666666666667
41080;2023;10;10;0;100;0;183511.5;1538.4;121.1
41081;2023;3;3;0;100;0;110000;1031.66666666667;100.333333333333
41083;2023;6;6;0;100;0;121416.666666667;1331.16666666667;88.1666666666667
41084;2023;12;12;0;100;0;117820.833333333;1346.91666666667;92.4166666666667
41085;2023;20;20;0;100;0;153200;1800.2;90.3
41086;2023;6;6;0;100;0;176624.666666667;1805;100.5
41087;2023;8;8;0;100;0;99029.875;1267.375;75.5
41088;2023;2;2;0;100;0;103500;1858;64
41089;2023;6;6;0;100;0;111708.333333333;907.666666666667;100.333333333333
41090;2023;6;6;0;100;0;135383.333333333;1172.66666666667;104.333333333333
41091;2023;6;6;0;100;0;331669.166666667;2422.66666666667;113.833333333333
41093;2023;1;1;0;100;0;260300;1094;238
41094;2023;21;21;0;100;0;229290.476190476;2094.57142857143;112.47619047619
41095;2023;18;18;0;100;0;119632.222222222;1578.72222222222;76.7222222222222
41096;2023;7;7;0;100;0;98802;1077.71428571429;82.7142857142857
41097;2023;37;37;0;100;0;129498.648648649;1310.45945945946;98.1351351351351
41098;2023;3;3;0;100;0;127000;1337;92.6666666666667
41099;2023;10;10;0;100;0;123671;1463.2;85.7
41100;2023;5;5;0;100;0;85000;911;101.2
41101;2023;12;12;0;100;0;142891;1457.08333333333;107.333333333333
41102;2023;5;5;0;100;0;165424;1196.6;121.2
41103;2023;4;4;0;100;0;131750;1117.5;112.5
41104;2023;22;22;0;100;0;213280.590909091;2155.72727272727;103.227272727273
41105;2023;19;19;0;100;0;172894.210526316;1609.10526315789;112.947368421053
41106;2023;59;57;2;96.6101694915254;3.38983050847458;186162.203389831;2027.45762711864;95.7627118644068
41107;2023;7;7;0;100;0;95714.2857142857;1331.28571428571;78.5714285714286
41108;2023;3;3;0;100;0;101666.666666667;945.333333333333;117
41109;2023;7;7;0;100;0;209305.714285714;1581.71428571429;142.857142857143
41110;2023;11;11;0;100;0;134345.454545455;1402.63636363636;99.9090909090909
41112;2023;2;2;0;100;0;357500;3441;98.5
41113;2023;3;3;0;100;0;163666.666666667;1493.33333333333;96
41114;2023;6;6;0;100;0;211000;1900;117.333333333333
41115;2023;2;2;0;100;0;185000;1672.5;110
41116;2023;2;2;0;100;0;123000;1243;95
41118;2023;4;4;0;100;0;328137.25;2818.5;111
41119;2023;3;3;0;100;0;100916.666666667;1626.66666666667;65.6666666666667
41120;2023;17;17;0;100;0;132529.411764706;1291.94117647059;109.529411764706
41122;2023;5;5;0;100;0;95602;906.2;103.4
41123;2023;6;6;0;100;0;104700;1189.16666666667;91.8333333333333
41124;2023;4;4;0;100;0;220687.5;1687.5;141.75
41125;2023;15;15;0;100;0;118506.666666667;1308.46666666667;89.9333333333333
41126;2023;18;18;0;100;0;162459.888888889;1630.22222222222;105.166666666667
41127;2023;5;5;0;100;0;136500;1833;76.8
41128;2023;8;8;0;100;0;177015.75;1795.625;96.75
41129;2023;5;5;0;100;0;199140;1829;101.6
41130;2023;6;6;0;100;0;141908.333333333;1197.83333333333;114
41131;2023;7;7;0;100;0;239828.571428571;1759;130.142857142857
41132;2023;4;4;0;100;0;149250;2101;79
41134;2023;5;4;1;80;20;170840;1792.6;97
41135;2023;20;20;0;100;0;91173.5;1060.25;91.9
41136;2023;75;65;10;86.6666666666667;13.3333333333333;149891.84;1682.32;91.84
41137;2023;5;5;0;100;0;138538;1433.6;92.2
41138;2023;3;3;0;100;0;140666.666666667;1836.66666666667;71.6666666666667
41139;2023;14;14;0;100;0;97535.7142857143;1131.57142857143;85.9285714285714
41140;2023;14;14;0;100;0;173755.714285714;1674;99.7142857142857
41141;2023;4;4;0;100;0;61250;720;91
41142;2023;23;23;0;100;0;216523.565217391;1815.4347826087;114.521739130435
41143;2023;17;16;1;94.1176470588235;5.88235294117647;102753.588235294;1152.82352941176;91.1764705882353
41144;2023;10;10;0;100;0;184910;1648.3;109.9
41145;2023;6;6;0;100;0;178666.666666667;1637.5;107.166666666667
41146;2023;11;11;0;100;0;112954.545454545;1350.09090909091;84.9090909090909
41147;2023;24;24;0;100;0;190389.583333333;1878.5;100.875
41148;2023;8;8;0;100;0;144717.5;1862.625;79.125
41149;2023;52;50;2;96.1538461538462;3.84615384615385;137008.076923077;1537.98076923077;89.9807692307692
41150;2023;23;23;0;100;0;237890;2303.91304347826;106.347826086957
41151;2023;62;52;10;83.8709677419355;16.1290322580645;127324.741935484;1444.29032258065;89.9032258064516
41152;2023;5;5;0;100;0;279200;2264;112
41153;2023;3;3;0;100;0;148333.333333333;1803.33333333333;72
41154;2023;17;17;0;100;0;78765.2941176471;1297;65.9411764705882
41155;2023;10;10;0;100;0;168730;1601;119.6
41156;2023;6;6;0;100;0;234567.166666667;1497.5;162
41157;2023;16;16;0;100;0;149512.1875;1490.5625;100.8125
41158;2023;29;25;4;86.2068965517241;13.7931034482759;171179.413793103;2155.62068965517;90.1034482758621
41159;2023;10;10;0;100;0;238222.2;2707.6;91.2
41160;2023;5;5;0;100;0;214260;1854.6;123.2
41161;2023;26;25;1;96.1538461538462;3.84615384615385;150986.538461538;1614.26923076923;99.1538461538462
41163;2023;2;2;0;100;0;167500;1196.5;140
41164;2023;46;46;0;100;0;138021.5;1472.21739130435;102
41166;2023;6;6;0;100;0;198714.166666667;1634.83333333333;126
41167;2023;45;45;0;100;0;191082;1855.84444444444;102.688888888889
41168;2023;2;2;0;100;0;109500;1117;98
41171;2023;20;20;0;100;0;123415;1327.15;99
41172;2023;3;3;0;100;0;168833.333333333;1289;132
41173;2023;43;41;2;95.3488372093023;4.65116279069767;138467.441860465;1471.88372093023;100.186046511628
41174;2023;4;4;0;100;0;183515;2086.5;113.25
41175;2023;18;18;0;100;0;116728.333333333;1273;98.3333333333333
41176;2023;16;15;1;93.75;6.25;165927.1875;2170.5625;94.5
41177;2023;6;6;0;100;0;122166.666666667;1555.16666666667;102.333333333333
41179;2023;1;1;0;100;0;75000;1172;64
41180;2023;15;14;1;93.3333333333333;6.66666666666667;126064.466666667;1567.66666666667;82.7333333333333
41181;2023;14;14;0;100;0;131954.357142857;1380.21428571429;96
41182;2023;1;1;0;100;0;60000;667;90
41184;2023;6;6;0;100;0;96483.3333333333;955.166666666667;106
41185;2023;24;24;0;100;0;156633.333333333;1367.45833333333;111.541666666667
41186;2023;1;1;0;100;0;155100;1385;112
41187;2023;5;5;0;100;0;200400;1633.8;120.2
41189;2023;4;4;0;100;0;229215;1919.25;110.75
41190;2023;5;5;0;100;0;137400;1400;99.8
41191;2023;1;1;0;100;0;49000;1021;48
41192;2023;4;4;0;100;0;93250;984.5;98.25
41193;2023;2;2;0;100;0;53000;1018.5;54
41194;2023;261;233;28;89.272030651341;10.727969348659;136419.249042146;1550.77394636015;89.6245210727969
41195;2023;2;2;0;100;0;275000;2419.5;112
41196;2023;1;1;0;100;0;160000;994;161
41198;2023;49;45;4;91.8367346938776;8.16326530612245;115778.897959184;1208.95918367347;97.5510204081633
41199;2023;8;8;0;100;0;154375;1640.75;100.75
41200;2023;1;1;0;100;0;214200;1770;121
41201;2023;3;3;0;100;0;138113.333333333;1125.66666666667;133.333333333333
41203;2023;3;3;0;100;0;151258.333333333;1462.66666666667;95.3333333333333
41204;2023;19;19;0;100;0;221736.526315789;1820.89473684211;124.052631578947
41205;2023;3;3;0;100;0;90080;1055.33333333333;82.6666666666667
41206;2023;10;10;0;100;0;235860;2049;113.7
41207;2023;13;13;0;100;0;149907.692307692;1474.15384615385;96.5384615384615
41208;2023;1;1;0;100;0;210000;1842;114
41209;2023;15;15;0;100;0;156140;1490.06666666667;108.066666666667
41211;2023;36;36;0;100;0;183977.777777778;1789.13888888889;105.305555555556
41212;2023;35;32;3;91.4285714285714;8.57142857142857;193178.885714286;2062.05714285714;94.2
41213;2023;2;2;0;100;0;134000;1425.5;94.5
41214;2023;13;13;0;100;0;109688.461538462;1167.76923076923;88.4615384615385
41215;2023;2;2;0;100;0;43000;766.5;52.5
41216;2023;7;7;0;100;0;91307.1428571429;1035.42857142857;91.1428571428571
41217;2023;11;11;0;100;0;155260;1577.63636363636;96.7272727272727
41218;2023;14;13;1;92.8571428571429;7.14285714285714;144920;1422.5;93.5714285714286
41219;2023;11;11;0;100;0;138363.636363636;1408.81818181818;107
41220;2023;56;51;5;91.0714285714286;8.92857142857143;157899.107142857;1623.44642857143;102.892857142857
41221;2023;6;6;0;100;0;138583.333333333;1348.66666666667;102.333333333333
41222;2023;3;3;0;100;0;94500;1072;83.6666666666667
41223;2023;7;7;0;100;0;187817.142857143;1855.57142857143;101.571428571429
41224;2023;3;3;0;100;0;197666.666666667;1746.33333333333;122
41225;2023;5;5;0;100;0;121920;1085.8;105.8
41226;2023;38;38;0;100;0;181835.921052632;1884.26315789474;100.210526315789
41228;2023;6;6;0;100;0;80250;1062.33333333333;73.5
41229;2023;14;14;0;100;0;156338.357142857;1405.78571428571;115.714285714286
41230;2023;12;12;0;100;0;207931.25;1887.25;114.333333333333
41231;2023;20;20;0;100;0;154480.5;1515.1;98.6
41232;2023;63;60;3;95.2380952380952;4.76190476190476;121952.698412698;1295;94.1111111111111
41233;2023;6;6;0;100;0;86500;1087;87
41234;2023;4;4;0;100;0;119750;1341.75;123
41235;2023;8;8;0;100;0;172150;1431.5;120.375
41237;2023;13;13;0;100;0;138118.461538462;1500.69230769231;87.6923076923077
41238;2023;36;36;0;100;0;105004.25;1219.61111111111;81.8055555555556
41239;2023;17;17;0;100;0;151229.588235294;1522.11764705882;102.058823529412
41241;2023;20;20;0;100;0;143218.85;1333.8;97.2
41242;2023;70;66;4;94.2857142857143;5.71428571428571;96169.4285714286;1301.47142857143;76.6
41243;2023;10;10;0;100;0;133950;1497.2;92.4
41245;2023;3;3;0;100;0;166550;1642.33333333333;101.333333333333
41246;2023;5;5;0;100;0;198970;1586.8;131.4
41247;2023;24;24;0;100;0;190170.416666667;1889.83333333333;104.083333333333
41248;2023;19;19;0;100;0;90010.5263157895;1163.89473684211;77.5789473684211
41249;2023;15;15;0;100;0;125526;1344.6;88.6
41250;2023;2;2;0;100;0;230000;1372.5;153.5
41251;2023;6;6;0;100;0;140060;1909.5;82.3333333333333
41252;2023;14;14;0;100;0;146763.928571429;1527.57142857143;101.714285714286
41253;2023;4;4;0;100;0;158625;1526.25;104.5
41254;2023;1;1;0;100;0;35000;507;69
41255;2023;6;6;0;100;0;112916.666666667;1130.83333333333;101.666666666667
41256;2023;13;13;0;100;0;112584.615384615;1356.23076923077;82.5384615384615
41258;2023;15;15;0;100;0;132591.666666667;1290.86666666667;102.733333333333
41259;2023;7;7;0;100;0;159857.142857143;1754;88.5714285714286
41260;2023;4;4;0;100;0;225346.5;1960.5;124
41261;2023;2;2;0;100;0;212550;2307;81
41262;2023;6;6;0;100;0;183570;1798.66666666667;109.833333333333
41265;2023;9;9;0;100;0;169840.666666667;1710.44444444444;100.333333333333
41266;2023;3;3;0;100;0;217483.333333333;1386;160.666666666667
41267;2023;8;8;0;100;0;224062.5;1798;129.125
41268;2023;1;1;0;100;0;63600;731;87
41269;2023;219;128;91;58.4474885844749;41.5525114155251;164555.205479452;1938.81278538813;83.972602739726
41271;2023;11;11;0;100;0;140909.090909091;1385.63636363636;107.272727272727
41273;2023;4;4;0;100;0;141000;980;126.75
41274;2023;3;3;0;100;0;152333.333333333;1061.33333333333;126.333333333333
41275;2023;8;8;0;100;0;136958.75;1653.625;83.375
41276;2023;16;10;6;62.5;37.5;146110.9375;1844.75;78.3125
41277;2023;2;2;0;100;0;131000;1291.5;100.5
41278;2023;7;7;0;100;0;124771.428571429;1454;86.8571428571429
41279;2023;9;9;0;100;0;95122.2222222222;1000.77777777778;93.5555555555556
41280;2023;49;49;0;100;0;108304.693877551;1102.67346938776;97.1632653061225
41281;2023;4;4;0;100;0;162752.5;1728.75;95.25
41282;2023;2;2;0;100;0;66000;778;85.5
41285;2023;8;8;0;100;0;128922.25;1468.25;85.125
41286;2023;2;2;0;100;0;161500;2323;71.5
41287;2023;6;6;0;100;0;192950;1697.33333333333;109.666666666667
41288;2023;10;10;0;100;0;199150;2046.8;96.4
41289;2023;5;5;0;100;0;131740;1914;83.2
41290;2023;1;1;0;100;0;150000;1103;136
41291;2023;3;3;0;100;0;161250;1362.66666666667;118.666666666667
41292;2023;2;2;0;100;0;120000;1095;109
41293;2023;2;2;0;100;0;184922.5;1875;98.5
41294;2023;10;10;0;100;0;203345;2002.5;99.9
41295;2023;74;65;9;87.8378378378378;12.1621621621622;212173.513513514;2154.24324324324;99.3918918918919
41296;2023;7;7;0;100;0;188000;1957.57142857143;96
41297;2023;6;6;0;100;0;160333.333333333;1878.5;97.3333333333333
42001;2023;5;5;0;100;0;174824;1705.2;100.6
42002;2023;2;2;0;100;0;188090;3157.5;58.5
42003;2023;21;21;0;100;0;176126.19047619;1596.2380952381;105.095238095238
42005;2023;102;49;53;48.0392156862745;51.9607843137255;205569.578431373;2343.46078431373;85.8921568627451
42006;2023;7;7;0;100;0;146878.571428571;1513.57142857143;95
42007;2023;2;2;0;100;0;311925;2280.5;138.5
42008;2023;1;1;0;100;0;150000;1282;117
42009;2023;6;6;0;100;0;129000;1317;101
42010;2023;14;13;1;92.8571428571429;7.14285714285714;245778;2521.85714285714;99.2857142857143
42011;2023;26;24;2;92.3076923076923;7.69230769230769;168309.230769231;2006.38461538462;89.6923076923077
42012;2023;8;8;0;100;0;183747.5;2487.25;75.5
42013;2023;18;18;0;100;0;223326.333333333;2302.05555555556;98.5
42014;2023;7;7;0;100;0;133252.857142857;1725.42857142857;77.4285714285714
42015;2023;16;16;0;100;0;140112.5;1547.9375;86.3125
42016;2023;6;6;0;100;0;201558.333333333;1831.66666666667;111.5
42017;2023;12;11;1;91.6666666666667;8.33333333333333;180319.083333333;2126.25;84.8333333333333
42018;2023;5;5;0;100;0;198820;1903.4;107.4
42019;2023;34;27;7;79.4117647058823;20.5882352941176;111919.264705882;1259.41176470588;85.1470588235294
42020;2023;16;14;2;87.5;12.5;238857.1875;2209.625;106.8125
42021;2023;11;11;0;100;0;251654.545454545;3090.81818181818;95.3636363636364
42022;2023;32;30;2;93.75;6.25;237463.9375;2532.03125;93.96875
42023;2023;28;16;12;57.1428571428571;42.8571428571429;155824.25;1464.10714285714;108.75
42025;2023;1;1;0;100;0;320100;1905;168
42026;2023;21;20;1;95.2380952380952;4.76190476190476;114620.952380952;1358.38095238095;84.2857142857143
42027;2023;5;5;0;100;0;71700;937;71.4
42028;2023;11;11;0;100;0;141286.363636364;2077.63636363636;78.0909090909091
42029;2023;14;14;0;100;0;115478.571428571;1431.21428571429;85.7142857142857
42030;2023;8;7;1;87.5;12.5;163484.625;1933.125;90.625
42031;2023;1;1;0;100;0;290000;2164;134
42032;2023;11;11;0;100;0;213427.272727273;2004.27272727273;104.454545454545
42033;2023;2;2;0;100;0;84251;702;120
42034;2023;2;2;0;100;0;110000;1139.5;102.5
42035;2023;4;4;0;100;0;208926.25;1527.75;135.75
42036;2023;5;5;0;100;0;272168.6;2964.8;98.4
42037;2023;5;5;0;100;0;199760;1866.6;101.4
42038;2023;8;8;0;100;0;243893.75;2518.875;98.75
42039;2023;11;10;1;90.9090909090909;9.09090909090909;109154.545454545;1036.45454545455;111
42041;2023;8;8;0;100;0;207483.75;1980;104.5
42042;2023;7;7;0;100;0;274260;2402.71428571429;117.857142857143
42043;2023;9;9;0;100;0;317122.222222222;2986.55555555556;105.333333333333
42044;2023;86;51;35;59.3023255813954;40.6976744186046;149105.790697674;1668.96511627907;87.8023255813954
42045;2023;1;1;0;100;0;127900;2558;50
42046;2023;22;22;0;100;0;221620.181818182;2131.72727272727;107.272727272727
42047;2023;8;8;0;100;0;104286.25;1418;79.625
42048;2023;13;13;0;100;0;214942.307692308;1750.61538461538;124.692307692308
42049;2023;6;6;0;100;0;120450;1261.5;110.166666666667
42051;2023;2;2;0;100;0;438960;3108;150
42052;2023;40;21;19;52.5;47.5;152840.625;1562.875;99.925
42053;2023;7;7;0;100;0;315242.857142857;3106.14285714286;99.5714285714286
42054;2023;1;1;0;100;0;170000;1453;117
42055;2023;1;1;0;100;0;120000;2000;60
42056;2023;32;29;3;90.625;9.375;218736.625;2208.5;99.75
42058;2023;3;3;0;100;0;170000;2186;77.6666666666667
42059;2023;52;41;11;78.8461538461538;21.1538461538462;217016.634615385;2214.86538461538;98.8461538461538
42060;2023;6;6;0;100;0;194556.666666667;2252.83333333333;98.3333333333333
42061;2023;3;3;0;100;0;128420;1216;109
42062;2023;10;10;0;100;0;234335;2476.2;101.6
42063;2023;3;3;0;100;0;131666.666666667;1379.33333333333;94
42064;2023;6;6;0;100;0;290970.833333333;2729.16666666667;107.666666666667
42065;2023;10;10;0;100;0;223520;1987.7;112.6
42066;2023;3;3;0;100;0;179816.666666667;1952.33333333333;88.3333333333333
42068;2023;4;4;0;100;0;210562.5;2029.5;104
42069;2023;23;23;0;100;0;231294.173913043;2055.91304347826;111.739130434783
42070;2023;14;14;0;100;0;210250;1889.92857142857;100.142857142857
42071;2023;126;51;75;40.4761904761905;59.5238095238095;128444.920634921;1617.42063492063;80.4523809523809
42072;2023;1;1;0;100;0;162000;1246;130
42073;2023;11;11;0;100;0;198369.090909091;1905.54545454545;120.090909090909
42074;2023;6;6;0;100;0;185221.666666667;1820.66666666667;103.166666666667
42075;2023;12;12;0;100;0;253983.333333333;2460.25;103.583333333333
42076;2023;7;7;0;100;0;117551.428571429;1017;114
42077;2023;2;2;0;100;0;298250;1520;226.5
42078;2023;3;3;0;100;0;177300;1291;137
42079;2023;7;7;0;100;0;156985.714285714;1538.71428571429;102.714285714286
42081;2023;10;10;0;100;0;270750;2465.6;110.8
42083;2023;1;1;0;100;0;347300;3816;91
42085;2023;6;6;0;100;0;243500;2773.16666666667;94
42086;2023;6;6;0;100;0;227616.666666667;1988.16666666667;115.5
42087;2023;14;14;0;100;0;266891.428571429;2330.07142857143;115.785714285714
42088;2023;10;10;0;100;0;205754.9;2124.4;105
42089;2023;6;6;0;100;0;218383.333333333;2276.83333333333;109.666666666667
42090;2023;10;9;1;90;10;149370.5;1458.8;97.9
42091;2023;7;6;1;85.7142857142857;14.2857142857143;187930.714285714;1848.71428571429;106.428571428571
42092;2023;27;17;10;62.962962962963;37.037037037037;286714.851851852;2717.92592592593;108.111111111111
42093;2023;13;13;0;100;0;316330.769230769;3127.46153846154;101.846153846154
42094;2023;97;46;51;47.4226804123711;52.5773195876289;158363.010309278;2002.57731958763;77.9896907216495
42095;2023;166;44;122;26.5060240963855;73.4939759036145;110937.668674699;1348.74096385542;81.1927710843374
42096;2023;10;10;0;100;0;233355;2077.5;117.6
42097;2023;45;33;12;73.3333333333333;26.6666666666667;281077.177777778;2641.77777777778;101.533333333333
42098;2023;11;11;0;100;0;188048.181818182;1699.09090909091;111.818181818182
42099;2023;24;14;10;58.3333333333333;41.6666666666667;175908.333333333;1970.625;85.7083333333333
42100;2023;2;2;0;100;0;183000;1857;83.5
42101;2023;2;2;0;100;0;211000;1280.5;166
42102;2023;2;2;0;100;0;155000;1521.5;91.5
42103;2023;31;17;14;54.8387096774194;45.1612903225806;188100.870967742;2247.77419354839;84.5483870967742
42104;2023;10;9;1;90;10;135000;1284.7;98.1
42105;2023;1;1;0;100;0;135000;1227;110
42106;2023;1;1;0;100;0;2,00E+05;1818;110
42107;2023;4;4;0;100;0;154503.75;1469.5;110.5
42108;2023;10;10;0;100;0;264500;2469.1;113.2
42109;2023;3;3;0;100;0;108233.333333333;1130.66666666667;94.3333333333333
42110;2023;34;24;10;70.5882352941177;29.4117647058824;216456.235294118;2254.20588235294;97.3529411764706
42112;2023;2;2;0;100;0;210000;2708.5;70
42113;2023;2;2;0;100;0;248500;2047;122
42115;2023;17;14;3;82.3529411764706;17.6470588235294;185203;1835.88235294118;105.176470588235
42116;2023;5;5;0;100;0;126200;1191.2;98.8
42117;2023;3;3;0;100;0;193650;1662;108.333333333333
42118;2023;9;9;0;100;0;188801.666666667;1515.66666666667;115
42119;2023;5;5;0;100;0;132699;1449.2;95.4
42120;2023;17;17;0;100;0;254088.823529412;2221.05882352941;114.176470588235
42121;2023;2;2;0;100;0;172160;2530.5;79.5
42122;2023;7;7;0;100;0;198744.571428571;1911.85714285714;96.8571428571429
42123;2023;43;20;23;46.5116279069767;53.4883720930233;217081.511627907;2544.13953488372;88.5813953488372
42124;2023;2;2;0;100;0;310200;3040;103.5
42125;2023;3;3;0;100;0;101146.666666667;1059;117.666666666667
42126;2023;16;16;0;100;0;183115.625;2002.0625;94.8125
42127;2023;74;70;4;94.5945945945946;5.40540540540541;159849.864864865;1859.2027027027;87.5675675675676
42128;2023;3;3;0;100;0;167666.666666667;1303.66666666667;129.333333333333
42129;2023;15;15;0;100;0;251585.333333333;2381.26666666667;109.666666666667
42130;2023;4;4;0;100;0;191750;1569.75;135.5
42131;2023;3;3;0;100;0;203300;1579;125.666666666667
42132;2023;3;3;0;100;0;291993.333333333;2181.33333333333;132.666666666667
42133;2023;3;3;0;100;0;171666.666666667;2230.66666666667;81
42134;2023;12;11;1;91.6666666666667;8.33333333333333;205251.25;1929.83333333333;109.333333333333
42135;2023;4;4;0;100;0;300134;2843.5;103.25
42136;2023;5;5;0;100;0;205060;1941;103.4
42137;2023;10;10;0;100;0;215370;2097.6;102.6
42138;2023;7;7;0;100;0;240702.857142857;2363.57142857143;101.428571428571
42139;2023;12;11;1;91.6666666666667;8.33333333333333;224558.333333333;1781.33333333333;116.333333333333
42140;2023;6;6;0;100;0;122250;2371.66666666667;70.3333333333333
42141;2023;3;3;0;100;0;186333.333333333;1489.66666666667;120
42142;2023;1;1;0;100;0;103000;1321;78
42143;2023;3;3;0;100;0;212266.666666667;1732.33333333333;121.666666666667
42145;2023;10;8;2;80;20;192275;1698.5;110
42146;2023;2;2;0;100;0;106666.5;578;185
42147;2023;225;105;120;46.6666666666667;53.3333333333333;181344.693333333;2080.44;86.3644444444444
42148;2023;7;7;0;100;0;124285.714285714;1219.85714285714;97.1428571428571
42149;2023;69;40;29;57.9710144927536;42.0289855072464;198492.855072464;2359.79710144928;85.9130434782609
42150;2023;19;18;1;94.7368421052632;5.26315789473684;276250.526315789;3000.36842105263;96.6315789473684
42151;2023;6;6;0;100;0;175990;1727.16666666667;99.1666666666667
42152;2023;5;5;0;100;0;221334;2172.8;108.4
42153;2023;2;2;0;100;0;87500;1668.5;58
42154;2023;7;7;0;100;0;147500;1663.57142857143;86.2857142857143
42155;2023;12;12;0;100;0;179675;1691.5;117.166666666667
42156;2023;9;9;0;100;0;147032.777777778;1367.77777777778;106.111111111111
42157;2023;10;10;0;100;0;176240;1746;105.8
42158;2023;7;7;0;100;0;133521.428571429;1110.42857142857;115.285714285714
42159;2023;14;12;2;85.7142857142857;14.2857142857143;95131.1428571429;1262.57142857143;79
42160;2023;4;4;0;100;0;116348.75;1059;111.25
42161;2023;4;4;0;100;0;503887.5;3289.5;172.5
42162;2023;10;10;0;100;0;190660;1662.6;106.4
42163;2023;9;8;1;88.8888888888889;11.1111111111111;117700.888888889;1129.33333333333;95.1111111111111
42164;2023;2;2;0;100;0;112500;1200.5;104
42165;2023;48;42;6;87.5;12.5;144380.4375;1582.5;90.3333333333333
42166;2023;4;4;0;100;0;202750;2308;88.5
42167;2023;2;1;1;50;50;132905;954;126.5
42168;2023;36;23;13;63.8888888888889;36.1111111111111;168171.944444444;1978.94444444444;90.6111111111111
42169;2023;11;11;0;100;0;214461.818181818;2382.36363636364;89.5454545454545
42170;2023;13;13;0;100;0;200030.769230769;3522.15384615385;93.2307692307692
42171;2023;2;2;0;100;0;181500;1501.5;115.5
42172;2023;6;4;2;66.6666666666667;33.3333333333333;289916.666666667;2240;122.666666666667
42173;2023;3;3;0;100;0;223333.333333333;1763;121
42174;2023;11;11;0;100;0;199629.090909091;1955;101.818181818182
42175;2023;10;9;1;90;10;155064;1522.6;99
42176;2023;20;20;0;100;0;227892.5;2232.55;99.8
42177;2023;40;36;4;90;10;169036.025;1674.05;96.775
42178;2023;6;6;0;100;0;304166.666666667;1814.66666666667;151.833333333333
42179;2023;7;7;0;100;0;179000;1683.14285714286;105.428571428571
42180;2023;7;7;0;100;0;246660;2348;114.142857142857
42181;2023;13;11;2;84.6153846153846;15.3846153846154;105403.846153846;1064;100.923076923077
42182;2023;41;37;4;90.2439024390244;9.75609756097561;189053.414634146;1901.24390243902;99.2926829268293
42183;2023;55;25;30;45.4545454545455;54.5454545454545;111699.545454545;1268.69090909091;83.0181818181818
42184;2023;197;127;70;64.4670050761421;35.5329949238579;166099.258883249;1902.8730964467;84.8680203045685
42185;2023;2;2;0;100;0;253980;2506.5;102.5
42186;2023;118;64;54;54.2372881355932;45.7627118644068;177163.779661017;1994.33898305085;85.5593220338983
42187;2023;660;165;495;25;75;115891.498484848;1495.91515151515;75.5378787878788
42188;2023;4;4;0;100;0;145625;1640;88.75
42189;2023;109;54;55;49.5412844036697;50.4587155963303;206282.100917431;2169.35779816514;92.394495412844
42191;2023;8;8;0;100;0;224022.875;2617.875;92.125
42192;2023;5;5;0;100;0;117700;1209.4;92
42193;2023;10;10;0;100;0;191392.3;2015.9;100.2
42194;2023;3;3;0;100;0;110600;1368.66666666667;84.3333333333333
42195;2023;21;16;5;76.1904761904762;23.8095238095238;96176.1904761905;1167.95238095238;81.6190476190476
42197;2023;10;10;0;100;0;196410;1786.2;111.9
42198;2023;13;12;1;92.3076923076923;7.69230769230769;154699.230769231;1482.15384615385;103.307692307692
42199;2023;18;18;0;100;0;223638.888888889;2191.44444444444;100.722222222222
42200;2023;12;12;0;100;0;245951.666666667;2356.66666666667;106.416666666667
42201;2023;6;6;0;100;0;223743.833333333;2101.16666666667;102.666666666667
42202;2023;1;1;0;100;0;119000;2288;52
42203;2023;1;1;0;100;0;120000;1446;83
42204;2023;16;10;6;62.5;37.5;143895.5625;1445.4375;88.75
42205;2023;4;4;0;100;0;146125;1675.5;78.75
42206;2023;12;12;0;100;0;255784.333333333;2426.83333333333;100.166666666667
42207;2023;362;124;238;34.2541436464088;65.7458563535912;153270.582872928;1748.69060773481;85.9779005524862
42208;2023;7;7;0;100;0;171171.428571429;1857;92.7142857142857
42209;2023;5;5;0;100;0;203000;1951.4;105
42210;2023;3;3;0;100;0;217666.666666667;1988.66666666667;117.333333333333
42211;2023;21;18;3;85.7142857142857;14.2857142857143;228737.380952381;2585;91.5714285714286
42212;2023;10;9;1;90;10;264470;2229.5;113.4
42213;2023;2;2;0;100;0;227500;3107.5;74
42214;2023;8;8;0;100;0;259352.5;2416.25;105.625
42215;2023;13;13;0;100;0;186325.384615385;1747.23076923077;106.538461538462
42216;2023;4;4;0;100;0;241930;2170;112.75
42217;2023;5;5;0;100;0;64580.8;822.8;78.6
42218;2023;2858;211;2647;7.38278516445066;92.6172148355493;98983.921973408;1419.90027991603;69.7123862841148
42219;2023;10;10;0;100;0;197190;2071.8;99.7
42220;2023;5;5;0;100;0;176150;1915.6;92.2
42221;2023;3;3;0;100;0;137833.333333333;1262;117
42222;2023;37;30;7;81.0810810810811;18.9189189189189;241783.648648649;2355.83783783784;105.594594594595
42223;2023;52;30;22;57.6923076923077;42.3076923076923;234292.788461538;2395.05769230769;93.5576923076923
42224;2023;22;12;10;54.5454545454545;45.4545454545455;255445.454545455;2628.36363636364;97.7272727272727
42225;2023;26;25;1;96.1538461538462;3.84615384615385;216594.230769231;2442.11538461538;88.9615384615385
42226;2023;3;3;0;100;0;184533.333333333;1606.33333333333;116.333333333333
42227;2023;4;4;0;100;0;54252.5;714;76.5
42228;2023;15;15;0;100;0;204513.333333333;2359.66666666667;88.7333333333333
42229;2023;4;4;0;100;0;244250;2209.5;119
42230;2023;28;25;3;89.2857142857143;10.7142857142857;108273.392857143;1151.17857142857;89.5714285714286
42231;2023;8;7;1;87.5;12.5;142506.25;1575.625;88.375
42232;2023;3;3;0;100;0;247333.333333333;1932;121.333333333333
42233;2023;7;7;0;100;0;106231.428571429;1339.57142857143;79.2857142857143
42234;2023;42;31;11;73.8095238095238;26.1904761904762;227539.285714286;2375.19047619048;95.9523809523809
42235;2023;5;5;0;100;0;158480;1746.4;95.2
42236;2023;2;2;0;100;0;95750;1080.5;89
42237;2023;46;28;18;60.8695652173913;39.1304347826087;193517.173913043;2192.04347826087;88.4347826086957
42238;2023;7;7;0;100;0;89728.5714285714;1077;86.2857142857143
42239;2023;10;10;0;100;0;161150;1829.2;88
42240;2023;7;7;0;100;0;221300;2454.28571428571;102.285714285714
42241;2023;5;5;0;100;0;197790;1733.4;135
42242;2023;16;15;1;93.75;6.25;256686.25;2848.5;91.5625
42243;2023;2;2;0;100;0;145000;1131.5;127.5
42245;2023;4;4;0;100;0;80525;900.25;92.5
42246;2023;11;10;1;90.9090909090909;9.09090909090909;194680;1642.81818181818;113.727272727273
42247;2023;2;2;0;100;0;37500;485;73
42248;2023;13;10;3;76.9230769230769;23.0769230769231;98294.6153846154;1343.92307692308;76.5384615384615
42249;2023;17;17;0;100;0;143737.588235294;1611.11764705882;97.4117647058823
42251;2023;2;2;0;100;0;147500;2089.5;70.5
42252;2023;6;6;0;100;0;84833.3333333333;1559.83333333333;77.1666666666667
42253;2023;15;15;0;100;0;212777.333333333;1881.26666666667;112.533333333333
42254;2023;3;3;0;100;0;153500;1462.66666666667;94
42255;2023;6;6;0;100;0;130433.333333333;1239.83333333333;105.166666666667
42256;2023;43;38;5;88.3720930232558;11.6279069767442;235613;2344.81395348837;97.7906976744186
42257;2023;15;15;0;100;0;118739.333333333;1302.73333333333;90.0666666666667
42259;2023;31;24;7;77.4193548387097;22.5806451612903;273964;2908.61290322581;93.3548387096774
42260;2023;6;6;0;100;0;189133.333333333;1281;149.166666666667
42261;2023;10;10;0;100;0;213487;2029.2;105.2
42262;2023;15;15;0;100;0;225800;2105;105.533333333333
42264;2023;8;8;0;100;0;243060.625;2410.5;100.875
42265;2023;10;10;0;100;0;299835.8;2975.1;104.4
42266;2023;7;7;0;100;0;196928.571428571;1571.42857142857;103.142857142857
42267;2023;20;19;1;95;5;189337.5;1745.75;111.35
42268;2023;8;8;0;100;0;229014.5;2665.875;89.375
42270;2023;19;17;2;89.4736842105263;10.5263157894737;302586.842105263;2487.36842105263;121.842105263158
42271;2023;36;26;10;72.2222222222222;27.7777777777778;224706.388888889;2587.86111111111;88.1111111111111
42272;2023;20;15;5;75;25;184595.15;2275.95;85.25
42274;2023;2;2;0;100;0;210000;1893;113
42275;2023;100;27;73;27;73;209740.84;2608.36;80.85
42276;2023;9;9;0;100;0;88559.4444444444;1037.88888888889;85.1111111111111
42277;2023;7;7;0;100;0;160478.571428571;1722.14285714286;86.7142857142857
42278;2023;2;2;0;100;0;57500;649;88
42279;2023;141;99;42;70.2127659574468;29.7872340425532;261021.914893617;2821.43262411347;92.8085106382979
42280;2023;3;3;0;100;0;196270;2020;91.3333333333333
42281;2023;3;3;0;100;0;142333.333333333;2358.33333333333;71.6666666666667
42282;2023;2;2;0;100;0;42000;510;84.5
42283;2023;11;11;0;100;0;210113.636363636;1829.18181818182;107.818181818182
42284;2023;11;11;0;100;0;227214.272727273;1997.45454545455;109.181818181818
42285;2023;39;32;7;82.051282051282;17.9487179487179;220627.564102564;2380.64102564103;92
42286;2023;8;8;0;100;0;196025;1840.75;105.5
42287;2023;10;10;0;100;0;163543;1592.3;95.9
42288;2023;2;1;1;50;50;93000;1450.5;69.5
42289;2023;12;11;1;91.6666666666667;8.33333333333333;173438.166666667;1594;104.916666666667
42290;2023;5;5;0;100;0;197800;1832;107
42293;2023;14;13;1;92.8571428571429;7.14285714285714;174714.285714286;1634.07142857143;109.142857142857
42294;2023;14;13;1;92.8571428571429;7.14285714285714;229203.571428571;1928.5;128.571428571429
42295;2023;1;1;0;100;0;123600;883;140
42296;2023;5;5;0;100;0;237270;2158;110.2
42297;2023;2;2;0;100;0;64000;1905.5;37.5
42298;2023;1;1;0;100;0;41000;414;99
42299;2023;26;19;7;73.0769230769231;26.9230769230769;229145.5;2588.53846153846;87.9230769230769
42300;2023;5;5;0;100;0;167558;1394;119.6
42301;2023;11;9;2;81.8181818181818;18.1818181818182;149250;1712.81818181818;81.0909090909091
42302;2023;77;48;29;62.3376623376623;37.6623376623377;222042.922077922;2431.02597402597;92.038961038961
42303;2023;5;5;0;100;0;140694.4;1222;123.6
42304;2023;77;70;7;90.9090909090909;9.09090909090909;201063.402597403;2211.96103896104;91.6103896103896
42305;2023;73;28;45;38.3561643835616;61.6438356164384;228310.890410959;2618.86301369863;85.2876712328767
42306;2023;6;6;0;100;0;235800;3105.16666666667;87.8333333333333
42307;2023;6;5;1;83.3333333333333;16.6666666666667;348678.333333333;3156.16666666667;107.666666666667
42308;2023;8;7;1;87.5;12.5;231102.5;1932.5;111
42310;2023;1;0;1;0;100;30000;462;65
42311;2023;12;10;2;83.3333333333333;16.6666666666667;225055.5;2353.41666666667;96.0833333333333
42312;2023;8;8;0;100;0;266631.25;2442.125;110.25
42313;2023;6;6;0;100;0;196550;2183.66666666667;94.5
42314;2023;2;2;0;100;0;42500;697.5;67
42315;2023;6;6;0;100;0;259770.833333333;2168;128.833333333333
42316;2023;82;57;25;69.5121951219512;30.4878048780488;178402.134146341;1983.71951219512;87.3536585365854
42317;2023;2;2;0;100;0;252560;1878.5;150
42318;2023;25;23;2;92;8;134298.2;1592.6;85.2
42319;2023;3;3;0;100;0;167483.333333333;1374.66666666667;122.666666666667
42320;2023;9;5;4;55.5555555555556;44.4444444444444;184183.333333333;1866.44444444444;89.4444444444444
42322;2023;16;13;3;81.25;18.75;187212.5;1669.625;109.5625
42323;2023;92;67;25;72.8260869565217;27.1739130434783;261020.434782609;2644.67391304348;98.695652173913
42324;2023;9;9;0;100;0;288818.777777778;2896.66666666667;101.111111111111
42325;2023;2;2;0;100;0;218975;2183.5;106.5
42326;2023;9;8;1;88.8888888888889;11.1111111111111;315678.222222222;2904.77777777778;116.888888888889
42327;2023;11;9;2;81.8181818181818;18.1818181818182;161395.454545455;1785.81818181818;99.3636363636364
42328;2023;6;6;0;100;0;168350;1458.5;114.666666666667
42329;2023;3;3;0;100;0;229466.666666667;2255.66666666667;94.6666666666667
42330;2023;94;26;68;27.6595744680851;72.3404255319149;150989.053191489;1716.20212765957;86.2234042553192
42331;2023;6;6;0;100;0;177204.666666667;1497.16666666667;116.166666666667
42332;2023;58;45;13;77.5862068965517;22.4137931034483;190232.344827586;1921.74137931034;97.2413793103448
42333;2023;1;1;0;100;0;155000;2039;76
42334;2023;11;10;1;90.9090909090909;9.09090909090909;208383.636363636;1806.72727272727;111.909090909091
42335;2023;3;3;0;100;0;236766.666666667;2550.33333333333;93.6666666666667
42336;2023;4;4;0;100;0;196100;1671;96.25
42337;2023;2;2;0;100;0;62619;864.5;60
42338;2023;11;10;1;90.9090909090909;9.09090909090909;196404.545454545;1568.36363636364;124.545454545455
43001;2023;4;4;0;100;0;112187.5;1168.25;104.25
43002;2023;15;8;7;53.3333333333333;46.6666666666667;197110;2134.33333333333;99.0666666666667
43003;2023;19;17;2;89.4736842105263;10.5263157894737;105821.052631579;1071.84210526316;103.947368421053
43004;2023;7;7;0;100;0;73714.2857142857;2102.71428571429;55.2857142857143
43005;2023;1;1;0;100;0;66500;1108;60
43006;2023;3;3;0;100;0;76000;764.333333333333;105.666666666667
43007;2023;8;8;0;100;0;253351.25;1683.5;145.125
43008;2023;1;1;0;100;0;98700;1234;80
43010;2023;7;7;0;100;0;162225.714285714;1705;93.2857142857143
43011;2023;1;1;0;100;0;149500;1438;104
43012;2023;67;49;18;73.134328358209;26.865671641791;188686.71641791;2014.01492537313;96.4477611940299
43013;2023;4;4;0;100;0;132982.5;1135.25;118.5
43014;2023;1;1;0;100;0;47540;970;49
43015;2023;2;2;0;100;0;40000;686;61.5
43016;2023;4;4;0;100;0;83500;973.25;83.75
43017;2023;3;3;0;100;0;96633.3333333333;920;98.3333333333333
43018;2023;10;9;1;90;10;165159;1687.3;99.4
43019;2023;1;1;0;100;0;160000;1345;119
43020;2023;57;50;7;87.719298245614;12.280701754386;171394.157894737;2017.24561403509;88.1228070175439
43021;2023;6;6;0;100;0;108113.333333333;1199;89.3333333333333
43022;2023;2;2;0;100;0;146600;1568.5;95
43023;2023;1;1;0;100;0;136000;850;160
43024;2023;12;11;1;91.6666666666667;8.33333333333333;129899.166666667;1562.08333333333;89.6666666666667
43025;2023;42;41;1;97.6190476190476;2.38095238095238;148236.166666667;1729.33333333333;84.3571428571429
43026;2023;6;6;0;100;0;110283.333333333;1028.16666666667;116
43027;2023;1;1;0;100;0;42000;700;60
43028;2023;1;1;0;100;0;245000;2426;101
43030;2023;3;3;0;100;0;170500;1237.66666666667;133.333333333333
43031;2023;3;3;0;100;0;113266.666666667;1170;93
43032;2023;8;8;0;100;0;197565.5;2150.5;95
43033;2023;10;10;0;100;0;132610;1623.3;86.7
43034;2023;4;4;0;100;0;128318.75;1701;72.5
43035;2023;3;3;0;100;0;124601.333333333;1506.66666666667;86.6666666666667
43036;2023;2;2;0;100;0;143500;1420;110.5
43037;2023;2;2;0;100;0;137350;1239;109
43038;2023;10;9;1;90;10;113750;1298.9;87.7
43039;2023;8;8;0;100;0;144531.25;1523.75;97.625
43040;2023;70;55;15;78.5714285714286;21.4285714285714;128331.285714286;1457.41428571429;90.7285714285714
43041;2023;53;31;22;58.4905660377358;41.5094339622642;168407.547169811;1946.20754716981;84.6981132075472
43042;2023;10;10;0;100;0;105470;1368.9;80.5
43043;2023;9;9;0;100;0;130944.444444444;1041.22222222222;122.666666666667
43044;2023;1;1;0;100;0;140000;1273;110
43045;2023;3;3;0;100;0;116666.666666667;1250;94.3333333333333
43046;2023;18;14;4;77.7777777777778;22.2222222222222;193538.388888889;2104.44444444444;92.6111111111111
43047;2023;2;2;0;100;0;71170;884;73
43048;2023;7;6;1;85.7142857142857;14.2857142857143;192271.428571429;1349.71428571429;153.428571428571
43049;2023;13;12;1;92.3076923076923;7.69230769230769;91804.6153846154;1709.61538461538;59.3846153846154
43051;2023;45;27;18;60;40;150454.111111111;1718.13333333333;84.4
43052;2023;1;1;0;100;0;44000;611;72
43053;2023;8;8;0;100;0;191516;2204.25;85.375
43054;2023;1;1;0;100;0;1,00E+05;1250;80
43055;2023;2;2;0;100;0;65500;1342;48.5
43056;2023;6;6;0;100;0;132833.333333333;1405.83333333333;90.1666666666667
43058;2023;7;7;0;100;0;181799;2178.42857142857;83.1428571428571
43059;2023;2;2;0;100;0;65300;891.5;75
43060;2023;1;1;0;100;0;34000;680;50
43061;2023;3;3;0;100;0;206216.666666667;1855.66666666667;119
43062;2023;7;7;0;100;0;197800;1713.71428571429;112.142857142857
43063;2023;4;4;0;100;0;48237.5;786;60.5
43064;2023;1;1;0;100;0;92400;1540;60
43066;2023;2;2;0;100;0;88500;1816.5;60
43067;2023;4;4;0;100;0;129617.5;1459.75;86.25
43068;2023;2;2;0;100;0;71250;1432.5;83.5
43069;2023;4;4;0;100;0;230350;2884.25;92.5
43070;2023;4;4;0;100;0;73862.5;1236;60
43071;2023;4;4;0;100;0;96525;1462.75;61.75
43072;2023;1;1;0;100;0;68000;1172;58
43073;2023;7;7;0;100;0;90679.4285714286;1083.85714285714;80.1428571428571
43074;2023;8;8;0;100;0;177525;1613.375;109.75
43075;2023;3;3;0;100;0;74183.3333333333;669;105.666666666667
43076;2023;2;2;0;100;0;177500;1251.5;147.5
43077;2023;6;4;2;66.6666666666667;33.3333333333333;90633.3333333333;848.5;107
43078;2023;22;22;0;100;0;209405.409090909;1869.36363636364;115.636363636364
43079;2023;1;1;0;100;0;80000;727;110
43080;2023;25;23;2;92;8;133416.32;1221.6;99.6
43082;2023;2;2;0;100;0;48500;801;71
43083;2023;2;2;0;100;0;145345;1455.5;132
43084;2023;8;8;0;100;0;198317.5;1874.625;109.25
43085;2023;1;1;0;100;0;133550;1214;110
43086;2023;3;3;0;100;0;103666.666666667;923;112.666666666667
43087;2023;24;18;6;75;25;132387.5;1510.58333333333;90.75
43088;2023;4;3;1;75;25;168557.5;1712;99.5
43089;2023;53;30;23;56.6037735849057;43.3962264150943;156934.056603774;1681.62264150943;92.7169811320755
43090;2023;4;4;0;100;0;169462.5;1169.75;142.75
43091;2023;3;2;1;66.6666666666667;33.3333333333333;140666.666666667;1533.66666666667;95.3333333333333
43092;2023;10;9;1;90;10;112073.5;1445.8;74
43093;2023;3;3;0;100;0;136533.333333333;1229.33333333333;108.666666666667
43094;2023;1;1;0;100;0;29500;421;70
43095;2023;3;3;0;100;0;92656.6666666667;786.666666666667;114
43096;2023;1;1;0;100;0;197000;1551;127
43097;2023;5;4;1;80;20;172060;1916.2;89.2
43098;2023;4;4;0;100;0;77770;991.75;81
43099;2023;8;8;0;100;0;106415;1167;96.375
43100;2023;2;2;0;100;0;85675;1110.5;77
43101;2023;2;2;0;100;0;103075;1413.5;72
43102;2023;13;13;0;100;0;189106.153846154;2052.38461538462;91.5384615384615
43103;2023;3;3;0;100;0;50333.3333333333;633.333333333333;92.6666666666667
43104;2023;7;7;0;100;0;88181.4285714286;980.571428571429;85.7142857142857
43106;2023;3;3;0;100;0;112500;1213;91.6666666666667
43107;2023;2;2;0;100;0;177500;2139;87
43108;2023;5;5;0;100;0;75340;1211.8;64.6
43109;2023;1;1;0;100;0;75000;1500;50
43110;2023;3;3;0;100;0;108500;1401.66666666667;75
43111;2023;9;9;0;100;0;91875.5555555556;981.333333333333;91.3333333333333
43112;2023;42;32;10;76.1904761904762;23.8095238095238;110549.523809524;1328.33333333333;85.1428571428571
43113;2023;14;12;2;85.7142857142857;14.2857142857143;183342.5;1760.21428571429;101.714285714286
43114;2023;12;12;0;100;0;157800;1531.91666666667;98.0833333333333
43115;2023;8;8;0;100;0;146093.75;1899.5;75.625
43117;2023;2;2;0;100;0;118750;796;134
43118;2023;7;7;0;100;0;67331.4285714286;901.428571428571;94.1428571428571
43119;2023;11;10;1;90.9090909090909;9.09090909090909;136106.545454545;1511.81818181818;87.0909090909091
43120;2023;11;11;0;100;0;136020;1310.45454545455;99.6363636363636
43121;2023;2;2;0;100;0;156750;1621.5;94.5
43122;2023;3;3;0;100;0;119013.333333333;1545.33333333333;82
43123;2023;1;1;0;100;0;252950;2057;123
43124;2023;8;8;0;100;0;107145;1158;91.25
43126;2023;4;4;0;100;0;166000;1667.5;100.75
43127;2023;11;11;0;100;0;204090.454545455;1799.45454545455;114.363636363636
43128;2023;1;1;0;100;0;140000;1273;110
43129;2023;1;1;0;100;0;342000;2138;160
43130;2023;16;16;0;100;0;196150.625;1974.0625;101.5
43131;2023;1;1;0;100;0;146700;1146;128
43132;2023;11;10;1;90.9090909090909;9.09090909090909;171693.636363636;1733;101.454545454545
43134;2023;1;1;0;100;0;249185;1962;127
43135;2023;22;15;7;68.1818181818182;31.8181818181818;134185.136363636;1232.81818181818;107.590909090909
43136;2023;11;11;0;100;0;107747.272727273;986.818181818182;119.545454545455
43137;2023;81;63;18;77.7777777777778;22.2222222222222;205572.148148148;2260.38271604938;91.5555555555556
43138;2023;4;4;0;100;0;111075;1455.25;88.25
43139;2023;1;1;0;100;0;85000;664;128
43140;2023;2;2;0;100;0;329600;2530;126.5
43141;2023;14;9;5;64.2857142857143;35.7142857142857;124678.571428571;1347.78571428571;94.6428571428571
43142;2023;6;6;0;100;0;186766.666666667;1946.16666666667;96.1666666666667
43143;2023;4;3;1;75;25;202575;2353.5;102
43144;2023;1;1;0;100;0;190000;1033;184
43145;2023;1;1;0;100;0;239000;1593;150
43147;2023;4;4;0;100;0;112511.25;1447.25;82.25
43148;2023;11;10;1;90.9090909090909;9.09090909090909;108553.636363636;1156.45454545455;93.5454545454545
43149;2023;3;3;0;100;0;70000;1134.33333333333;70.3333333333333
43150;2023;5;5;0;100;0;206600;1647.2;146.6
43151;2023;2;2;0;100;0;69500;1619.5;67
43152;2023;22;22;0;100;0;240803.818181818;1995.13636363636;120.681818181818
43153;2023;16;15;1;93.75;6.25;199165.625;2020;96.375
43154;2023;13;12;1;92.3076923076923;7.69230769230769;92042.5384615385;1051.69230769231;92.2307692307692
43155;2023;4;4;0;100;0;122450;1389.5;87.25
43156;2023;11;11;0;100;0;104182.727272727;1483.45454545455;77.5454545454545
43157;2023;338;42;296;12.4260355029586;87.5739644970414;127500.189349112;1736.41124260355;73.6242603550296
43158;2023;7;7;0;100;0;221785.714285714;2250.85714285714;93.5714285714286
43159;2023;8;8;0;100;0;230857.5;1846.75;124.125
43160;2023;5;5;0;100;0;106780;1124;82.8
43162;2023;33;31;2;93.9393939393939;6.06060606060606;129662.272727273;1564.24242424242;83.3030303030303
43163;2023;9;8;1;88.8888888888889;11.1111111111111;131544.444444444;1559.77777777778;91.7777777777778
43164;2023;4;4;0;100;0;117310;1162.5;116.5
43165;2023;20;20;0;100;0;134972.5;1485.55;96.9
43166;2023;7;7;0;100;0;87978.5714285714;1395.85714285714;70.4285714285714
43167;2023;1;1;0;100;0;85000;1049;81
43168;2023;3;3;0;100;0;357233.333333333;3442;90
43170;2023;3;2;1;66.6666666666667;33.3333333333333;137366.666666667;1626.66666666667;79.3333333333333
43171;2023;3;3;0;100;0;52000;587;84.6666666666667
43172;2023;3;3;0;100;0;278960;1832;172
43173;2023;3;3;0;100;0;115000;1013.66666666667;109.333333333333
43174;2023;9;9;0;100;0;159172.222222222;1385;124.555555555556
43175;2023;2;2;0;100;0;62325;545;117.5
43177;2023;36;22;14;61.1111111111111;38.8888888888889;165038.888888889;1710.66666666667;94.9166666666667
43178;2023;1;1;0;100;0;90000;1000;90
43180;2023;3;3;0;100;0;64666.6666666667;670.666666666667;100
43181;2023;5;5;0;100;0;138550;1741.2;103.4
43183;2023;2;2;0;100;0;81500;917;86.5
43184;2023;19;11;8;57.8947368421053;42.1052631578947;184770.789473684;2423.84210526316;75.4210526315789
43185;2023;44;42;2;95.4545454545455;4.54545454545455;128886.159090909;1420.20454545455;91.4772727272727
43186;2023;8;8;0;100;0;149733.75;2251.5;66.875
43187;2023;3;3;0;100;0;240466.666666667;1336.66666666667;178
43188;2023;7;7;0;100;0;116428.571428571;977.285714285714;113.714285714286
43189;2023;5;5;0;100;0;98200;1288.2;76.8
43190;2023;20;20;0;100;0;181665.75;1834.35;98.05
43191;2023;6;6;0;100;0;116000;1264.83333333333;96.6666666666667
43192;2023;10;10;0;100;0;97981;1083.8;97.1
43193;2023;5;5;0;100;0;63400;811.8;77.6
43194;2023;10;9;1;90;10;145280;1671.6;89.1
43195;2023;4;4;0;100;0;77125;825.75;92.5
43196;2023;2;2;0;100;0;115800;2141;52.5
43197;2023;4;4;0;100;0;50272.5;530;96.25
43198;2023;5;5;0;100;0;80842;878.4;100.4
43199;2023;11;11;0;100;0;146388.636363636;1807.09090909091;92.3636363636364
43200;2023;13;12;1;92.3076923076923;7.69230769230769;161638.461538462;1825.69230769231;90.6153846153846
43201;2023;7;7;0;100;0;135942.857142857;1480.85714285714;96.4285714285714
43202;2023;2;2;0;100;0;67000;1050.5;68
43203;2023;1;1;0;100;0;239000;1811;132
43204;2023;5;5;0;100;0;152020;1671;95.2
43205;2023;24;21;3;87.5;12.5;202191.666666667;2027.04166666667;103.791666666667
43206;2023;2;2;0;100;0;107500;1148;96.5
43207;2023;1;1;0;100;0;228000;2018;113
43208;2023;3;3;0;100;0;87333.3333333333;975.333333333333;79.3333333333333
43210;2023;1;1;0;100;0;22000;423;52
43211;2023;19;15;4;78.9473684210526;21.0526315789474;157768.421052632;1827.05263157895;90.3157894736842
43212;2023;10;9;1;90;10;101826.2;998;95.3
43213;2023;12;11;1;91.6666666666667;8.33333333333333;174098.333333333;1676.41666666667;103.333333333333
43214;2023;3;3;0;100;0;90700;1056;84.6666666666667
43215;2023;4;4;0;100;0;80500;924.75;80
43216;2023;15;11;4;73.3333333333333;26.6666666666667;166173.333333333;1677.73333333333;98.8666666666667
43217;2023;9;9;0;100;0;83055.5555555556;823.222222222222;96.5555555555556
43218;2023;4;4;0;100;0;168553.75;1650;99.5
43219;2023;2;2;0;100;0;200561.5;1781;100
43220;2023;4;4;0;100;0;73000;950;77.5
43221;2023;8;7;1;87.5;12.5;72575;818.75;84.625
43222;2023;4;4;0;100;0;107012.5;1118.25;94.5
43223;2023;12;12;0;100;0;190333.333333333;1917.41666666667;103.083333333333
43224;2023;45;40;5;88.8888888888889;11.1111111111111;162557.777777778;1774.8;94.0666666666667
43226;2023;1;1;0;100;0;105000;1094;96
43227;2023;7;7;0;100;0;185942.857142857;1819.28571428571;95.4285714285714
43228;2023;2;2;0;100;0;105190;1226.5;82
43229;2023;3;3;0;100;0;164133.333333333;1520.33333333333;118
43230;2023;12;12;0;100;0;138370.833333333;1354.75;99
43231;2023;7;6;1;85.7142857142857;14.2857142857143;83682.8571428571;1038.71428571429;75.4285714285714
43232;2023;2;2;0;100;0;177575;1687.5;105.5
43233;2023;7;7;0;100;0;189157.142857143;1625.14285714286;113.428571428571
43234;2023;10;9;1;90;10;113713;1265.1;90.6
43236;2023;21;9;12;42.8571428571429;57.1428571428571;130634.761904762;1386.33333333333;92
43237;2023;4;4;0;100;0;108512.5;1534.25;74.25
43238;2023;3;3;0;100;0;129833.666666667;1387;90.6666666666667
43239;2023;8;8;0;100;0;102000;966.625;99.5
43241;2023;13;12;1;92.3076923076923;7.69230769230769;119771.230769231;1365.15384615385;81.3076923076923
43242;2023;1;1;0;100;0;57500;685;84
43244;2023;25;21;4;84;16;142804.36;1615.4;86.2
43245;2023;4;4;0;100;0;126512.5;1360.75;88.5
43246;2023;6;4;2;66.6666666666667;33.3333333333333;64508.3333333333;1041.83333333333;62.1666666666667
43249;2023;4;4;0;100;0;159250;1339;136.5
43251;2023;44;17;27;38.6363636363636;61.3636363636364;145600.75;1704.68181818182;80.8636363636364
43252;2023;2;2;0;100;0;142700;860;163
43253;2023;6;6;0;100;0;195408.333333333;2209;94.1666666666667
43254;2023;3;3;0;100;0;62000;642.666666666667;100.333333333333
43256;2023;5;4;1;80;20;73527.2;1393.6;63.6
43257;2023;5;5;0;100;0;103969.2;1383;71.6
43258;2023;14;14;0;100;0;167565.357142857;1680.78571428571;95.6428571428571
43259;2023;4;4;0;100;0;131712.75;1382.5;91.75
43260;2023;1;1;0;100;0;40000;541;74
43261;2023;3;3;0;100;0;87675.6666666667;1516.66666666667;63.3333333333333
43262;2023;15;11;4;73.3333333333333;26.6666666666667;98125.6666666667;1101.26666666667;87.2
43263;2023;2;2;0;100;0;103500;906;115
43264;2023;1;1;0;100;0;230800;1539;150
43265;2023;18;18;0;100;0;232875;2470.72222222222;94.1111111111111
43267;2023;16;16;0;100;0;106043.75;1200.0625;87
43268;2023;57;43;14;75.4385964912281;24.5614035087719;164341.964912281;1848.61403508772;93.7017543859649
44001;2023;22;22;0;100;0;163575.772727273;1754.31818181818;97.4090909090909
44002;2023;41;38;3;92.6829268292683;7.31707317073171;280826.048780488;2811.21951219512;101.536585365854
44003;2023;118;87;31;73.728813559322;26.271186440678;248271.152542373;2647.40677966102;95.7796610169491
44005;2023;59;57;2;96.6101694915254;3.38983050847458;246491.915254237;2636.15254237288;92.9491525423729
44006;2023;38;38;0;100;0;271260.526315789;2853.71052631579;94.8421052631579
44007;2023;31;31;0;100;0;154485.612903226;1773.87096774194;98.5806451612903
44009;2023;83;71;12;85.5421686746988;14.4578313253012;410647.626506024;3522.57831325301;117.481927710843
44010;2023;81;66;15;81.4814814814815;18.5185185185185;378528.87654321;5312.76543209877;76.3456790123457
44012;2023;84;69;15;82.1428571428571;17.8571428571429;332345.011904762;5143.2619047619;68.5833333333333
44013;2023;37;35;2;94.5945945945946;5.40540540540541;227675.675675676;2175.75675675676;103.567567567568
44014;2023;35;35;0;100;0;294764;2994.65714285714;100.657142857143
44015;2023;141;118;23;83.6879432624114;16.3120567375887;199917.503546099;2333.86524822695;89.2056737588652
44016;2023;13;13;0;100;0;242384.615384615;2326.23076923077;107
44018;2023;65;54;11;83.0769230769231;16.9230769230769;296697.169230769;3234.06153846154;92.5076923076923
44019;2023;17;17;0;100;0;232687.882352941;2454.82352941176;101.352941176471
44020;2023;189;136;53;71.9576719576719;28.042328042328;268156.576719577;3264.09523809524;83.7301587301587
44021;2023;62;59;3;95.1612903225807;4.83870967741935;225709.919354839;2606.53225806452;89.8387096774194
44022;2023;24;24;0;100;0;208964.5;2127.58333333333;100.958333333333
44023;2023;25;24;1;96;4;226647.2;2562.56;82.2
44024;2023;22;22;0;100;0;267499.909090909;2841.27272727273;96.7272727272727
44025;2023;33;33;0;100;0;232484.848484848;2439.87878787879;101.969696969697
44026;2023;203;136;67;66.9950738916256;33.0049261083744;319460.098522167;3566.76354679803;89.6650246305419
44027;2023;17;17;0;100;0;296242.705882353;3274.17647058824;93.8823529411765
44028;2023;35;30;5;85.7142857142857;14.2857142857143;289556.8;2653.28571428571;109.914285714286
44029;2023;54;54;0;100;0;266025.12962963;2769.90740740741;101.037037037037
44030;2023;59;59;0;100;0;219462;2311.81355932203;100.186440677966
44031;2023;13;13;0;100;0;117115.384615385;1237.07692307692;109.923076923077
44032;2023;38;38;0;100;0;263700;2798.71052631579;96.2368421052632
44033;2023;32;32;0;100;0;270475;2564.875;107.59375
44035;2023;226;162;64;71.6814159292035;28.3185840707965;359004.225663717;3703.67699115044;97.3141592920354
44036;2023;177;137;40;77.4011299435028;22.5988700564972;154738.898305085;1867.56497175141;84.135593220339
44037;2023;32;32;0;100;0;265506.25;2744.09375;98.4375
44038;2023;38;38;0;100;0;263813.947368421;2768.89473684211;97.6315789473684
44039;2023;6;6;0;100;0;277333.333333333;2864.5;92.1666666666667
44041;2023;63;63;0;100;0;267847.857142857;3047.20634920635;92.1746031746032
44043;2023;78;66;12;84.6153846153846;15.3846153846154;306633.358974359;3316.98717948718;92.9230769230769
44044;2023;13;13;0;100;0;132442.307692308;1386.53846153846;95.4615384615385
44045;2023;38;36;2;94.7368421052632;5.26315789473684;278969.078947368;2776.13157894737;101.736842105263
44046;2023;24;24;0;100;0;320075;3071.25;111.5
44047;2023;296;194;102;65.5405405405405;34.4594594594595;263034.253378378;3231.88513513513;82.5641891891892
44048;2023;17;17;0;100;0;206612.941176471;2213.35294117647;103.176470588235
44049;2023;148;68;80;45.945945945946;54.0540540540541;328040.52027027;4776.08108108108;70.3513513513514
44050;2023;35;35;0;100;0;207746.142857143;2150.77142857143;99.3428571428571
44051;2023;32;32;0;100;0;152478.1875;1893.9375;82.65625
44052;2023;109;103;6;94.4954128440367;5.5045871559633;207506.660550459;2305.83486238532;92.6422018348624
44053;2023;27;27;0;100;0;229368.333333333;2382.03703703704;97.3333333333333
44054;2023;30;30;0;100;0;141996.166666667;1470.93333333333;94.5
44055;2023;624;214;410;34.2948717948718;65.7051282051282;502360.876602564;6931.79326923077;73.5144230769231
44056;2023;37;36;1;97.2972972972973;2.7027027027027;251908.405405405;2609.83783783784;100.810810810811
44057;2023;31;31;0;100;0;170194.516129032;1812.77419354839;93.5806451612903
44058;2023;2;2;0;100;0;202500;1983;125.5
44061;2023;36;34;2;94.4444444444444;5.55555555555556;218429.166666667;2550.63888888889;88.0833333333333
44062;2023;24;24;0;100;0;236908;2284.41666666667;106.083333333333
44063;2023;34;32;2;94.1176470588235;5.88235294117647;245417.352941176;2686.11764705882;90.1176470588235
44064;2023;34;33;1;97.0588235294118;2.94117647058824;254838.294117647;2429.26470588235;107.882352941176
44065;2023;10;10;0;100;0;120560.8;1219.6;93.9
44066;2023;61;60;1;98.3606557377049;1.63934426229508;342872.819672131;3329.95081967213;106.491803278689
44067;2023;81;80;1;98.7654320987654;1.23456790123457;142258.839506173;1735.1975308642;84.2098765432099
44068;2023;48;48;0;100;0;164907.8125;1919.58333333333;85.4583333333333
44069;2023;193;135;58;69.9481865284974;30.0518134715026;351668.616580311;3935.52331606218;93.1813471502591
44070;2023;39;39;0;100;0;284761.076923077;3025.48717948718;100.282051282051
44071;2023;46;46;0;100;0;329129.630434783;3346.39130434783;99.3260869565217
44072;2023;74;73;1;98.6486486486486;1.35135135135135;251434.702702703;2895.7972972973;91.2567567567568
44073;2023;59;57;2;96.6101694915254;3.38983050847458;274000.13559322;2824.72881355932;102.254237288136
44074;2023;57;38;19;66.6666666666667;33.3333333333333;239405.614035088;3288.75438596491;73.1578947368421
44075;2023;24;24;0;100;0;136253.166666667;1450.16666666667;93.9583333333333
44076;2023;20;20;0;100;0;165986.75;1637.9;102.8
44077;2023;31;30;1;96.7741935483871;3.2258064516129;219707.967741935;2228.61290322581;99.3225806451613
44078;2023;5;5;0;100;0;114800;1363.6;77
44079;2023;29;27;2;93.1034482758621;6.89655172413793;249185.344827586;2504.48275862069;102
44080;2023;9;9;0;100;0;221444.444444444;2531.88888888889;97.3333333333333
44081;2023;63;63;0;100;0;190682.634920635;2029.33333333333;96.6984126984127
44082;2023;41;40;1;97.5609756097561;2.4390243902439;260680.975609756;2643.68292682927;100.170731707317
44083;2023;25;25;0;100;0;198008;2268.4;88.8
44084;2023;66;58;8;87.8787878787879;12.1212121212121;274070.818181818;2978.43939393939;94.969696969697
44085;2023;8;8;0;100;0;123850;1314;90.25
44086;2023;15;15;0;100;0;151496.4;1671.4;93.2666666666667
44087;2023;93;88;5;94.6236559139785;5.37634408602151;210510.752688172;2461.95698924731;87.6236559139785
44088;2023;31;26;5;83.8709677419355;16.1290322580645;234993.741935484;2591.29032258065;94.2258064516129
44089;2023;32;32;0;100;0;244095.625;2580.375;96.15625
44090;2023;13;13;0;100;0;212423.076923077;2141.15384615385;101.923076923077
44091;2023;23;23;0;100;0;157573.869565217;1683.82608695652;101.652173913043
44092;2023;11;11;0;100;0;159909.090909091;1536.63636363636;107.545454545455
44094;2023;26;22;4;84.6153846153846;15.3846153846154;287923.076923077;3221.34615384615;91.3461538461538
44095;2023;14;14;0;100;0;101721.428571429;1143.14285714286;89.0714285714286
44096;2023;31;31;0;100;0;226467.741935484;2313.58064516129;100.290322580645
44097;2023;56;50;6;89.2857142857143;10.7142857142857;399609.25;4292.96428571429;95.375
44098;2023;74;72;2;97.2972972972973;2.7027027027027;238058.986486486;2726.55405405405;94.0945945945946
44099;2023;27;27;0;100;0;125670.37037037;1359.92592592593;98.3703703703704
44100;2023;27;27;0;100;0;282189.37037037;2957.14814814815;101.888888888889
44101;2023;63;56;7;88.8888888888889;11.1111111111111;248549.412698413;3151.19047619048;81.8730158730159
44102;2023;27;27;0;100;0;256535.185185185;2836.85185185185;96.3333333333333
44103;2023;62;47;15;75.8064516129032;24.1935483870968;197496.935483871;2425.67741935484;83.4838709677419
44104;2023;12;12;0;100;0;195850;1889.5;104.25
44105;2023;4;4;0;100;0;137750;1639.25;83.5
44106;2023;53;41;12;77.3584905660377;22.6415094339623;270449.132075472;4375.54716981132;66.9433962264151
44107;2023;21;21;0;100;0;231428.571428571;2265.7619047619;107.333333333333
44108;2023;23;23;0;100;0;249789.565217391;2644.91304347826;98.9565217391304
44109;2023;4910;934;3976;19.0224032586558;80.9775967413442;260642.655600815;3958.09938900204;65.1368635437882
44110;2023;99;94;5;94.9494949494949;5.05050505050505;275100.97979798;2842.52525252525;99.4949494949495
44111;2023;19;19;0;100;0;232056.315789474;2366.05263157895;99.1052631578947
44112;2023;8;8;0;100;0;116000;1377.875;85.625
44113;2023;51;46;5;90.1960784313726;9.80392156862745;211660;2168.52941176471;103.196078431373
44114;2023;315;188;127;59.6825396825397;40.3174603174603;335457.936507937;3615.87936507937;92.2730158730159
44115;2023;42;42;0;100;0;267580.714285714;2661.59523809524;102.095238095238
44116;2023;55;33;22;60;40;163758.854545455;2117.92727272727;76.6181818181818
44117;2023;41;37;4;90.2439024390244;9.75609756097561;294141.56097561;2963.80487804878;101.536585365854
44118;2023;11;11;0;100;0;157679.818181818;1600;102.090909090909
44119;2023;19;19;0;100;0;228679.473684211;2301.47368421053;98.6842105263158
44120;2023;57;50;7;87.719298245614;12.280701754386;239889.912280702;2759.19298245614;88.7719298245614
44121;2023;7;7;0;100;0;141185.714285714;1990.71428571429;78.4285714285714
44122;2023;30;30;0;100;0;292391.166666667;2806.16666666667;110.533333333333
44123;2023;18;18;0;100;0;129972.222222222;1326;99.6111111111111
44124;2023;6;6;0;100;0;110750;1195.66666666667;93.3333333333333
44125;2023;79;75;4;94.9367088607595;5.06329113924051;441564.417721519;5246;86.2658227848101
44126;2023;95;91;4;95.7894736842105;4.21052631578947;325816.968421053;4510.27368421053;75.8631578947368
44127;2023;19;19;0;100;0;215052.631578947;2207.10526315789;97.8947368421053
44128;2023;70;70;0;100;0;183947.185714286;2010.42857142857;94.1857142857143
44129;2023;124;98;26;79.0322580645161;20.9677419354839;209267.387096774;2291.6935483871;93.3225806451613
44130;2023;64;61;3;95.3125;4.6875;305902.296875;3249.046875;99.65625
44131;2023;292;229;63;78.4246575342466;21.5753424657534;437126.900684931;5236.07876712329;85.6130136986301
44132;2023;323;142;181;43.9628482972136;56.0371517027864;431809.371517028;6232.29102167183;71.4241486068111
44133;2023;32;29;3;90.625;9.375;284032.125;2990.5625;95.9375
44134;2023;14;14;0;100;0;242236.428571429;2283;106.357142857143
44135;2023;152;74;78;48.6842105263158;51.3157894736842;371799.197368421;5712.57894736842;66.1118421052632
44136;2023;47;39;8;82.9787234042553;17.0212765957447;402534.638297872;5291.78723404255;78.1276595744681
44137;2023;24;24;0;100;0;251374.166666667;2408.875;104.625
44138;2023;14;13;1;92.8571428571429;7.14285714285714;215871.428571429;2275.42857142857;100.071428571429
44139;2023;14;14;0;100;0;189832.142857143;1790.71428571429;104.428571428571
44140;2023;16;16;0;100;0;200737.5;2138.3125;98.875
44141;2023;11;11;0;100;0;200845.909090909;2062.18181818182;96.1818181818182
44142;2023;13;11;2;84.6153846153846;15.3846153846154;210746.153846154;2447.15384615385;85.7692307692308
44143;2023;620;303;317;48.8709677419355;51.1290322580645;255978.327419355;3329.52096774194;76.8483870967742
44144;2023;27;27;0;100;0;153465.333333333;1607.33333333333;93.2222222222222
44145;2023;24;24;0;100;0;266739.583333333;3022.66666666667;92.375
44146;2023;27;27;0;100;0;168648.148148148;1680.25925925926;105.259259259259
44148;2023;16;16;0;100;0;120768.75;1410.3125;82.25
44149;2023;33;33;0;100;0;217098.333333333;2273.36363636364;97.3939393939394
44150;2023;27;27;0;100;0;275047.777777778;2894.66666666667;96.7777777777778
44151;2023;67;60;7;89.5522388059701;10.4477611940298;398368.23880597;3600.4776119403;109.985074626866
44152;2023;27;27;0;100;0;228240.740740741;2396.2962962963;100.185185185185
44153;2023;28;28;0;100;0;155142.857142857;1544.85714285714;101.464285714286
44154;2023;306;200;106;65.359477124183;34.640522875817;317735.039215686;4337.5;76.5980392156863
44155;2023;35;35;0;100;0;241583.8;2791.94285714286;92.0285714285714
44156;2023;45;45;0;100;0;194518.444444444;2276.55555555556;89.3111111111111
44157;2023;22;22;0;100;0;184470.909090909;2105.81818181818;87.2272727272727
44158;2023;58;50;8;86.2068965517241;13.7931034482759;306026.706896552;3026.98275862069;103.758620689655
44159;2023;9;9;0;100;0;315923.555555556;3161.77777777778;101
44161;2023;39;39;0;100;0;192104.102564103;1984.07692307692;99.7948717948718
44162;2023;724;212;512;29.2817679558011;70.7182320441989;223422.429558011;3039.75276243094;74.1574585635359
44163;2023;42;40;2;95.2380952380952;4.76190476190476;218417.976190476;2048.28571428571;110.285714285714
44164;2023;24;23;1;95.8333333333333;4.16666666666667;186466.166666667;2742.70833333333;72.625
44165;2023;18;18;0;100;0;230261.111111111;2533.22222222222;95.3333333333333
44166;2023;56;53;3;94.6428571428571;5.35714285714286;282505.839285714;3014.01785714286;97.1071428571429
44168;2023;52;52;0;100;0;189465.384615385;2218.05769230769;89.75
44169;2023;74;71;3;95.9459459459459;4.05405405405405;303669.594594595;3153.98648648649;99.3918918918919
44170;2023;12;12;0;100;0;92100;1067.66666666667;87.4166666666667
44171;2023;14;14;0;100;0;318462.142857143;2800.64285714286;115.428571428571
44172;2023;224;106;118;47.3214285714286;52.6785714285714;268391.022321429;3388.75;79.0267857142857
44173;2023;15;15;0;100;0;205565.466666667;2300;91.2666666666667
44174;2023;26;26;0;100;0;225448.076923077;2448.15384615385;92.9230769230769
44175;2023;47;47;0;100;0;335820.808510638;3154.63829787234;109.510638297872
44176;2023;33;33;0;100;0;202189.454545455;2312.21212121212;89.4545454545455
44178;2023;25;25;0;100;0;245409.6;2649.2;94.24
44179;2023;35;35;0;100;0;269948.571428571;2825.74285714286;100.514285714286
44180;2023;32;31;1;96.875;3.125;181968.75;1978.0625;93.78125
44182;2023;129;102;27;79.0697674418605;20.9302325581395;308380.658914729;4399.84496124031;73.6976744186046
44183;2023;16;16;0;100;0;366145.6875;3468.0625;97.75
44184;2023;1127;506;621;44.8979591836735;55.1020408163265;236490.804791482;3119.16947648625;76.8553682342502
44185;2023;47;40;7;85.1063829787234;14.8936170212766;163004.276595745;2013.25531914894;82.531914893617
44186;2023;66;63;3;95.4545454545455;4.54545454545455;277886.03030303;2897.18181818182;96.6969696969697
44187;2023;58;56;2;96.551724137931;3.44827586206897;264770.620689655;2962.68965517241;92.5172413793103
44188;2023;82;76;6;92.6829268292683;7.31707317073171;274386.56097561;2943.9512195122;95.3414634146341
44189;2023;27;27;0;100;0;216087.962962963;2275.18518518519;95.7777777777778
44190;2023;400;215;185;53.75;46.25;278505.355;3686.685;77.07
44192;2023;27;27;0;100;0;245711.111111111;2752.77777777778;92.1481481481482
44193;2023;20;20;0;100;0;128163.4;1225.65;107.35
44194;2023;94;67;27;71.2765957446808;28.7234042553192;406577.053191489;3888.17021276596;104.617021276596
44195;2023;95;85;10;89.4736842105263;10.5263157894737;276001.442105263;2808.74736842105;101.715789473684
44196;2023;21;21;0;100;0;156654.761904762;1888.95238095238;87
44197;2023;25;25;0;100;0;94916.84;1213.16;81.24
44198;2023;98;77;21;78.5714285714286;21.4285714285714;299442.37755102;3484.10204081633;87.6326530612245
44199;2023;15;15;0;100;0;134228.866666667;1451.73333333333;92.2666666666667
44200;2023;4;4;0;100;0;113500;1332;84.25
44201;2023;75;66;9;88;12;468875.52;4011.33333333333;114.173333333333
44202;2023;12;12;0;100;0;172684.833333333;1831.5;104.666666666667
44203;2023;24;24;0;100;0;284638.666666667;3020.375;100.333333333333
44204;2023;112;77;35;68.75;31.25;332211.464285714;3534.33035714286;94.4464285714286
44205;2023;20;20;0;100;0;234520.3;2531.9;95.7
44206;2023;27;27;0;100;0;175086.62962963;1891.22222222222;94.4444444444444
44207;2023;10;10;0;100;0;188070;2050;90.4
44208;2023;16;16;0;100;0;178741.4375;1656.0625;109.1875
44209;2023;92;81;11;88.0434782608696;11.9565217391304;341154.326086957;3249.02173913043;105.79347826087
44210;2023;103;88;15;85.4368932038835;14.5631067961165;195028.766990291;2657.57281553398;78.1165048543689
44211;2023;114;78;36;68.4210526315789;31.5789473684211;318960.307017544;4428.07894736842;76.1842105263158
44212;2023;97;91;6;93.8144329896907;6.18556701030928;267254.051546392;2836.0824742268;99.2164948453608
44213;2023;74;72;2;97.2972972972973;2.7027027027027;176239.486486486;1868.55405405405;95.6621621621622
44214;2023;15;13;2;86.6666666666667;13.3333333333333;201468.333333333;1929.86666666667;103.866666666667
44215;2023;277;211;66;76.1732851985559;23.826714801444;335196.55234657;3678.23826714801;91.3068592057762
44216;2023;42;41;1;97.6190476190476;2.38095238095238;202763.80952381;2245.88095238095;96.0714285714286
44217;2023;42;40;2;95.2380952380952;4.76190476190476;334337.714285714;3299.11904761905;108.238095238095
44218;2023;9;9;0;100;0;104733.444444444;1210.55555555556;91
44220;2023;18;16;2;88.8888888888889;11.1111111111111;244255.388888889;2580.61111111111;94.0555555555556
44221;2023;15;15;0;100;0;256860.4;2512.33333333333;105.533333333333
44222;2023;9;9;0;100;0;157283;2120;75.2222222222222
44223;2023;53;46;7;86.7924528301887;13.2075471698113;251854.037735849;2636.47169811321;97.5094339622642
44224;2023;16;16;0;100;0;234146.875;2218;103.5625
45001;2023;3;3;0;100;0;162300;1303.66666666667;125.333333333333
45002;2023;8;8;0;100;0;99000;1177.875;85.625
45004;2023;189;179;10;94.7089947089947;5.29100529100529;148218.153439153;1751.2962962963;87.6931216931217
45005;2023;3;3;0;100;0;107666.666666667;1258.33333333333;91.3333333333333
45006;2023;15;11;4;73.3333333333333;26.6666666666667;358878.8;2911.86666666667;128.6
45008;2023;19;16;3;84.2105263157895;15.7894736842105;147368.421052632;1700.42105263158;90.1578947368421
45009;2023;16;16;0;100;0;164966.25;1891.375;87.6875
45010;2023;5;5;0;100;0;195790;1861.8;107.6
45011;2023;2;2;0;100;0;147500;1850;80.5
45013;2023;2;2;0;100;0;181500;2688;67.5
45014;2023;8;8;0;100;0;150106.125;1600.25;93.5
45015;2023;10;10;0;100;0;197034;1958.4;106.4
45016;2023;9;9;0;100;0;98233.3333333333;1213.77777777778;78.1111111111111
45017;2023;1;1;0;100;0;87000;1359;64
45018;2023;13;13;0;100;0;117476.923076923;1236.07692307692;98.5384615384615
45019;2023;8;8;0;100;0;229125;1860.5;123.25
45020;2023;5;5;0;100;0;151630;1678.2;90.4
45021;2023;5;5;0;100;0;126000;1331.8;99.2
45022;2023;6;6;0;100;0;101916.666666667;1308.5;78.8333333333333
45023;2023;1;1;0;100;0;127000;770;165
45024;2023;2;2;0;100;0;147500;1651.5;89
45025;2023;14;14;0;100;0;159514.285714286;1687.07142857143;101.5
45026;2023;13;13;0;100;0;157191.538461538;1987.07692307692;83.5384615384615
45027;2023;8;8;0;100;0;105862.5;1254.125;90.125
45028;2023;119;83;36;69.7478991596639;30.2521008403361;162425.823529412;1799.41176470588;89.6470588235294
45029;2023;35;33;2;94.2857142857143;5.71428571428571;124924;1378.14285714286;91.9142857142857
45030;2023;16;16;0;100;0;124853.125;1601.1875;79.75
45031;2023;22;22;0;100;0;106339.181818182;1333.81818181818;82.7272727272727
45032;2023;6;6;0;100;0;150666.666666667;1550.5;96
45033;2023;4;4;0;100;0;100475;1156.25;90.75
45034;2023;20;19;1;95;5;210518.15;2177.5;98.75
45035;2023;22;21;1;95.4545454545455;4.54545454545455;151373.863636364;1421.86363636364;108.090909090909
45036;2023;11;11;0;100;0;214753.636363636;1611.36363636364;133.454545454545
45037;2023;5;5;0;100;0;215060;2078.2;106.4
45038;2023;2;2;0;100;0;145182.5;1654.5;89
45039;2023;9;9;0;100;0;168159.111111111;1775.66666666667;96
45040;2023;21;20;1;95.2380952380952;4.76190476190476;111277.142857143;1079.66666666667;95.1904761904762
45041;2023;3;3;0;100;0;74187.6666666667;863.333333333333;86
45042;2023;32;32;0;100;0;164055.9375;1649.25;97.28125
45043;2023;9;9;0;100;0;240021.888888889;2414;102
45045;2023;3;3;0;100;0;183333.333333333;1616;111.666666666667
45046;2023;10;10;0;100;0;175485;1855.2;95.1
45047;2023;3;3;0;100;0;127511.666666667;1301;125.666666666667
45049;2023;16;16;0;100;0;199273.75;1827.375;111.8125
45050;2023;8;8;0;100;0;131594.25;1445;91.375
45051;2023;19;19;0;100;0;180482.315789474;1916.63157894737;97.3157894736842
45053;2023;53;50;3;94.3396226415094;5.66037735849057;152250.396226415;1579.77358490566;96.6603773584906
45054;2023;8;8;0;100;0;187931.25;1979.125;100.625
45055;2023;6;5;1;83.3333333333333;16.6666666666667;136250;1563.5;90.3333333333333
45056;2023;4;4;0;100;0;154750;1760;84.5
45058;2023;1;1;0;100;0;215900;1576;137
45059;2023;3;3;0;100;0;112333.333333333;1079;118
45060;2023;8;8;0;100;0;93375;915;99.75
45061;2023;32;28;4;87.5;12.5;121452.8125;1496.78125;85.8125
45062;2023;15;14;1;93.3333333333333;6.66666666666667;186970;1897.66666666667;95.4666666666667
45063;2023;25;25;0;100;0;98599.4;1247.92;83.68
45064;2023;5;5;0;100;0;132840;1975.8;87.2
45065;2023;2;2;0;100;0;162250;1689.5;103
45066;2023;10;10;0;100;0;132450;1560.1;87.9
45067;2023;23;22;1;95.6521739130435;4.34782608695652;208575.217391304;2231.17391304348;96.9130434782609
45068;2023;102;90;12;88.2352941176471;11.7647058823529;123411.31372549;1651.56862745098;75.2843137254902
45069;2023;11;11;0;100;0;162650;1677.36363636364;103.636363636364
45070;2023;2;2;0;100;0;89000;1188.5;77.5
45072;2023;9;8;1;88.8888888888889;11.1111111111111;229502.777777778;2146.66666666667;109
45073;2023;6;6;0;100;0;138500;1154.83333333333;118.333333333333
45075;2023;138;96;42;69.5652173913043;30.4347826086957;186929.797101449;2169.90579710145;87.6086956521739
45076;2023;3;3;0;100;0;84966.6666666667;2166.66666666667;44
45077;2023;8;8;0;100;0;127878.5;1392.25;97.375
45078;2023;2;2;0;100;0;121000;1134;122.5
45079;2023;4;4;0;100;0;93083.25;1226.25;67.75
45080;2023;7;7;0;100;0;231817.142857143;2014.71428571429;114
45081;2023;3;3;0;100;0;126666.666666667;1049.33333333333;125.666666666667
45082;2023;107;83;24;77.5700934579439;22.4299065420561;175845.280373832;2030.46728971963;89.0373831775701
45083;2023;35;33;2;94.2857142857143;5.71428571428571;140837.971428571;1548.51428571429;89.6
45084;2023;6;6;0;100;0;122483.333333333;1733.16666666667;79
45085;2023;33;30;3;90.9090909090909;9.09090909090909;100274.848484848;1230.75757575758;84.4242424242424
45086;2023;1;1;0;100;0;189990;1919;99
45087;2023;32;32;0;100;0;96987.125;1294.46875;73.5625
45088;2023;2;2;0;100;0;199000;2058;110
45089;2023;108;104;4;96.2962962962963;3.7037037037037;228955.833333333;2378.05555555556;98.3611111111111
45091;2023;5;5;0;100;0;240800;1737.4;129.2
45092;2023;19;19;0;100;0;166665.789473684;1710.47368421053;104.368421052632
45093;2023;21;20;1;95.2380952380952;4.76190476190476;198847.333333333;2108.7619047619;96.5238095238095
45094;2023;3;3;0;100;0;294333.333333333;1819.66666666667;139.333333333333
45095;2023;35;34;1;97.1428571428571;2.85714285714286;165886.828571429;1777.31428571429;101.428571428571
45096;2023;4;4;0;100;0;117975;1446;87
45097;2023;27;27;0;100;0;111703.259259259;1475.51851851852;77.962962962963
45098;2023;29;28;1;96.551724137931;3.44827586206897;197150.689655172;2176.55172413793;94.6551724137931
45099;2023;11;11;0;100;0;171354.545454545;1562.72727272727;113
45100;2023;17;17;0;100;0;376153.823529412;3065.76470588235;125.235294117647
45101;2023;1;1;0;100;0;286600;1825;157
45102;2023;4;4;0;100;0;198375;1551.25;120
45103;2023;25;25;0;100;0;119820.04;1477.76;83.96
45104;2023;34;33;1;97.0588235294118;2.94117647058824;151262.705882353;1710.76470588235;90.3823529411765
45105;2023;1;1;0;100;0;46020;1644;28
45107;2023;8;8;0;100;0;152704.5;1465.25;103
45108;2023;26;25;1;96.1538461538462;3.84615384615385;124693.846153846;1494.46153846154;80.8461538461538
45109;2023;7;7;0;100;0;178471.428571429;1599.14285714286;115.857142857143
45110;2023;7;7;0;100;0;184577.142857143;1777.57142857143;113.857142857143
45111;2023;9;9;0;100;0;189805.444444444;1598.88888888889;128.555555555556
45112;2023;4;4;0;100;0;169405;1820.75;96
45113;2023;7;7;0;100;0;183170;2005.14285714286;121.714285714286
45114;2023;4;4;0;100;0;195500;1747.75;112.25
45115;2023;58;56;2;96.551724137931;3.44827586206897;157192.379310345;1666.98275862069;98.6724137931034
45116;2023;8;8;0;100;0;167426.875;1818.375;97.75
45118;2023;8;8;0;100;0;160003.125;1760.375;95.5
45119;2023;24;24;0;100;0;172853.125;1718.04166666667;109.125
45120;2023;1;1;0;100;0;40000;500;80
45121;2023;12;11;1;91.6666666666667;8.33333333333333;107541.25;1339.58333333333;80.3333333333333
45122;2023;13;13;0;100;0;134782.615384615;1446.53846153846;92.9230769230769
45123;2023;15;15;0;100;0;193505.333333333;1868.93333333333;108.533333333333
45124;2023;2;2;0;100;0;191845;2179;88.5
45125;2023;2;2;0;100;0;150000;1909;93.5
45126;2023;25;25;0;100;0;253403.12;2295.24;113.92
45127;2023;35;33;2;94.2857142857143;5.71428571428571;177885.714285714;1941.65714285714;96.0571428571429
45129;2023;29;29;0;100;0;147371.724137931;1380.13793103448;104.310344827586
45130;2023;14;14;0;100;0;207721.428571429;1939.85714285714;110.071428571429
45131;2023;4;4;0;100;0;152250;1957.25;79.5
45132;2023;4;4;0;100;0;94158.75;1170.25;82.75
45133;2023;5;5;0;100;0;191960;2093;95.2
45134;2023;15;15;0;100;0;162273.333333333;1578.06666666667;104.8
45135;2023;3;3;0;100;0;132000;1693;72
45136;2023;9;9;0;100;0;147456.888888889;1306;114.888888888889
45137;2023;8;8;0;100;0;125375;1740.375;91.125
45139;2023;8;7;1;87.5;12.5;297512.5;2510.375;130.75
45141;2023;1;1;0;100;0;170000;2208;77
45142;2023;45;41;4;91.1111111111111;8.88888888888889;190581.088888889;2145.88888888889;90.7777777777778
45143;2023;1;1;0;100;0;130000;1150;113
45144;2023;13;13;0;100;0;222820.769230769;2344.92307692308;102
45145;2023;40;40;0;100;0;160069.05;1819.95;91.4
45146;2023;84;79;5;94.0476190476191;5.95238095238095;207032.321428571;2258.66666666667;92.1309523809524
45147;2023;251;135;116;53.7848605577689;46.2151394422311;163817.195219124;2145.03187250996;77.7450199203187
45148;2023;10;10;0;100;0;155050;1593.5;105.1
45149;2023;5;5;0;100;0;149000;1550.4;105.2
45150;2023;2;2;0;100;0;210900;2781;78.5
45151;2023;3;3;0;100;0;202666.666666667;1645.66666666667;136
45152;2023;3;3;0;100;0;186000;1590.66666666667;110.333333333333
45153;2023;10;10;0;100;0;117350;1542.2;74.8
45154;2023;13;13;0;100;0;218446.153846154;1952.53846153846;110.692307692308
45155;2023;168;132;36;78.5714285714286;21.4285714285714;110338.648809524;1372.32738095238;81.1071428571429
45156;2023;10;10;0;100;0;132686;1435.9;93.8
45157;2023;5;5;0;100;0;186750;1839.8;103.6
45158;2023;7;7;0;100;0;145414.285714286;1495.14285714286;98.4285714285714
45159;2023;3;3;0;100;0;192000;1759.66666666667;108.666666666667
45160;2023;5;5;0;100;0;138198;1437;97.6
45161;2023;8;8;0;100;0;152025;1819;83.5
45162;2023;8;8;0;100;0;158862.5;1471.625;108.125
45164;2023;6;6;0;100;0;158230;1687.5;94.3333333333333
45165;2023;2;2;0;100;0;53500;776;67
45166;2023;1;1;0;100;0;207000;2112;98
45167;2023;19;19;0;100;0;202700;2046.73684210526;104.157894736842
45168;2023;6;6;0;100;0;157300;1552.83333333333;99.3333333333333
45169;2023;77;63;14;81.8181818181818;18.1818181818182;229661.636363636;2562.37662337662;93.1038961038961
45170;2023;1;1;0;100;0;173000;1966;88
45171;2023;10;10;0;100;0;166640;1371.8;123.2
45173;2023;48;39;9;81.25;18.75;163679;2153.125;79.9166666666667
45174;2023;3;3;0;100;0;184666.666666667;1941;95.6666666666667
45175;2023;16;16;0;100;0;259897.75;2224.5;117.5
45176;2023;7;7;0;100;0;119745;1438.71428571429;81.2857142857143
45177;2023;1;1;0;100;0;195000;1393;140
45178;2023;18;18;0;100;0;130888.333333333;1486.16666666667;86.9444444444444
45179;2023;32;31;1;96.875;3.125;230685.9375;2078.21875;107.34375
45180;2023;4;4;0;100;0;122060;1449;112.75
45181;2023;2;2;0;100;0;220000;2046;119
45182;2023;19;19;0;100;0;198857.315789474;1866.52631578947;108.473684210526
45183;2023;1;1;0;100;0;169310;1821;93
45184;2023;3;3;0;100;0;99333.3333333333;1160;92.3333333333333
45185;2023;4;4;0;100;0;204822.5;1905;106
45186;2023;7;7;0;100;0;136571.428571429;1356.85714285714;98.7142857142857
45187;2023;43;41;2;95.3488372093023;4.65116279069767;120624.534883721;1411.32558139535;89.1162790697674
45188;2023;22;22;0;100;0;210721.227272727;2037.5;108.045454545455
45189;2023;4;4;0;100;0;214750;1727.25;118.5
45191;2023;97;69;28;71.1340206185567;28.8659793814433;162289.175257732;1896.43298969072;87.2783505154639
45193;2023;26;26;0;100;0;207331.384615385;2023.46153846154;104.730769230769
45194;2023;27;24;3;88.8888888888889;11.1111111111111;234478.222222222;2292.88888888889;111.481481481481
45195;2023;8;8;0;100;0;166062.5;1807.375;104.125
45196;2023;12;12;0;100;0;200387.5;2347.16666666667;82.0833333333333
45197;2023;8;8;0;100;0;260907.5;2501.5;108.375
45198;2023;3;3;0;100;0;219666.666666667;1850.66666666667;119.666666666667
45199;2023;6;6;0;100;0;125250;1410.16666666667;93.8333333333333
45200;2023;18;18;0;100;0;223311.111111111;2101.38888888889;103.166666666667
45201;2023;2;2;0;100;0;164750;1273;129
45202;2023;10;10;0;100;0;171410;1962.3;94.9
45203;2023;61;55;6;90.1639344262295;9.83606557377049;197285.983606557;2163.26229508197;94.2622950819672
45204;2023;5;5;0;100;0;239980;1800.2;131.4
45205;2023;3;3;0;100;0;139333.333333333;1454.33333333333;88
45206;2023;6;6;0;100;0;129250;1494.83333333333;89.3333333333333
45207;2023;2;2;0;100;0;138500;2546;54.5
45208;2023;226;75;151;33.1858407079646;66.8141592920354;102894.234513274;1561.92920353982;67.6371681415929
45209;2023;4;4;0;100;0;163125;1121.25;150.5
45210;2023;8;8;0;100;0;134511.125;1498.125;89.125
45212;2023;14;13;1;92.8571428571429;7.14285714285714;143034.285714286;1597;98
45213;2023;7;7;0;100;0;179285.714285714;1824.42857142857;107.714285714286
45214;2023;4;4;0;100;0;94750;1003.5;88
45215;2023;3;3;0;100;0;108666.666666667;1389;78.3333333333333
45217;2023;2;2;0;100;0;128995;1125.5;122
45219;2023;2;2;0;100;0;191850;1974.5;91.5
45220;2023;7;7;0;100;0;173528.571428571;2094.57142857143;96.2857142857143
45222;2023;23;23;0;100;0;157839.913043478;1803.08695652174;90.6521739130435
45223;2023;9;9;0;100;0;193737.666666667;2372.11111111111;87.4444444444444
45224;2023;55;49;6;89.0909090909091;10.9090909090909;196535.254545455;2026.69090909091;98.1818181818182
45225;2023;3;3;0;100;0;193583.333333333;1656.33333333333;121.666666666667
45226;2023;11;11;0;100;0;165331.818181818;1812;93.9090909090909
45227;2023;14;14;0;100;0;159506.642857143;1685.42857142857;102
45228;2023;13;13;0;100;0;157096.153846154;1568.53846153846;101.230769230769
45229;2023;34;33;1;97.0588235294118;2.94117647058824;132008.676470588;1570.29411764706;89.9705882352941
45230;2023;13;13;0;100;0;123892.230769231;1465.69230769231;92.3076923076923
45231;2023;1;1;0;100;0;240000;1690;142
45232;2023;323;141;182;43.6532507739938;56.3467492260062;218929.922600619;2847.04953560371;79.4798761609907
45233;2023;3;3;0;100;0;134666.666666667;1549.33333333333;86.6666666666667
45234;2023;1744;417;1327;23.9105504587156;76.0894495412844;184997.865825688;2761.62155963303;68.7792431192661
45235;2023;37;29;8;78.3783783783784;21.6216216216216;222050.405405405;2473.7027027027;93.5675675675676
45237;2023;3;3;0;100;0;217400;2386.33333333333;91
45238;2023;7;7;0;100;0;119857.142857143;1488.28571428571;84.4285714285714
45239;2023;4;4;0;100;0;117500;1001.75;118.25
45240;2023;16;16;0;100;0;181777.8125;1945.1875;103.0625
45241;2023;4;4;0;100;0;168922.5;1801.25;93.5
45242;2023;2;2;0;100;0;151750;2201;70.5
45243;2023;4;4;0;100;0;166777.5;1880;88.25
45244;2023;38;38;0;100;0;153797.368421053;1867.73684210526;87.2894736842105
45245;2023;19;18;1;94.7368421052632;5.26315789473684;80507.1052631579;1108.47368421053;73.1052631578947
45246;2023;1;1;0;100;0;140000;2090;67
45247;2023;29;29;0;100;0;178733.793103448;1759.58620689655;104.896551724138
45248;2023;24;23;1;95.8333333333333;4.16666666666667;155447.166666667;1614.875;97.3333333333333
45249;2023;11;11;0;100;0;221440.909090909;1915.18181818182;114
45250;2023;1;1;0;100;0;108000;1588;68
45251;2023;3;3;0;100;0;90833.3333333333;1422;59.6666666666667
45252;2023;82;55;27;67.0731707317073;32.9268292682927;117979.256097561;1609.07317073171;74.4756097560976
45253;2023;13;12;1;92.3076923076923;7.69230769230769;166778.307692308;1822.15384615385;94.3076923076923
45254;2023;21;21;0;100;0;125362.380952381;1510.2380952381;87.7619047619048
45255;2023;5;5;0;100;0;190600;1713.6;113.6
45256;2023;6;6;0;100;0;167553.333333333;2150.66666666667;90
45257;2023;3;3;0;100;0;100666.666666667;1284.66666666667;79.6666666666667
45258;2023;47;44;3;93.6170212765958;6.38297872340426;139630.723404255;1691.85106382979;85.1063829787234
45259;2023;13;13;0;100;0;167784.615384615;1715.07692307692;102.692307692308
45260;2023;4;4;0;100;0;148287.5;2057.5;72.5
45261;2023;11;11;0;100;0;198326.363636364;1896.54545454545;105.727272727273
45262;2023;3;3;0;100;0;127000;1557.66666666667;87
45263;2023;4;4;0;100;0;170750;1869;86.25
45264;2023;1;1;0;100;0;217000;3239;67
45265;2023;8;8;0;100;0;126625;1512.875;85.625
45266;2023;5;5;0;100;0;182404;1578.6;121.8
45268;2023;4;4;0;100;0;83730.5;1322.75;66.25
45269;2023;46;43;3;93.4782608695652;6.52173913043478;241094.152173913;2211.19565217391;111.239130434783
45270;2023;30;30;0;100;0;162928.2;1731.96666666667;98.7333333333333
45271;2023;13;12;1;92.3076923076923;7.69230769230769;180537.692307692;1650.53846153846;104.230769230769
45272;2023;29;29;0;100;0;305295.172413793;2857.06896551724;113.034482758621
45273;2023;32;30;2;93.75;6.25;204490.625;2105.03125;106.625
45274;2023;58;50;8;86.2068965517241;13.7931034482759;306977;2826.58620689655;112.155172413793
45275;2023;6;6;0;100;0;105250;1418;76
45276;2023;10;10;0;100;0;117800;1174.6;99.9
45277;2023;8;8;0;100;0;164562.5;1445.75;105.5
45278;2023;24;24;0;100;0;141329.166666667;1245.91666666667;109.166666666667
45279;2023;24;24;0;100;0;115770.833333333;1376.54166666667;84.5416666666667
45280;2023;9;9;0;100;0;180922.222222222;1352.44444444444;128.888888888889
45281;2023;22;22;0;100;0;151104.772727273;1522.13636363636;98.4090909090909
45282;2023;28;21;7;75;25;250641;2552.14285714286;100.535714285714
45283;2023;1;1;0;100;0;117000;1500;78
45284;2023;261;136;125;52.1072796934866;47.8927203065134;185243.091954023;2279.80842911877;82.3984674329502
45285;2023;199;115;84;57.7889447236181;42.2110552763819;159590.452261307;2031.72864321608;78.9195979899498
45286;2023;131;59;72;45.0381679389313;54.9618320610687;192257.770992366;2643.9465648855;74.4045801526718
45288;2023;1;1;0;100;0;110000;1571;70
45289;2023;7;7;0;100;0;199737.142857143;1737;115.571428571429
45290;2023;18;18;0;100;0;217587;2078.27777777778;114.611111111111
45291;2023;8;8;0;100;0;143052.5;1335.375;108.125
45292;2023;14;14;0;100;0;127753.571428571;1195.78571428571;113.142857142857
45293;2023;14;14;0;100;0;188395.714285714;1783.92857142857;105.428571428571
45294;2023;3;3;0;100;0;135333.333333333;1635.33333333333;87
45296;2023;9;9;0;100;0;188217.777777778;2186.11111111111;90.4444444444444
45297;2023;15;15;0;100;0;124305.533333333;1685.66666666667;75.8666666666667
45298;2023;57;41;16;71.9298245614035;28.0701754385965;259174.263157895;2843.80701754386;91.4912280701754
45299;2023;4;4;0;100;0;165525;1437.25;127.75
45300;2023;35;35;0;100;0;249819.657142857;2350.82857142857;109.742857142857
45301;2023;3;3;0;100;0;141666.666666667;1981;73.6666666666667
45302;2023;148;120;28;81.0810810810811;18.9189189189189;204137.554054054;2340.29054054054;89.4324324324324
45303;2023;7;7;0;100;0;191585.714285714;1310.14285714286;126.428571428571
45305;2023;2;2;0;100;0;191500;2301.5;81
45306;2023;13;13;0;100;0;141330.769230769;1433.61538461538;103.538461538462
45307;2023;12;12;0;100;0;159393.75;1340.08333333333;122.416666666667
45308;2023;25;24;1;96;4;246213.6;2178.36;115.8
45309;2023;10;10;0;100;0;193289;1778.5;114.7
45310;2023;19;18;1;94.7368421052632;5.26315789473684;187703.684210526;2048.89473684211;96.5789473684211
45311;2023;6;6;0;100;0;212652.5;1842.33333333333;118.666666666667
45312;2023;5;5;0;100;0;158800;1465.2;104
45313;2023;10;10;0;100;0;190450;1994;100.7
45314;2023;5;5;0;100;0;135630;1439.2;95.4
45315;2023;54;48;6;88.8888888888889;11.1111111111111;136161;1659.64814814815;82.3518518518518
45316;2023;12;12;0;100;0;165084.5;1788.75;106.416666666667
45317;2023;24;24;0;100;0;246345.833333333;2315;113.875
45320;2023;4;4;0;100;0;244365;1982.25;126.5
45321;2023;12;12;0;100;0;154109.25;1571.41666666667;95.3333333333333
45322;2023;1;1;0;100;0;272000;2000;136
45323;2023;1;1;0;100;0;550000;5000;110
45324;2023;25;22;3;88;12;183223.2;1874.64;101.6
45325;2023;6;6;0;100;0;173050;2020.33333333333;93.8333333333333
45326;2023;5;5;0;100;0;112200;1372;85.6
45327;2023;18;18;0;100;0;191853.944444444;1886.61111111111;111.277777777778
45328;2023;5;5;0;100;0;164060;2229.6;71
45329;2023;28;27;1;96.4285714285714;3.57142857142857;104742.464285714;1411.67857142857;90.0714285714286
45330;2023;3;3;0;100;0;130885.333333333;1606.33333333333;96
45331;2023;6;6;0;100;0;299354.666666667;3474;97
45332;2023;33;32;1;96.969696969697;3.03030303030303;131932;1607.63636363636;84.4242424242424
45333;2023;13;12;1;92.3076923076923;7.69230769230769;273750;2120.69230769231;129.538461538462
45334;2023;7;7;0;100;0;173464.285714286;1602;104.142857142857
45335;2023;19;19;0;100;0;184382.736842105;1799.68421052632;110.947368421053
45336;2023;11;11;0;100;0;205727.272727273;1681.36363636364;114.818181818182
45337;2023;8;8;0;100;0;113437.5;1195.625;104.75
45338;2023;92;83;9;90.2173913043478;9.78260869565217;151483.706521739;1874.57608695652;83
45339;2023;4;4;0;100;0;196812.5;1403.25;137
45340;2023;9;9;0;100;0;195504.111111111;2278.77777777778;91.8888888888889
45341;2023;1;1;0;100;0;220000;1419;155
45342;2023;3;3;0;100;0;198110.666666667;1918;105
45343;2023;6;6;0;100;0;235648.166666667;2503.16666666667;99
45344;2023;5;5;0;100;0;146812;1272;124.4
45345;2023;11;11;0;100;0;159770;1870.36363636364;96.0909090909091
45346;2023;25;25;0;100;0;201443.6;2062.96;104.84
45347;2023;15;15;0;100;0;164366.666666667;1744.53333333333;97.7333333333333
45348;2023;6;6;0;100;0;172250;1776.33333333333;117.833333333333
46001;2023;7;7;0;100;0;143000;2091.14285714286;79.1428571428571
46003;2023;11;9;2;81.8181818181818;18.1818181818182;183272.727272727;1672.90909090909;109.454545454545
46004;2023;1;1;0;100;0;1,00E+05;1042;96
46005;2023;9;9;0;100;0;176922.222222222;1906.66666666667;94.2222222222222
46006;2023;8;8;0;100;0;191588.75;1753.5;102.25
46007;2023;6;6;0;100;0;201661.666666667;1836.16666666667;112.333333333333
46008;2023;3;3;0;100;0;220895.666666667;3278.66666666667;75
46009;2023;8;8;0;100;0;159910;1780.25;86.125
46011;2023;10;10;0;100;0;144780;1697;86.5
46012;2023;3;3;0;100;0;103333.333333333;1121;91
46013;2023;3;3;0;100;0;145500;1712.33333333333;92
46015;2023;15;14;1;93.3333333333333;6.66666666666667;116664.666666667;1329.8;94.6666666666667
46016;2023;3;3;0;100;0;179658.333333333;2362.66666666667;76
46017;2023;3;3;0;100;0;167000;2027.66666666667;84
46018;2023;4;4;0;100;0;231750;2205.75;106.25
46020;2023;5;5;0;100;0;156200;1560.8;86.8
46021;2023;4;4;0;100;0;138000;1900.5;74
46022;2023;7;7;0;100;0;281131.428571429;2681.28571428571;95
46023;2023;3;3;0;100;0;281371.666666667;1970.33333333333;145.333333333333
46024;2023;5;5;0;100;0;247200;1744.8;135.6
46026;2023;3;3;0;100;0;187883.333333333;2196.33333333333;84
46027;2023;1;1;0;100;0;139000;1695;82
46028;2023;17;17;0;100;0;139489.411764706;1775.11764705882;87.3529411764706
46029;2023;22;22;0;100;0;141230.363636364;1737;85.3636363636364
46030;2023;4;4;0;100;0;151750;1742.5;84
46031;2023;2;2;0;100;0;117290;1737;73.5
46032;2023;2;2;0;100;0;75000;1253;60.5
46033;2023;10;10;0;100;0;231760;2017;114.7
46034;2023;5;5;0;100;0;115200;1141.4;103.6
46035;2023;1;1;0;100;0;486000;2160;225
46036;2023;1;1;0;100;0;440000;2933;150
46038;2023;13;13;0;100;0;151532.923076923;1429.69230769231;103.615384615385
46039;2023;1;1;0;100;0;126000;1909;66
46040;2023;2;2;0;100;0;286150;2022.5;140
46042;2023;318;154;164;48.4276729559748;51.5723270440252;144270.405660377;1781.03459119497;81.6194968553459
46043;2023;2;2;0;100;0;252295;2173;120
46044;2023;5;5;0;100;0;163215;1606.2;97.4
46045;2023;15;14;1;93.3333333333333;6.66666666666667;221033.333333333;1877.66666666667;106.8
46046;2023;2;2;0;100;0;241500;1833.5;112
46047;2023;3;3;0;100;0;155000;1953.66666666667;79.3333333333333
46049;2023;4;4;0;100;0;286396.25;2737.5;116
46050;2023;4;4;0;100;0;188515;1998;92.5
46051;2023;1;1;0;100;0;229000;1877;122
46052;2023;4;4;0;100;0;203512.5;1576.25;138.75
46053;2023;7;7;0;100;0;156793.714285714;1956.28571428571;79.2857142857143
46054;2023;7;7;0;100;0;194485.714285714;2502.14285714286;81.4285714285714
46055;2023;9;9;0;100;0;98758.8888888889;1260;77.2222222222222
46056;2023;2;2;0;100;0;160850;2619.5;65
46057;2023;8;8;0;100;0;152043.75;1610.125;92.875
46058;2023;11;11;0;100;0;175493.636363636;1758.90909090909;99.0909090909091
46059;2023;4;4;0;100;0;95765.75;1195.75;79.75
46060;2023;4;4;0;100;0;196500;2508.75;75.25
46061;2023;3;3;0;100;0;110333.333333333;1611;68
46062;2023;7;7;0;100;0;209142.142857143;1649.14285714286;135.428571428571
46063;2023;15;15;0;100;0;130066;1541.8;90.4
46064;2023;12;12;0;100;0;187822.666666667;1967.41666666667;105
46065;2023;8;8;0;100;0;242589.375;2034.625;116.625
46066;2023;9;9;0;100;0;230756.111111111;2346.11111111111;109.666666666667
46068;2023;3;3;0;100;0;154333.333333333;1085;123.666666666667
46070;2023;5;5;0;100;0;198840;2292.2;97.8
46072;2023;2;2;0;100;0;259250;2100;121
46073;2023;6;6;0;100;0;96133.3333333333;1243;73
46074;2023;1;1;0;100;0;255000;2161;118
46075;2023;1;1;0;100;0;255000;4397;58
46076;2023;3;3;0;100;0;117166.666666667;1688.33333333333;80.6666666666667
46079;2023;2;2;0;100;0;60850;1043.5;60
46080;2023;14;14;0;100;0;201352.142857143;1992.5;105
46082;2023;3;3;0;100;0;268833.333333333;1849.66666666667;156
46083;2023;10;10;0;100;0;188665;1540.9;130.1
46084;2023;3;3;0;100;0;218766.666666667;1683.33333333333;154.333333333333
46085;2023;3;3;0;100;0;92000;1407;61.3333333333333
46086;2023;3;3;0;100;0;163333.333333333;1316.33333333333;116
46087;2023;9;9;0;100;0;191652.222222222;1905;101
46088;2023;4;4;0;100;0;165067.5;1629;99.25
46089;2023;13;13;0;100;0;234022.384615385;2512.30769230769;91.3846153846154
46090;2023;1;1;0;100;0;90000;2432;37
46091;2023;5;5;0;100;0;229374;2182.2;105.2
46092;2023;3;3;0;100;0;212800;2026;122
46093;2023;4;4;0;100;0;125750;1546;78.5
46094;2023;6;6;0;100;0;152706.666666667;1913.16666666667;106.666666666667
46095;2023;6;6;0;100;0;207906.666666667;1723.33333333333;119.166666666667
46097;2023;3;3;0;100;0;118566.666666667;1391.66666666667;75.6666666666667
46098;2023;2;2;0;100;0;162500;3250;50
46100;2023;5;5;0;100;0;174330;2083.2;81
46101;2023;4;4;0;100;0;189025;1643.5;97
46102;2023;133;70;63;52.6315789473684;47.3684210526316;141018.195488722;1791.58646616541;78.2631578947368
46103;2023;6;6;0;100;0;188833.333333333;1724.5;124.833333333333
46104;2023;2;2;0;100;0;232515;2539;85
46105;2023;4;4;0;100;0;220758.5;1759.5;127
46106;2023;2;2;0;100;0;110000;1895;57.5
46107;2023;2;2;0;100;0;241500;2034;134
46108;2023;7;7;0;100;0;106006.142857143;1613.42857142857;60.8571428571429
46109;2023;3;3;0;100;0;208333.333333333;2387.66666666667;83.3333333333333
46112;2023;2;2;0;100;0;75735;953.5;88
46113;2023;7;7;0;100;0;149510.714285714;1904.42857142857;96.2857142857143
46114;2023;8;8;0;100;0;234395;1702.25;129
46116;2023;1;1;0;100;0;222000;2037;109
46117;2023;4;4;0;100;0;127616.25;1763;67.5
46118;2023;9;9;0;100;0;249400;1906;116.666666666667
46120;2023;5;5;0;100;0;221742.8;2192.2;99.4
46121;2023;2;2;0;100;0;101400;1129;68.5
46123;2023;6;6;0;100;0;161241.666666667;1533.66666666667;116.5
46124;2023;2;2;0;100;0;163000;1793;85
46125;2023;4;4;0;100;0;177500;1746.75;103.75
46126;2023;1;1;0;100;0;196130;838;234
46127;2023;73;57;16;78.0821917808219;21.9178082191781;155708.164383562;1838.21917808219;93.4657534246575
46128;2023;43;37;6;86.046511627907;13.953488372093;140452.23255814;1600.74418604651;83.953488372093
46129;2023;5;5;0;100;0;241700;3356.6;89.2
46130;2023;4;4;0;100;0;114750;1450.75;76.75
46131;2023;6;6;0;100;0;198113.333333333;2143.83333333333;94
46132;2023;6;6;0;100;0;195361.666666667;1858.83333333333;112.166666666667
46134;2023;3;3;0;100;0;111316.666666667;1708.33333333333;68
46135;2023;1;1;0;100;0;30000;1200;25
46136;2023;4;4;0;100;0;136807.5;1795;90.75
46137;2023;14;14;0;100;0;235690.285714286;1868.21428571429;113.071428571429
46138;2023;11;11;0;100;0;187726.363636364;1923.27272727273;104.181818181818
46139;2023;1;1;0;100;0;95000;880;108
46140;2023;4;4;0;100;0;227115;2146.5;108.25
46142;2023;3;3;0;100;0;157166.666666667;2016.66666666667;78.6666666666667
46143;2023;16;15;1;93.75;6.25;195511.5625;2027.4375;96.5625
46144;2023;3;3;0;100;0;158666.666666667;1657.33333333333;97.6666666666667
46145;2023;18;18;0;100;0;141686.611111111;1467.16666666667;96.1666666666667
46148;2023;11;11;0;100;0;204897.272727273;1870.09090909091;108.454545454545
46149;2023;3;3;0;100;0;164833.333333333;1705.33333333333;104.666666666667
46151;2023;2;2;0;100;0;70000;906;82.5
46152;2023;5;5;0;100;0;136960;1324.8;118.2
46153;2023;14;14;0;100;0;182547.642857143;1840.64285714286;101.785714285714
46154;2023;1;1;0;100;0;77000;1013;76
46155;2023;2;2;0;100;0;212500;2717.5;78
46156;2023;13;13;0;100;0;176872.384615385;1701.53846153846;102.846153846154
46157;2023;2;2;0;100;0;84250;1134;73
46159;2023;5;5;0;100;0;115800;1732.2;66
46160;2023;7;7;0;100;0;115445.285714286;883.857142857143;130
46161;2023;2;2;0;100;0;76116.5;897;75
46162;2023;1;1;0;100;0;75625;560;135
46163;2023;8;7;1;87.5;12.5;85068.75;945.75;85.125
46165;2023;2;2;0;100;0;117500;1398.5;78
46167;2023;6;6;0;100;0;189300;1704.5;117.166666666667
46168;2023;3;3;0;100;0;119100;1179.66666666667;90.6666666666667
46169;2023;6;6;0;100;0;223725;2322.16666666667;111.833333333333
46170;2023;7;7;0;100;0;107142.857142857;1178.71428571429;94.4285714285714
46171;2023;7;7;0;100;0;247545.714285714;2540.42857142857;105.714285714286
46172;2023;6;6;0;100;0;222633.333333333;1967;116
46173;2023;14;12;2;85.7142857142857;14.2857142857143;179014.571428571;1499.14285714286;123.785714285714
46174;2023;1;1;0;100;0;55000;1528;36
46175;2023;8;8;0;100;0;197456.25;2081.625;101
46176;2023;8;8;0;100;0;156806.25;1947.75;74.25
46177;2023;4;4;0;100;0;230337.5;2049.25;112.5
46178;2023;3;3;0;100;0;145000;1486.33333333333;92.3333333333333
46180;2023;7;7;0;100;0;157471.428571429;1900;84.5714285714286
46181;2023;1;1;0;100;0;155072;2096;74
46182;2023;19;19;0;100;0;144771.052631579;1424.78947368421;102.578947368421
46183;2023;7;7;0;100;0;216571.428571429;1888.42857142857;106
46184;2023;5;5;0;100;0;149000;2067.4;64
46185;2023;23;22;1;95.6521739130435;4.34782608695652;195217.391304348;2471.30434782609;88.6086956521739
46187;2023;7;6;1;85.7142857142857;14.2857142857143;211507.142857143;2401.57142857143;95
46188;2023;3;3;0;100;0;237066.666666667;2946.66666666667;73.6666666666667
46189;2023;2;2;0;100;0;159750;1048.5;164.5
46190;2023;1;1;0;100;0;40000;930;43
46191;2023;18;17;1;94.4444444444444;5.55555555555556;154183.333333333;1799.55555555556;86.8888888888889
46192;2023;1;1;0;100;0;196000;2042;96
46193;2023;7;6;1;85.7142857142857;14.2857142857143;195522.142857143;2353.85714285714;85.5714285714286
46194;2023;1;1;0;100;0;220000;2391;92
46195;2023;5;5;0;100;0;131592;1679.8;85.8
46197;2023;10;10;0;100;0;194754;1908.4;94.2
46199;2023;2;2;0;100;0;201991.5;2403.5;86
46200;2023;4;4;0;100;0;141250;2272.5;71
46201;2023;39;35;4;89.7435897435898;10.2564102564103;202313.871794872;1989.53846153846;102.769230769231
46202;2023;4;4;0;100;0;140625;1342.5;108.25
46203;2023;2;2;0;100;0;284310;2745;107
46204;2023;10;9;1;90;10;119520;1233.3;101.5
46205;2023;8;8;0;100;0;170401.875;1734.875;96.75
46206;2023;2;2;0;100;0;150500;1575.5;95.5
46208;2023;3;3;0;100;0;1,00E+05;1690.33333333333;68.3333333333333
46209;2023;4;4;0;100;0;242750;2418.75;105.5
46210;2023;2;2;0;100;0;230300;2063;120.5
46211;2023;4;4;0;100;0;167162.5;1710.5;103.75
46213;2023;3;3;0;100;0;157833.333333333;1439.66666666667;104.666666666667
46214;2023;1;1;0;100;0;1,00E+05;1299;77
46215;2023;8;8;0;100;0;169068.375;1385;126.625
46216;2023;6;6;0;100;0;237075;2135.83333333333;111.833333333333
46217;2023;1;1;0;100;0;130000;1667;78
46218;2023;4;4;0;100;0;253403.75;1955;141.5
46219;2023;1;1;0;100;0;125000;665;188
46220;2023;8;7;1;87.5;12.5;193750;1933.875;98.125
46221;2023;6;6;0;100;0;250660.166666667;2357.16666666667;114.5
46223;2023;2;2;0;100;0;334390;1968;173
46224;2023;39;33;6;84.6153846153846;15.3846153846154;192238.256410256;1849.02564102564;107.666666666667
46225;2023;38;38;0;100;0;230520.026315789;2113.52631578947;112.578947368421
46226;2023;4;4;0;100;0;165750;1533;101.25
46227;2023;3;3;0;100;0;201266.666666667;2190.66666666667;89.3333333333333
46228;2023;10;10;0;100;0;192063.2;1719.7;114.3
46229;2023;13;13;0;100;0;166853.923076923;1836.76923076923;97.1538461538462
46230;2023;1;1;0;100;0;323500;1155;280
46231;2023;37;36;1;97.2972972972973;2.7027027027027;158201.405405405;1782.18918918919;94.7027027027027
46232;2023;10;10;0;100;0;196205.1;1983.2;104.4
46233;2023;1;1;0;100;0;61000;1220;50
46235;2023;1;1;0;100;0;236860;1579;150
46236;2023;1;1;0;100;0;140000;1750;80
46237;2023;2;2;0;100;0;260835;2310.5;112.5
46238;2023;2;2;0;100;0;258425;2617.5;99
46239;2023;3;3;0;100;0;136000;1454.66666666667;92.6666666666667
46240;2023;5;4;1;80;20;267060;3451.8;120
46241;2023;4;4;0;100;0;308407.5;1937.5;164
46242;2023;3;3;0;100;0;136000;1247.33333333333;110.666666666667
46243;2023;2;2;0;100;0;63500;598;106.5
46245;2023;3;3;0;100;0;245633.333333333;2152.66666666667;115.333333333333
46246;2023;1;1;0;100;0;125000;1389;90
46247;2023;2;2;0;100;0;150525;1576.5;91.5
46250;2023;1;1;0;100;0;67500;767;88
46251;2023;44;38;6;86.3636363636364;13.6363636363636;146445.363636364;1630.75;90.25
46252;2023;5;5;0;100;0;133430;1580.6;79.8
46253;2023;7;7;0;100;0;150904.571428571;1324.14285714286;114.142857142857
46254;2023;1;1;0;100;0;290000;3412;85
46255;2023;4;4;0;100;0;264150.5;3080.75;86
46256;2023;2;2;0;100;0;151528.5;900;142
46257;2023;5;5;0;100;0;190965.4;1701.2;119.2
46258;2023;1;1;0;100;0;275000;2696;102
46259;2023;1;1;0;100;0;65000;625;104
46260;2023;1;1;0;100;0;120000;1165;103
46262;2023;10;10;0;100;0;172279.1;1732.6;99.6
46263;2023;10;10;0;100;0;189630;1414.6;120
46264;2023;3;3;0;100;0;149166.666666667;3786;64.6666666666667
46265;2023;6;6;0;100;0;162666.666666667;1594;99.3333333333333
46266;2023;4;4;0;100;0;158325;1370.75;135.25
46267;2023;6;6;0;100;0;196866.666666667;1911.33333333333;98.8333333333333
46268;2023;17;17;0;100;0;169185.294117647;1778.35294117647;95.1176470588235
46269;2023;1;1;0;100;0;42000;560;75
46270;2023;7;7;0;100;0;248128.571428571;1897.42857142857;123.428571428571
46271;2023;7;7;0;100;0;163049.714285714;1463.28571428571;121.571428571429
46273;2023;3;2;1;66.6666666666667;33.3333333333333;161643;1768.33333333333;94
46276;2023;3;3;0;100;0;242696.666666667;2286;130.666666666667
46277;2023;3;3;0;100;0;128333.333333333;1215.66666666667;108.666666666667
46279;2023;3;3;0;100;0;190483.333333333;1575;120.333333333333
46280;2023;1;1;0;100;0;150000;2419;62
46281;2023;1;1;0;100;0;102500;1424;72
46283;2023;3;3;0;100;0;190500;1732;113
46284;2023;2;2;0;100;0;170350;2017.5;85.5
46286;2023;1;1;0;100;0;260000;2321;112
46288;2023;3;3;0;100;0;237893.333333333;1931.66666666667;120.333333333333
46289;2023;2;2;0;100;0;130500;1732;75.5
46290;2023;4;4;0;100;0;150605;1884.25;80
46292;2023;3;3;0;100;0;230333.333333333;1610;149.666666666667
46293;2023;5;5;0;100;0;200620;1898.8;101.2
46295;2023;3;3;0;100;0;202790;1913.66666666667;99.3333333333333
46296;2023;4;4;0;100;0;145620;1482;94.25
46297;2023;18;18;0;100;0;151791.277777778;1554.44444444444;90.6666666666667
46299;2023;3;3;0;100;0;113970;1484.66666666667;93
46301;2023;8;8;0;100;0;227709;1856.125;123.75
46302;2023;3;3;0;100;0;97499.6666666667;915;102.333333333333
46303;2023;2;2;0;100;0;220500;2365;90.5
46304;2023;2;2;0;100;0;51250;1131.5;45.5
46305;2023;2;2;0;100;0;195600;1479;133
46307;2023;6;6;0;100;0;152166.666666667;1775.16666666667;91.1666666666667
46308;2023;1;1;0;100;0;37550;894;42
46309;2023;54;43;11;79.6296296296296;20.3703703703704;139308.611111111;1475.61111111111;95.7407407407407
46310;2023;1;1;0;100;0;151500;1918;79
46311;2023;16;16;0;100;0;144876.8125;1269.75;120.5625
46312;2023;2;1;1;50;50;311250;1828;155
46313;2023;7;7;0;100;0;168710.142857143;1398.57142857143;120.714285714286
46314;2023;4;4;0;100;0;128805;1617.75;75.75
46315;2023;3;3;0;100;0;47870.3333333333;1511.33333333333;55
46316;2023;4;4;0;100;0;187949.75;2689.5;81.5
46317;2023;8;8;0;100;0;236064.25;2125.25;111.625
46318;2023;2;2;0;100;0;73000;1362.5;51
46320;2023;4;4;0;100;0;146005;1734.75;97.25
46321;2023;3;3;0;100;0;147388.333333333;1628.66666666667;85
46322;2023;3;3;0;100;0;132500;2139.66666666667;68.6666666666667
46323;2023;3;3;0;100;0;143578.666666667;1980.33333333333;84.6666666666667
46324;2023;2;2;0;100;0;132765;1352.5;87.5
46328;2023;4;4;0;100;0;139675;1546.5;89
46329;2023;3;3;0;100;0;140933.333333333;2004;78.3333333333333
46330;2023;19;18;1;94.7368421052632;5.26315789473684;175457.368421053;1642.47368421053;105.526315789474
46332;2023;2;2;0;100;0;180373;1785;103.5
46333;2023;2;2;0;100;0;79000;958.5;75.5
46334;2023;26;25;1;96.1538461538462;3.84615384615385;204859.076923077;1999.11538461538;103.884615384615
46335;2023;4;4;0;100;0;253162.5;2314.25;117.25
46336;2023;2;2;0;100;0;187000;1679.5;116.5
46337;2023;4;4;0;100;0;215893.25;1779.5;118.5
46338;2023;2;2;0;100;0;83500;678.5;114
46339;2023;3;3;0;100;0;174993.333333333;1500;112
46340;2023;4;4;0;100;0;189750;1756.25;115
47001;2023;615;216;399;35.1219512195122;64.8780487804878;128442.941463415;1869.10081300813;70.7886178861789
47002;2023;3;3;0;100;0;329310;2007;167.333333333333
47003;2023;8;8;0;100;0;170812.5;1461.375;136.25
47004;2023;58;47;11;81.0344827586207;18.9655172413793;144699.568965517;1522.22413793103;98.6724137931034
47005;2023;11;11;0;100;0;205820.545454545;1750.45454545455;121.454545454545
47006;2023;4;4;0;100;0;153248.75;1591;96.75
47007;2023;4;4;0;100;0;170886.75;1621;116
47009;2023;1;1;0;100;0;220000;1630;135
47010;2023;4;4;0;100;0;204937.5;1362.5;147.75
47011;2023;2;2;0;100;0;298000;2246.5;128.5
47012;2023;5;5;0;100;0;194200;1963.6;96.4
47013;2023;3;3;0;100;0;214913.666666667;1981.66666666667;97.6666666666667
47014;2023;1;1;0;100;0;63000;618;102
47015;2023;20;19;1;95;5;147284;1368.5;100.55
47016;2023;14;14;0;100;0;203431.428571429;1910.85714285714;109.142857142857
47017;2023;5;5;0;100;0;161760;1153.8;141.4
47018;2023;6;6;0;100;0;178875;1631.66666666667;104.166666666667
47019;2023;11;11;0;100;0;260588.727272727;1944.81818181818;134.363636363636
47020;2023;2;2;0;100;0;416119.5;2027;208.5
47021;2023;24;23;1;95.8333333333333;4.16666666666667;145022.625;1504.54166666667;98
47022;2023;1;1;0;100;0;110000;1392;79
47023;2023;3;3;0;100;0;192183.333333333;1856.66666666667;104.333333333333
47024;2023;13;13;0;100;0;237828;2083.84615384615;116.769230769231
47025;2023;11;11;0;100;0;204385.454545455;1920.18181818182;104.545454545455
47026;2023;4;4;0;100;0;274125;2374;125.5
47027;2023;30;30;0;100;0;161588.133333333;1694.3;96.5666666666667
47028;2023;7;7;0;100;0;147585.714285714;1345;117
47029;2023;15;15;0;100;0;175081.4;1899.86666666667;90.5333333333333
47030;2023;1;1;0;100;0;150000;1562;96
47031;2023;77;69;8;89.6103896103896;10.3896103896104;185136.545454545;1936.27272727273;98.6363636363636
47032;2023;71;62;9;87.3239436619718;12.6760563380282;181022.478873239;1914.98591549296;94.7605633802817
47033;2023;2;2;0;100;0;252100;1884;130
47034;2023;7;7;0;100;0;151285.714285714;1685.71428571429;90.8571428571429
47035;2023;1;1;0;100;0;69690;860;81
47036;2023;7;7;0;100;0;139300;1339.57142857143;107.714285714286
47037;2023;2;2;0;100;0;110000;1130.5;95.5
47038;2023;6;6;0;100;0;206400;1524;145.833333333333
47040;2023;20;20;0;100;0;240694;2238;106.5
47041;2023;7;6;1;85.7142857142857;14.2857142857143;142991.428571429;1335.14285714286;109.285714285714
47042;2023;1;1;0;100;0;410000;3727;110
47043;2023;19;18;1;94.7368421052632;5.26315789473684;138500;1208.36842105263;115.421052631579
47044;2023;7;7;0;100;0;100466.142857143;1071.14285714286;96.1428571428571
47045;2023;3;3;0;100;0;167158.666666667;1000.66666666667;173.666666666667
47046;2023;3;3;0;100;0;145000;1503.33333333333;98.6666666666667
47047;2023;3;3;0;100;0;376886;2436.66666666667;152.666666666667
47048;2023;20;19;1;95;5;166413.25;1494.15;113.4
47049;2023;21;21;0;100;0;128205.238095238;1310.38095238095;99.7142857142857
47050;2023;3;3;0;100;0;198816.666666667;1517.66666666667;132
47051;2023;25;24;1;96;4;184832.8;2005.12;92.92
47052;2023;71;54;17;76.056338028169;23.943661971831;152825.929577465;1903.30985915493;85.3098591549296
47053;2023;2;2;0;100;0;125650;1720.5;74
47054;2023;12;12;0;100;0;115026.083333333;1281.83333333333;92.5
47055;2023;13;9;4;69.2307692307692;30.7692307692308;109051.923076923;1459.07692307692;76.6923076923077
47056;2023;9;9;0;100;0;168744.444444444;1574.22222222222;106
47057;2023;22;22;0;100;0;129606.363636364;1314.31818181818;102.363636363636
47058;2023;4;4;0;100;0;161875;1930;85
47059;2023;1;1;0;100;0;115000;958;120
47060;2023;12;12;0;100;0;169485;1551.25;108.833333333333
47061;2023;4;4;0;100;0;147416.75;1250.25;128.75
47062;2023;6;6;0;100;0;197981;1657.16666666667;122.166666666667
47063;2023;1;1;0;100;0;265000;4206;63
47064;2023;1;1;0;100;0;230000;1949;118
47065;2023;35;34;1;97.1428571428571;2.85714285714286;148505.428571429;1435.54285714286;117.857142857143
47066;2023;10;10;0;100;0;200291;2014;103.3
47067;2023;4;4;0;100;0;161750;1676.5;96.5
47068;2023;12;11;1;91.6666666666667;8.33333333333333;213569.166666667;1547.25;151
47069;2023;38;33;5;86.8421052631579;13.1578947368421;181564.342105263;1826.94736842105;100.684210526316
47070;2023;10;10;0;100;0;202008;1876.8;105.7
47071;2023;3;3;0;100;0;120666.666666667;1266.33333333333;93
47072;2023;1;1;0;100;0;1050000;3116;337
47073;2023;1;1;0;100;0;145000;1611;90
47074;2023;4;4;0;100;0;113702.5;1117.5;99.75
47075;2023;11;11;0;100;0;253583.636363636;1957.72727272727;132.636363636364
47077;2023;6;6;0;100;0;255519.166666667;2019.83333333333;113.166666666667
47078;2023;22;17;5;77.2727272727273;22.7272727272727;108515.909090909;1238.04545454545;87.4545454545455
47079;2023;8;8;0;100;0;170525;1525.75;114
47080;2023;5;5;0;100;0;202809;1568.2;139.6
47081;2023;8;8;0;100;0;258056.875;1829.75;141.75
47082;2023;2;2;0;100;0;235000;1767;136.5
47083;2023;3;3;0;100;0;356000;2582.33333333333;143.333333333333
47084;2023;2;2;0;100;0;242000;1577;138
47085;2023;3;3;0;100;0;153566.666666667;1977.33333333333;86
47086;2023;15;15;0;100;0;220660.666666667;1471.06666666667;144.666666666667
47087;2023;1;1;0;100;0;119000;2288;52
47088;2023;18;7;11;38.8888888888889;61.1111111111111;105397.222222222;1369.88888888889;69.0555555555556
47089;2023;4;4;0;100;0;231087.5;1582.5;140.5
47090;2023;1;1;0;100;0;530000;1767;300
47091;2023;38;28;10;73.6842105263158;26.3157894736842;195116.315789474;2181.84210526316;87.5263157894737
47092;2023;4;4;0;100;0;279242;2101;137.5
47093;2023;4;4;0;100;0;96875;1228.25;76.5
47094;2023;6;6;0;100;0;138058.333333333;1531.16666666667;93
47095;2023;7;7;0;100;0;155714.285714286;1129.28571428571;111.142857142857
47096;2023;1;1;0;100;0;503487;2310;218
47097;2023;11;11;0;100;0;163547.363636364;1375.54545454545;125.454545454545
47098;2023;2;2;0;100;0;358335;1643;213.5
47099;2023;8;8;0;100;0;272200.625;1629.375;167.25
47100;2023;59;58;1;98.3050847457627;1.69491525423729;240347.542372881;2178.05084745763;110.525423728814
47101;2023;7;7;0;100;0;211466.142857143;2164.85714285714;100.142857142857
47102;2023;6;6;0;100;0;182000;1229.83333333333;146.333333333333
47103;2023;2;2;0;100;0;244415;1019.5;212.5
47104;2023;3;3;0;100;0;144000;1396;106
47105;2023;1;1;0;100;0;238700;1717;139
47106;2023;86;80;6;93.0232558139535;6.97674418604651;117986.23255814;1222.09302325581;94.3255813953488
47107;2023;3;3;0;100;0;81266.6666666667;876;103
47108;2023;1;1;0;100;0;170500;1421;120
47109;2023;4;4;0;100;0;186500;1351;139.75
47110;2023;18;17;1;94.4444444444444;5.55555555555556;166943.333333333;2197.55555555556;99.0555555555556
47111;2023;8;8;0;100;0;175076.25;1444.375;123.25
47112;2023;10;10;0;100;0;164200;1736.4;101.7
47114;2023;3;3;0;100;0;158750;1612;97.3333333333333
47115;2023;2;2;0;100;0;222100;1911.5;116.5
47117;2023;6;6;0;100;0;240533.333333333;1929.66666666667;129.166666666667
47118;2023;2;2;0;100;0;221950;2534;86
47119;2023;13;13;0;100;0;148034.615384615;1428.84615384615;106
47120;2023;1;1;0;100;0;195000;1250;156
47121;2023;1;1;0;100;0;194000;2156;90
47123;2023;4;4;0;100;0;466475;4728.75;108.75
47124;2023;2;2;0;100;0;138515;1387;100.5
47125;2023;10;10;0;100;0;144050;1241.4;119.8
47126;2023;2;2;0;100;0;143205;1510;95
47127;2023;7;7;0;100;0;190635.714285714;1753.28571428571;117
47128;2023;8;7;1;87.5;12.5;193574.125;1927.625;95.125
47129;2023;3;3;0;100;0;212883.333333333;1804.33333333333;124
47130;2023;5;5;0;100;0;358398;2514.2;153.6
47131;2023;6;6;0;100;0;308816.666666667;2276.16666666667;136.5
47132;2023;3;3;0;100;0;251666.666666667;1751.33333333333;152.333333333333
47133;2023;8;8;0;100;0;144112.5;1720.125;98.625
47134;2023;6;6;0;100;0;235499.166666667;1635;142.333333333333
47135;2023;6;6;0;100;0;192613.333333333;1358.33333333333;139.333333333333
47136;2023;2;2;0;100;0;194094;1850;105
47137;2023;6;5;1;83.3333333333333;16.6666666666667;239985;1927.83333333333;132.833333333333
47138;2023;17;17;0;100;0;223965.352941176;2053.29411764706;108.823529411765
47139;2023;1;1;0;100;0;825000;2546;324
47140;2023;8;8;0;100;0;179993.75;1762.75;96.25
47141;2023;4;4;0;100;0;191703.75;1259.75;148
47142;2023;15;15;0;100;0;220741.533333333;1697.06666666667;133.133333333333
47143;2023;27;26;1;96.2962962962963;3.7037037037037;137974.851851852;1477.48148148148;95
47144;2023;10;10;0;100;0;238158.7;1786.5;135.1
47145;2023;52;42;10;80.7692307692308;19.2307692307692;160263.769230769;1757.17307692308;87.3461538461538
47146;2023;12;11;1;91.6666666666667;8.33333333333333;178793.333333333;1653.33333333333;117.25
47147;2023;6;6;0;100;0;119766.666666667;1357.66666666667;87.5
47150;2023;2;2;0;100;0;157500;1681;94
47151;2023;6;6;0;100;0;211602.5;1463.66666666667;147.166666666667
47152;2023;7;7;0;100;0;195050.428571429;1630.57142857143;115
47154;2023;6;6;0;100;0;279958.333333333;2284;124.666666666667
47155;2023;3;3;0;100;0;501233.666666667;2298;205
47156;2023;13;13;0;100;0;161438.461538462;1716.23076923077;96
47157;2023;299;207;92;69.2307692307692;30.7692307692308;127957.227424749;1586.87959866221;81.7591973244147
47158;2023;1;1;0;100;0;473940;2257;210
47159;2023;15;15;0;100;0;121546.666666667;1163.6;106.266666666667
47160;2023;4;4;0;100;0;242750;2404.75;102.75
47162;2023;3;3;0;100;0;403223.333333333;2506;166.333333333333
47163;2023;5;5;0;100;0;252450;2146.6;117.8
47164;2023;2;2;0;100;0;231500;1937.5;127
47165;2023;11;11;0;100;0;130128.909090909;1026.63636363636;141.909090909091
47167;2023;15;15;0;100;0;125780;1245.73333333333;93.8666666666667
47168;2023;65;57;8;87.6923076923077;12.3076923076923;101780.846153846;1207.35384615385;85.6615384615385
47169;2023;5;5;0;100;0;262030;2233.4;117
47170;2023;11;11;0;100;0;172141.545454545;1487.18181818182;110.727272727273
47171;2023;4;4;0;100;0;198595;1494;121.75
47173;2023;12;12;0;100;0;154500.666666667;1295.25;115.916666666667
47174;2023;6;6;0;100;0;303176.666666667;1670;179.166666666667
47175;2023;49;42;7;85.7142857142857;14.2857142857143;150264.469387755;1447.59183673469;92.4897959183673
47176;2023;2;2;0;100;0;93444.5;1139.5;88.5
47177;2023;4;4;0;100;0;118750;1025;148.25
47178;2023;5;5;0;100;0;138305;1171;133.8
47179;2023;35;35;0;100;0;120600.428571429;1112.17142857143;108.571428571429
47180;2023;1;1;0;100;0;178900;988;181
47181;2023;8;8;0;100;0;284411.25;2027.5;143.25
47182;2023;3;3;0;100;0;276666.666666667;1411;185.333333333333
47184;2023;6;6;0;100;0;171781.833333333;1201.33333333333;129.333333333333
47185;2023;45;45;0;100;0;141474.022222222;1512.44444444444;97.4888888888889
47186;2023;9;9;0;100;0;195477.777777778;1498.33333333333;135.555555555556
47187;2023;3;3;0;100;0;268000;2247.33333333333;115
47188;2023;3;3;0;100;0;246570.333333333;2787.33333333333;86
47189;2023;1;1;0;100;0;265000;2038;130
47190;2023;1;1;0;100;0;95000;1557;61
47191;2023;6;6;0;100;0;161535.833333333;1872.33333333333;86
47193;2023;2;2;0;100;0;197700;2117.5;104.5
47194;2023;7;7;0;100;0;230601.428571429;1462.28571428571;168.714285714286
47195;2023;91;77;14;84.6153846153846;15.3846153846154;156323.373626374;1581.84615384615;97.9450549450549
47196;2023;2;2;0;100;0;115000;1755.5;65.5
47197;2023;5;5;0;100;0;208671.8;1572.6;135.8
47198;2023;4;4;0;100;0;220800;1806.75;130
47199;2023;5;5;0;100;0;220294.2;1637.4;137
47200;2023;1;1;0;100;0;252500;1778;142
47201;2023;152;127;25;83.5526315789474;16.4473684210526;159709.855263158;1934.01315789474;82.6184210526316
47202;2023;2;2;0;100;0;173630;2084.5;81.5
47203;2023;40;33;7;82.5;17.5;176274.85;1767.5;96.625
47204;2023;5;5;0;100;0;142890;1436;99.8
47205;2023;3;3;0;100;0;279666.666666667;2116.33333333333;136.666666666667
47206;2023;4;4;0;100;0;303562.5;2643.25;123.5
47207;2023;1;1;0;100;0;197700;1594;124
47208;2023;1;1;0;100;0;330000;2012;164
47209;2023;57;52;5;91.2280701754386;8.7719298245614;158641.228070175;1860.12280701754;84.3157894736842
47210;2023;15;15;0;100;0;170988.466666667;1503.86666666667;108.2
47211;2023;2;2;0;100;0;157350;1350.5;115.5
47212;2023;7;7;0;100;0;198211.428571429;2046.42857142857;102
47213;2023;13;13;0;100;0;207576.923076923;1772.76923076923;115.923076923077
47214;2023;5;5;0;100;0;225184;1488;153.4
47215;2023;51;47;4;92.156862745098;7.84313725490196;167624.68627451;1656.47058823529;105.686274509804
47216;2023;8;8;0;100;0;144157.625;1730.5;92.25
47217;2023;13;13;0;100;0;154838.461538462;1894.53846153846;87
47218;2023;2;2;0;100;0;265783;2665.5;100
47219;2023;1;1;0;100;0;150000;1579;95
47220;2023;1;1;0;100;0;145000;1450;100
47221;2023;6;6;0;100;0;116294.5;1096.16666666667;111.666666666667
47222;2023;3;3;0;100;0;263900;2395.66666666667;121.333333333333
47223;2023;2;2;0;100;0;105000;1233.5;86.5
47224;2023;2;2;0;100;0;65000;935.5;76.5
47225;2023;21;21;0;100;0;237722.714285714;2240.09523809524;105.142857142857
47226;2023;7;7;0;100;0;168282.428571429;1541.85714285714;108
47228;2023;6;6;0;100;0;173681.333333333;1834.66666666667;95.1666666666667
47229;2023;4;4;0;100;0;209873.75;1733.25;124.5
47230;2023;3;3;0;100;0;112333.333333333;1155.33333333333;96.6666666666667
47231;2023;1;1;0;100;0;284550;2846;100
47232;2023;15;15;0;100;0;162500;1351.8;125.466666666667
47233;2023;46;39;7;84.7826086956522;15.2173913043478;166404.108695652;1614.71739130435;104.630434782609
47234;2023;7;7;0;100;0;251155.714285714;2294;106.285714285714
47235;2023;10;10;0;100;0;220269;2055.9;108.3
47236;2023;1;1;0;100;0;598876;2339;256
47237;2023;8;8;0;100;0;228779.25;1919;133.875
47238;2023;15;15;0;100;0;237862.666666667;1635.13333333333;140.933333333333
47239;2023;5;5;0;100;0;174320;1540;113.6
47240;2023;3;3;0;100;0;302683.333333333;1849.66666666667;194
47241;2023;16;16;0;100;0;260766;1817.625;155.9375
47242;2023;3;3;0;100;0;136955;1259;101.666666666667
47244;2023;1;1;0;100;0;210000;1235;170
47245;2023;3;3;0;100;0;188750;1544.33333333333;117
47246;2023;15;15;0;100;0;245413.333333333;1847.86666666667;132.133333333333
47248;2023;6;6;0;100;0;275248.333333333;2097.83333333333;139.166666666667
47249;2023;3;3;0;100;0;78333.3333333333;1322.33333333333;63.6666666666667
47251;2023;2;2;0;100;0;223250;3365;75
47252;2023;74;73;1;98.6486486486486;1.35135135135135;140410.959459459;1457.35135135135;98.8108108108108
47253;2023;4;4;0;100;0;163315;1810.5;81.75
47254;2023;5;5;0;100;0;234880;2479.2;116.8
47257;2023;7;7;0;100;0;223685.857142857;2183;103.857142857143
47258;2023;5;5;0;100;0;190280;1710.8;104.8
47260;2023;8;8;0;100;0;146000;1476.125;93.75
47262;2023;4;4;0;100;0;155412.5;1378.75;115.25
47263;2023;3;3;0;100;0;178000;1837;110
47264;2023;24;24;0;100;0;156845.083333333;1646.83333333333;97.4583333333333
47265;2023;6;6;0;100;0;150938.333333333;1647.83333333333;95
47266;2023;2;2;0;100;0;172500;1421.5;120
47267;2023;2;2;0;100;0;149500;979;131
47269;2023;10;10;0;100;0;258095.4;1829.2;143.6
47271;2023;3;3;0;100;0;153922;1410.33333333333;115.666666666667
47272;2023;3;3;0;100;0;271333.333333333;2159.66666666667;128.333333333333
47274;2023;5;5;0;100;0;185736;1600.6;107.4
47275;2023;3;3;0;100;0;94833.3333333333;1269.33333333333;96.6666666666667
47276;2023;3;3;0;100;0;223966.666666667;2674.33333333333;101.333333333333
47277;2023;3;3;0;100;0;77000;1018.33333333333;73
47278;2023;4;4;0;100;0;181951.75;1306.25;135.5
47279;2023;8;8;0;100;0;145250;1516.75;100.125
47280;2023;32;31;1;96.875;3.125;160649.28125;1653.8125;98.84375
47281;2023;5;5;0;100;0;217710;1638.2;141
47282;2023;3;3;0;100;0;195583.333333333;1477;165.333333333333
47283;2023;14;14;0;100;0;108921.428571429;1227.42857142857;82.9285714285714
47284;2023;4;4;0;100;0;174640;1711.75;98.75
47285;2023;6;6;0;100;0;168666.666666667;1327;118.5
47287;2023;3;3;0;100;0;150344.333333333;1564.66666666667;105
47288;2023;8;8;0;100;0;210923.375;2084.625;99.125
47289;2023;8;8;0;100;0;175293.75;1524.25;113.875
47290;2023;12;12;0;100;0;169491.416666667;1434.25;120.416666666667
47291;2023;5;5;0;100;0;239400;1912.2;118.4
47292;2023;13;13;0;100;0;140753.769230769;1217.23076923077;102.538461538462
47293;2023;5;5;0;100;0;143000;1304;100
47294;2023;5;5;0;100;0;235271.4;1957.6;112.2
47295;2023;1;1;0;100;0;207000;1169;177
47296;2023;2;2;0;100;0;258000;2370.5;117
47297;2023;3;3;0;100;0;322566.666666667;2065.33333333333;155
47298;2023;1;1;0;100;0;179350;1495;120
47299;2023;5;5;0;100;0;343934;1612.4;188.8
47300;2023;12;12;0;100;0;249183.333333333;2294.66666666667;110.5
47301;2023;14;14;0;100;0;192864.571428571;1619.78571428571;120.928571428571
47302;2023;17;17;0;100;0;92636.4705882353;1037.41176470588;87.4117647058823
47305;2023;3;3;0;100;0;163833.333333333;1333.66666666667;146
47306;2023;10;10;0;100;0;194782.4;2040.7;111
47307;2023;2;2;0;100;0;191110;1425;109
47308;2023;2;2;0;100;0;184200;1964.5;95
47309;2023;9;9;0;100;0;127909.333333333;1620.77777777778;83.1111111111111
47310;2023;151;121;30;80.1324503311258;19.8675496688742;116051.774834437;1349.90728476821;87.1788079470199
47311;2023;1;1;0;100;0;170000;2179;78
47312;2023;10;10;0;100;0;255150;1747.3;130.3
47313;2023;1;1;0;100;0;295000;1903;155
47314;2023;5;5;0;100;0;210238;1767.6;115.4
47315;2023;5;5;0;100;0;120398;1224.6;101.2
47316;2023;3;3;0;100;0;185333.333333333;1416.33333333333;128.333333333333
47317;2023;6;6;0;100;0;91913.3333333333;906.5;109
47318;2023;28;26;2;92.8571428571429;7.14285714285714;134464.285714286;1532.57142857143;90.7142857142857
47319;2023;1;1;0;100;0;140000;1750;80
47320;2023;5;5;0;100;0;187964;1183.8;182.6
47321;2023;3;3;0;100;0;137000;1409;90.3333333333333
47323;2023;386;292;94;75.6476683937824;24.3523316062176;125644.279792746;1454.22797927461;87.4170984455959
47324;2023;30;30;0;100;0;165714.166666667;1611;104.233333333333
47325;2023;4;4;0;100;0;143500;1582.75;94
47326;2023;10;10;0;100;0;225326;2293.8;107.3
47327;2023;3;3;0;100;0;114666.666666667;1343.66666666667;92.3333333333333
47328;2023;4;4;0;100;0;149875;1489.5;102
48001;2023;3;3;0;100;0;76666.6666666667;1035;73.3333333333333
48002;2023;3;3;0;100;0;130473.333333333;1278;110.333333333333
48003;2023;1;1;0;100;0;115000;1237;93
48004;2023;3;2;1;66.6666666666667;33.3333333333333;88033.3333333333;1313;75.3333333333333
48005;2023;1;1;0;100;0;75000;2143;35
48008;2023;5;5;0;100;0;100889;1570.8;65.6
48009;2023;15;14;1;93.3333333333333;6.66666666666667;126178.933333333;1419.73333333333;92.1333333333333
48010;2023;1;1;0;100;0;59000;702;84
48012;2023;2;2;0;100;0;116250;1651;86.5
48013;2023;8;6;2;75;25;194412.5;1863.375;107.125
48015;2023;4;4;0;100;0;126083.25;1956.75;69.25
48016;2023;5;5;0;100;0;162970;1684;90.6
48017;2023;10;9;1;90;10;228348.5;2212.4;95.8
48018;2023;4;4;0;100;0;144450;1575.75;87.5
48019;2023;4;4;0;100;0;209000;1398.75;102.75
48020;2023;3;3;0;100;0;114956.666666667;1477.33333333333;84.3333333333333
48021;2023;6;5;1;83.3333333333333;16.6666666666667;110145;1374.16666666667;87.1666666666667
48025;2023;1;1;0;100;0;261000;1652;158
48026;2023;1;1;0;100;0;223500;2511;89
48027;2023;18;16;2;88.8888888888889;11.1111111111111;113909.888888889;1471.44444444444;81.5555555555556
48028;2023;2;2;0;100;0;65000;583.5;105
48029;2023;1;1;0;100;0;115000;1769;65
48030;2023;1;1;0;100;0;129000;1612;80
48032;2023;1;1;0;100;0;54580;895;61
48034;2023;24;22;2;91.6666666666667;8.33333333333333;126006.291666667;1701.70833333333;78.125
48036;2023;5;5;0;100;0;145108;2340.8;77.2
48038;2023;8;7;1;87.5;12.5;110216.875;1244.375;94.625
48039;2023;16;14;2;87.5;12.5;117741.6875;1454.1875;79.3125
48041;2023;1;1;0;100;0;310280;2722;114
48042;2023;6;6;0;100;0;218560;2166.16666666667;109.333333333333
48043;2023;4;4;0;100;0;134545;1058;133.25
48045;2023;3;3;0;100;0;77950;1189.33333333333;64.6666666666667
48046;2023;2;2;0;100;0;111190;1071.5;92.5
48048;2023;1;1;0;100;0;173000;2471;70
48050;2023;7;7;0;100;0;141596.142857143;1846;76
48051;2023;6;6;0;100;0;177048.333333333;2143.83333333333;85.5
48053;2023;4;4;0;100;0;68525;1122.75;59
48054;2023;2;2;0;100;0;133200;1831.5;71.5
48055;2023;2;2;0;100;0;175000;3631.5;57
48056;2023;5;5;0;100;0;164150;1836.4;90.2
48058;2023;3;3;0;100;0;115666.666666667;1484.66666666667;76.6666666666667
48059;2023;1;1;0;100;0;68000;1214;56
48061;2023;17;14;3;82.3529411764706;17.6470588235294;163650.764705882;1839.35294117647;86.7647058823529
48064;2023;1;1;0;100;0;45000;643;70
48065;2023;2;2;0;100;0;44665;971;45
48067;2023;1;1;0;100;0;3,00E+05;1500;200
48068;2023;2;2;0;100;0;225000;1414;149.5
48069;2023;2;2;0;100;0;202202.5;1358;121
48070;2023;10;9;1;90;10;79225;1053.8;73.6
48072;2023;1;1;0;100;0;58500;801;73
48073;2023;1;1;0;100;0;1,00E+05;909;110
48074;2023;4;4;0;100;0;143504.5;1491;101.75
48075;2023;15;13;2;86.6666666666667;13.3333333333333;166135.866666667;2277.6;76
48079;2023;7;7;0;100;0;144842.857142857;1486.85714285714;92
48080;2023;44;30;14;68.1818181818182;31.8181818181818;104025.204545455;1338.77272727273;78.6590909090909
48081;2023;2;2;0;100;0;112515;1089.5;100
48083;2023;6;5;1;83.3333333333333;16.6666666666667;81091.8333333333;775.333333333333;104.333333333333
48086;2023;5;5;0;100;0;92810;1264.2;79.4
48087;2023;4;4;0;100;0;162730;1321.75;134.5
48088;2023;2;2;0;100;0;165500;2584;63
48089;2023;5;5;0;100;0;171400;1632.8;99.2
48090;2023;6;5;1;83.3333333333333;16.6666666666667;145048.333333333;1369.83333333333;113.166666666667
48092;2023;62;32;30;51.6129032258064;48.3870967741936;124674.193548387;1459.91935483871;86.9032258064516
48094;2023;9;8;1;88.8888888888889;11.1111111111111;119752.222222222;1616.66666666667;72.4444444444444
48095;2023;114;53;61;46.4912280701754;53.5087719298246;155271.122807018;2042.92105263158;78.5263157894737
48096;2023;7;7;0;100;0;122392.857142857;1735.71428571429;71.8571428571429
48097;2023;2;2;0;100;0;256500;2356;101.5
48098;2023;1;1;0;100;0;285000;2036;140
48099;2023;19;17;2;89.4736842105263;10.5263157894737;145113.894736842;1824.10526315789;91.5263157894737
48103;2023;4;4;0;100;0;208200;1945.5;106
48104;2023;5;5;0;100;0;110684;1515.2;69.8
48105;2023;1;1;0;100;0;155000;2123;73
48106;2023;1;1;0;100;0;45000;1500;30
48107;2023;2;2;0;100;0;193500;1577;128
48108;2023;1;1;0;100;0;138000;939;147
48111;2023;3;2;1;66.6666666666667;33.3333333333333;71733.3333333333;1438;50.3333333333333
48112;2023;4;3;1;75;25;60125;1083.75;60.75
48116;2023;12;10;2;83.3333333333333;16.6666666666667;149129.5;1804.58333333333;81.6666666666667
48117;2023;1;1;0;100;0;1,00E+05;1538;65
48119;2023;5;5;0;100;0;73580;1071.6;74.8
48121;2023;2;2;0;100;0;123000;1510;95.5
48123;2023;3;3;0;100;0;230888.333333333;1707.33333333333;153.666666666667
48124;2023;1;1;0;100;0;70000;1077;65
48126;2023;4;4;0;100;0;138750;1066.75;130
48127;2023;17;17;0;100;0;124188.235294118;1736.70588235294;74.5882352941177
48128;2023;4;4;0;100;0;149181;1311.25;114.25
48129;2023;2;2;0;100;0;90439.5;1330.5;67.5
48130;2023;1;1;0;100;0;65000;542;120
48131;2023;3;2;1;66.6666666666667;33.3333333333333;101833.333333333;1160.66666666667;91.3333333333333
48132;2023;18;15;3;83.3333333333333;16.6666666666667;138203.611111111;1403.72222222222;100.833333333333
48135;2023;1;1;0;100;0;89000;1271;70
48136;2023;3;3;0;100;0;142966.666666667;1838.66666666667;86.6666666666667
48137;2023;4;4;0;100;0;235173.75;2478.5;106.75
48138;2023;2;2;0;100;0;270000;1241.5;215
48139;2023;4;4;0;100;0;82500;1141.75;73.75
48140;2023;36;31;5;86.1111111111111;13.8888888888889;118887.444444444;1437.19444444444;82.9722222222222
48141;2023;4;4;0;100;0;173950;1734;95.5
48144;2023;5;5;0;100;0;187241;2411.4;94
48146;2023;19;16;3;84.2105263157895;15.7894736842105;157852.631578947;1766.42105263158;82.6842105263158
48147;2023;5;5;0;100;0;179023.4;1820.6;99
48148;2023;9;9;0;100;0;181455.555555556;2034.44444444444;88.7777777777778
48150;2023;1;1;0;100;0;80000;1481;54
48152;2023;2;2;0;100;0;7,00E+05;5059;136.5
48153;2023;1;1;0;100;0;60000;667;90
48155;2023;9;8;1;88.8888888888889;11.1111111111111;181535.555555556;2642.88888888889;68.7777777777778
48156;2023;11;11;0;100;0;132575.090909091;1367.72727272727;96.4545454545455
48158;2023;1;1;0;100;0;122100;1607;76
48160;2023;2;2;0;100;0;147500;1382.5;105
48161;2023;1;1;0;100;0;134380;1581;85
48163;2023;1;1;0;100;0;186400;2118;88
48165;2023;1;1;0;100;0;150000;1000;150
48166;2023;2;2;0;100;0;83425;1144;72.5
48167;2023;2;2;0;100;0;86790;1674.5;50.5
48168;2023;1;1;0;100;0;110000;1146;96
48169;2023;1;1;0;100;0;105000;1750;60
48170;2023;3;3;0;100;0;95000;2231.66666666667;44.3333333333333
48171;2023;3;3;0;100;0;176666.666666667;2294;80.3333333333333
48173;2023;4;4;0;100;0;195603.75;2377;76.5
48174;2023;3;3;0;100;0;65591;877.333333333333;78
48175;2023;2;2;0;100;0;104000;1600;66
48176;2023;2;2;0;100;0;165635;1796.5;84
48178;2023;13;13;0;100;0;166489.230769231;1981.30769230769;86.7692307692308
48182;2023;2;2;0;100;0;58000;883;66
48185;2023;1;1;0;100;0;75000;1154;65
48187;2023;2;2;0;100;0;53612.5;926.5;58
48188;2023;3;2;1;66.6666666666667;33.3333333333333;51916.6666666667;767;69
48190;2023;1;1;0;100;0;167030;1965;85
48193;2023;5;5;0;100;0;137600;2029.8;69
48194;2023;5;5;0;100;0;129620;1616.2;84.2
48198;2023;12;10;2;83.3333333333333;16.6666666666667;121690.166666667;2167.83333333333;56.1666666666667
49002;2023;31;31;0;100;0;174289.483870968;1680.09677419355;103.387096774194
49003;2023;29;29;0;100;0;192623.448275862;2089;95.3103448275862
49007;2023;2000;517;1483;25.85;74.15;233881.5785;3412.7555;69.8495
49008;2023;12;12;0;100;0;137241.666666667;1464.75;92.9166666666667
49009;2023;4;4;0;100;0;72375;813.75;92.5
49010;2023;5;5;0;100;0;144000;1590.6;107.2
49011;2023;6;6;0;100;0;201833.333333333;1710.66666666667;118.166666666667
49012;2023;5;5;0;100;0;228860;2000;103
49015;2023;190;107;83;56.3157894736842;43.6842105263158;276413.636842105;3079.32105263158;90.6578947368421
49017;2023;7;7;0;100;0;183072.857142857;1466.71428571429;115.428571428571
49018;2023;149;147;2;98.6577181208054;1.34228187919463;149946.154362416;1519.18120805369;98.7986577181208
49020;2023;33;31;2;93.9393939393939;6.06060606060606;314460.606060606;2888.60606060606;115.484848484848
49021;2023;62;61;1;98.3870967741936;1.61290322580645;195747.806451613;2099.58064516129;95.0967741935484
49022;2023;11;11;0;100;0;219754.545454545;2148.09090909091;100.818181818182
49023;2023;235;217;18;92.3404255319149;7.65957446808511;173102.8;1925.37446808511;90.7489361702128
49026;2023;21;21;0;100;0;193820.666666667;1972.42857142857;102.857142857143
49027;2023;12;12;0;100;0;176225;1763.91666666667;101
49028;2023;2;2;0;100;0;238000;1924;113
49029;2023;12;12;0;100;0;233629.166666667;2482.66666666667;92.6666666666667
49030;2023;7;7;0;100;0;176216.142857143;1499.85714285714;124.714285714286
49035;2023;52;51;1;98.0769230769231;1.92307692307692;428535.019230769;3414.98076923077;122.673076923077
49036;2023;12;12;0;100;0;188107.5;1318.5;137.916666666667
49038;2023;1;1;0;100;0;175000;1683;104
49041;2023;19;19;0;100;0;167183.157894737;1742.73684210526;101.631578947368
49045;2023;5;5;0;100;0;102400;1561.6;68
49048;2023;42;36;6;85.7142857142857;14.2857142857143;256155.69047619;2726.47619047619;94.8095238095238
49050;2023;112;107;5;95.5357142857143;4.46428571428571;232222.767857143;2184.59821428571;107.553571428571
49053;2023;1;1;0;100;0;127000;1396;91
49054;2023;24;22;2;91.6666666666667;8.33333333333333;139559.708333333;1506.125;93
49055;2023;18;18;0;100;0;321127.777777778;2797.61111111111;115.111111111111
49056;2023;3;3;0;100;0;152666.666666667;1488;109
49057;2023;2;2;0;100;0;87500;875.5;97.5
49058;2023;7;7;0;100;0;160785.714285714;1942.28571428571;80.5714285714286
49060;2023;36;33;3;91.6666666666667;8.33333333333333;189001.722222222;1939.16666666667;96.8611111111111
49061;2023;11;11;0;100;0;112013.454545455;1694.54545454545;78
49063;2023;70;61;9;87.1428571428571;12.8571428571429;247069.6;2554.77142857143;100.3
49064;2023;9;9;0;100;0;219888.888888889;1919.55555555556;108
49067;2023;5;5;0;100;0;139480;1504.2;86.6
49068;2023;17;16;1;94.1176470588235;5.88235294117647;193672.647058824;1971.76470588235;103.705882352941
49069;2023;162;161;1;99.3827160493827;0.617283950617284;209051.339506173;2249.31481481481;95.1666666666667
49070;2023;8;8;0;100;0;159988.25;1527.75;106.25
49076;2023;11;11;0;100;0;169110;1959.27272727273;84.5454545454545
49080;2023;91;89;2;97.8021978021978;2.1978021978022;169527.043956044;1698.84615384615;102.703296703297
49082;2023;4;3;1;75;25;164250;2446.25;81.5
49086;2023;37;34;3;91.8918918918919;8.10810810810811;190114.216216216;1836.91891891892;101.486486486486
49089;2023;16;16;0;100;0;250991.1875;2172.0625;130.625
49090;2023;7;7;0;100;0;160035.714285714;1559.57142857143;100.571428571429
49092;2023;192;187;5;97.3958333333333;2.60416666666667;167575.59375;1740.4375;97.75
49099;2023;696;470;226;67.5287356321839;32.4712643678161;189004.533045977;2246.92385057471;84.8620689655172
49100;2023;2;2;0;100;0;121250;1766.5;69
49102;2023;2;2;0;100;0;155000;1405;115
49107;2023;10;10;0;100;0;274100;1982.7;141.9
49109;2023;11;10;1;90.9090909090909;9.09090909090909;139363.636363636;1521.63636363636;89.0909090909091
49110;2023;14;13;1;92.8571428571429;7.14285714285714;247228.571428571;2993.21428571429;91.9285714285714
49112;2023;16;16;0;100;0;171071.875;1624.625;105.1875
49113;2023;10;10;0;100;0;161954.5;1488.2;124.7
49114;2023;1;1;0;100;0;50000;714;70
49120;2023;18;17;1;94.4444444444444;5.55555555555556;184549.444444444;2161.33333333333;87.8333333333333
49121;2023;4;4;0;100;0;125587.5;1637.5;76.5
49123;2023;19;19;0;100;0;207286;2073.26315789474;101.947368421053
49125;2023;103;100;3;97.0873786407767;2.9126213592233;168151.621359223;1712.42718446602;99.0679611650485
49127;2023;40;40;0;100;0;153828.75;1587.675;93.875
49129;2023;48;48;0;100;0;256034.979166667;2646;95.8333333333333
49130;2023;6;6;0;100;0;235653.333333333;1979.33333333333;117.833333333333
49131;2023;5;5;0;100;0;174500;1492;120.4
49132;2023;21;21;0;100;0;206834.047619048;1866.71428571429;116.380952380952
49135;2023;19;17;2;89.4736842105263;10.5263157894737;243029.263157895;2331.52631578947;104.421052631579
49138;2023;32;32;0;100;0;182771.875;1685.375;106.96875
49140;2023;17;17;0;100;0;123523.823529412;1430.70588235294;89.1176470588235
49155;2023;12;12;0;100;0;272158.333333333;2569.91666666667;107.416666666667
49160;2023;22;22;0;100;0;217840.909090909;2252.36363636364;104.181818181818
49161;2023;9;9;0;100;0;215444.444444444;1922.44444444444;113.222222222222
49163;2023;27;27;0;100;0;172474.185185185;2080.59259259259;83.9259259259259
49167;2023;25;25;0;100;0;303824;2600.28;121.76
49170;2023;12;12;0;100;0;175103.333333333;1873.75;90.75
49171;2023;1;1;0;100;0;145000;1812;80
49174;2023;15;15;0;100;0;158000.666666667;1555.66666666667;103.666666666667
49176;2023;54;53;1;98.1481481481482;1.85185185185185;217551.148148148;2411.75925925926;93.037037037037
49178;2023;12;12;0;100;0;135337.5;1410.16666666667;102.166666666667
49180;2023;58;58;0;100;0;155267.586206897;1701.43103448276;95.6034482758621
49182;2023;5;5;0;100;0;212500;1791.2;113
49183;2023;59;59;0;100;0;181386.440677966;1896.15254237288;95.4406779661017
49188;2023;3;3;0;100;0;274500;2453.33333333333;108.666666666667
49192;2023;25;25;0;100;0;186026;1880.84;97.84
49193;2023;44;43;1;97.7272727272727;2.27272727272727;175147.727272727;1735.25;105.75
49194;2023;63;61;2;96.8253968253968;3.17460317460317;221354.285714286;2190.1746031746;105.825396825397
49195;2023;13;13;0;100;0;253940.615384615;2247.76923076923;113.769230769231
49200;2023;64;64;0;100;0;279075.65625;2460.546875;112.953125
49201;2023;18;18;0;100;0;193527.777777778;2009;102.333333333333
49205;2023;11;11;0;100;0;135181.818181818;1430.63636363636;94.5454545454545
49209;2023;2;2;0;100;0;207500;1308;154.5
49211;2023;5;5;0;100;0;181600;1462.4;129.8
49214;2023;65;51;14;78.4615384615385;21.5384615384615;286994.353846154;2957.46153846154;95.9846153846154
49215;2023;45;43;2;95.5555555555556;4.44444444444444;142138;1385.97777777778;101.422222222222
49216;2023;6;6;0;100;0;258083.333333333;1938.33333333333;125.5
49217;2023;8;8;0;100;0;219336;1908;114.875
49218;2023;185;183;2;98.9189189189189;1.08108108108108;159193.151351351;1664.10810810811;97.0378378378378
49219;2023;5;5;0;100;0;104763.8;1382.6;77
49220;2023;51;51;0;100;0;164106.764705882;1682.58823529412;101.176470588235
49221;2023;10;10;0;100;0;157138.9;1315.5;113.6
49222;2023;19;19;0;100;0;284086.105263158;2688.42105263158;106.210526315789
49223;2023;70;63;7;90;10;273349.957142857;2642.34285714286;104.357142857143
49224;2023;15;15;0;100;0;179181.6;1898.6;94.5333333333333
49228;2023;94;94;0;100;0;114140.765957447;1178.97872340426;95.4574468085106
49231;2023;12;12;0;100;0;205393.833333333;2092.33333333333;99.4166666666667
49235;2023;6;6;0;100;0;161533.333333333;1695.66666666667;94.8333333333333
49236;2023;3;3;0;100;0;105600;1062;92.3333333333333
49237;2023;2;2;0;100;0;95500;643.5;169
49240;2023;11;11;0;100;0;129949.090909091;1560.27272727273;87.3636363636364
49241;2023;25;24;1;96;4;309063.24;2911.84;110.84
49244;2023;171;168;3;98.2456140350877;1.75438596491228;183295.257309942;1877.3918128655;100.473684210526
49246;2023;111;83;28;74.7747747747748;25.2252252252252;257155.603603604;2817.22522522523;91.3063063063063
49247;2023;24;24;0;100;0;265266.666666667;2663.625;100.5
49248;2023;106;105;1;99.0566037735849;0.943396226415094;116320.443396226;1272.98113207547;91.2358490566038
49253;2023;9;9;0;100;0;143546.222222222;1503.77777777778;90.8888888888889
49257;2023;9;9;0;100;0;131455.555555556;1569.66666666667;84.2222222222222
49259;2023;29;28;1;96.551724137931;3.44827586206897;238017.068965517;2213.37931034483;110.068965517241
49260;2023;18;18;0;100;0;165361.111111111;1839.44444444444;89
49261;2023;96;95;1;98.9583333333333;1.04166666666667;186394.583333333;2015.51041666667;97.2395833333333
49262;2023;9;9;0;100;0;244000;2008;113
49266;2023;10;10;0;100;0;241250;2296.6;103.5
49267;2023;75;51;24;68;32;278409.04;2859.6;97.6666666666667
49269;2023;21;21;0;100;0;230068.571428571;2196.71428571429;102.095238095238
49271;2023;20;20;0;100;0;230145;2388.65;96.8
49272;2023;13;12;1;92.3076923076923;7.69230769230769;181723.076923077;2014.30769230769;90.9230769230769
49278;2023;42;30;12;71.4285714285714;28.5714285714286;309465.880952381;3054.14285714286;100.166666666667
49283;2023;38;38;0;100;0;236471.657894737;2729.28947368421;97.1315789473684
49284;2023;11;11;0;100;0;230790.909090909;2051.72727272727;113.909090909091
49288;2023;4;4;0;100;0;242750;1772.5;136.5
49291;2023;5;5;0;100;0;91800;935;100.2
49292;2023;41;41;0;100;0;214129.268292683;1989.68292682927;108.585365853659
49294;2023;26;26;0;100;0;278904.115384615;2331.69230769231;117.346153846154
49298;2023;20;20;0;100;0;257897.5;2487.9;103.45
49299;2023;25;25;0;100;0;251137.8;2400.92;107.8
49301;2023;241;241;0;100;0;182401.780082988;1968.34854771784;93.7551867219917
49302;2023;9;9;0;100;0;142143.333333333;1421.33333333333;108.777777777778
49306;2023;27;27;0;100;0;240303.333333333;2492.62962962963;95.4814814814815
49307;2023;151;148;3;98.0132450331126;1.98675496688742;261394.635761589;2413.74834437086;111.337748344371
49308;2023;18;18;0;100;0;324829.722222222;2625.88888888889;124.555555555556
49310;2023;5;5;0;100;0;102000;1193.2;83.2
49311;2023;9;9;0;100;0;174444.333333333;1651;111.222222222222
49321;2023;6;6;0;100;0;148801.166666667;1889.83333333333;77.8333333333333
49323;2023;79;70;9;88.6075949367088;11.3924050632911;286975.53164557;2783.79746835443;104.151898734177
49326;2023;12;12;0;100;0;246150.416666667;2752.25;97.0833333333333
49328;2023;443;239;204;53.9503386004515;46.0496613995485;159484.534988713;1877.96162528217;85.0677200902934
49329;2023;16;14;2;87.5;12.5;207063.875;2539.375;86.75
49330;2023;8;8;0;100;0;209475;2021.625;107.75
49331;2023;212;185;27;87.2641509433962;12.7358490566038;138050.504716981;1518.36320754717;93.877358490566
49332;2023;36;34;2;94.4444444444444;5.55555555555556;205730.833333333;2111.61111111111;99.0277777777778
49333;2023;26;24;2;92.3076923076923;7.69230769230769;179661.807692308;1868.65384615385;105.307692307692
49334;2023;3;3;0;100;0;193666.666666667;1928.66666666667;100.333333333333
49336;2023;6;6;0;100;0;142162.833333333;1161;125.5
49338;2023;14;14;0;100;0;348250;2722.35714285714;126.214285714286
49339;2023;12;12;0;100;0;230066.666666667;2341.25;97.0833333333333
49341;2023;10;10;0;100;0;135953;1235.6;106.9
49343;2023;33;32;1;96.969696969697;3.03030303030303;234362.424242424;2213.48484848485;102.242424242424
49344;2023;15;15;0;100;0;195433.333333333;2063.33333333333;95.6666666666667
49345;2023;46;46;0;100;0;174271.304347826;1863.39130434783;97.8913043478261
49347;2023;45;41;4;91.1111111111111;8.88888888888889;219768.355555556;2417.08888888889;95.3333333333333
49352;2023;5;5;0;100;0;230800;1685.4;135.2
49353;2023;195;159;36;81.5384615384615;18.4615384615385;217659.38974359;2566.24102564103;85.1538461538462
49355;2023;33;33;0;100;0;202821.515151515;1993.0303030303;100.545454545455
49358;2023;8;8;0;100;0;199000;2007.5;98.625
49359;2023;10;10;0;100;0;183049;1821.3;104.2
49361;2023;14;14;0;100;0;180974.928571429;1780.42857142857;105.428571428571
49362;2023;10;10;0;100;0;217150;1876.3;114.3
49364;2023;10;10;0;100;0;96700;1442.2;84.6
49367;2023;43;43;0;100;0;186372.162790698;1811.46511627907;105.418604651163
49368;2023;26;26;0;100;0;157923.653846154;1548.92307692308;105.5
49369;2023;14;14;0;100;0;148046.785714286;1535.14285714286;96.3571428571429
49370;2023;6;6;0;100;0;218166.666666667;1666.66666666667;134
49371;2023;17;17;0;100;0;170673.529411765;1631;103.941176470588
49373;2023;95;94;1;98.9473684210526;1.05263157894737;149611.526315789;1388.12631578947;107.842105263158
49374;2023;18;18;0;100;0;156671.944444444;1697.22222222222;90.0555555555556
49377;2023;44;43;1;97.7272727272727;2.27272727272727;234670.409090909;2323.25;102.159090909091
49378;2023;27;27;0;100;0;168639.111111111;1786.07407407407;92.7777777777778
49381;2023;19;19;0;100;0;185436.157894737;1774.52631578947;106.052631578947
50002;2023;61;47;14;77.0491803278689;22.9508196721311;170125.672131148;1886.67213114754;89.3934426229508
50003;2023;93;83;10;89.247311827957;10.752688172043;401303.946236559;4457.96774193548;98.4516129032258
50004;2023;8;8;0;100;0;171171.875;1468.625;117.875
50006;2023;3;3;0;100;0;102766.666666667;1067;100.666666666667
50008;2023;1;1;0;100;0;305000;3245;94
50013;2023;1;1;0;100;0;206100;1982;104
50015;2023;7;7;0;100;0;227524.285714286;2156.42857142857;105.714285714286
50016;2023;2;2;0;100;0;142500;1563.5;84
50019;2023;6;6;0;100;0;166449.333333333;2183.16666666667;86.3333333333333
50021;2023;1;1;0;100;0;2,00E+05;1389;144
50022;2023;1;1;0;100;0;240000;2034;118
50023;2023;8;8;0;100;0;162137.5;1504.375;104.625
50024;2023;3;3;0;100;0;212600;1529;133
50025;2023;115;74;41;64.3478260869565;35.6521739130435;199580.095652174;2173.60869565217;90.8869565217391
50026;2023;1;1;0;100;0;250000;2174;115
50027;2023;10;10;0;100;0;226843;1885.2;115.1
50028;2023;2;2;0;100;0;212285;1954.5;106
50029;2023;15;15;0;100;0;85380;980.066666666667;87
50030;2023;14;9;5;64.2857142857143;35.7142857142857;172167.857142857;2752.21428571429;62.2857142857143
50031;2023;71;55;16;77.4647887323944;22.5352112676056;277637.788732394;3596.76056338028;77.6056338028169
50032;2023;11;11;0;100;0;204164.818181818;1762.90909090909;113.363636363636
50033;2023;3;3;0;100;0;201000;2273;102.333333333333
50034;2023;6;6;0;100;0;199805.5;1561;132.666666666667
50036;2023;3;3;0;100;0;58333.3333333333;629;94.6666666666667
50038;2023;7;7;0;100;0;145057.142857143;1569.71428571429;87.5714285714286
50039;2023;2;2;0;100;0;150000;1366.5;105.5
50040;2023;3;3;0;100;0;182333.333333333;1502.33333333333;126
50041;2023;90;87;3;96.6666666666667;3.33333333333333;257750.244444444;2538.81111111111;104.711111111111
50042;2023;2;2;0;100;0;419500;2577.5;163.5
50044;2023;2;2;0;100;0;221000;1854.5;122.5
50045;2023;9;9;0;100;0;188555.555555556;1654.11111111111;110.666666666667
50046;2023;6;6;0;100;0;202878.333333333;1689.66666666667;126.333333333333
50048;2023;10;10;0;100;0;104010.6;997.4;109.9
50049;2023;6;6;0;100;0;167214.666666667;1667.66666666667;110.833333333333
50050;2023;3;3;0;100;0;90000;1502.33333333333;64.3333333333333
50052;2023;5;5;0;100;0;90110;1594.6;56.2
50054;2023;1;1;0;100;0;179000;1133;158
50058;2023;21;21;0;100;0;294253.142857143;3035.47619047619;100.095238095238
50059;2023;2;2;0;100;0;130000;1968;66.5
50062;2023;4;4;0;100;0;97300;1207.5;82.75
50064;2023;5;5;0;100;0;148030;1514.8;115.8
50066;2023;57;47;10;82.4561403508772;17.5438596491228;384202.368421053;4276.31578947368;97.7719298245614
50069;2023;5;5;0;100;0;160650.8;1912.8;90
50070;2023;2;2;0;100;0;560180;3030;178.5
50072;2023;1;1;0;100;0;165000;2619;63
50074;2023;18;18;0;100;0;128233.611111111;1439.61111111111;89.5
50076;2023;58;49;9;84.4827586206897;15.5172413793103;257998.603448276;2950.98275862069;95.1034482758621
50077;2023;21;21;0;100;0;292002.952380952;2803.57142857143;107.095238095238
50078;2023;7;7;0;100;0;257185.714285714;2514.57142857143;103.571428571429
50079;2023;4;4;0;100;0;285750;1994.5;138.75
50081;2023;9;9;0;100;0;405144.444444444;3528.22222222222;115.111111111111
50082;2023;68;67;1;98.5294117647059;1.47058823529412;179712.779411765;1867.86764705882;97.4852941176471
50083;2023;6;6;0;100;0;197590.5;2287.66666666667;88
50084;2023;3;3;0;100;0;257833.333333333;2123;122.333333333333
50085;2023;15;15;0;100;0;245574.133333333;2426.53333333333;97.9333333333333
50086;2023;4;4;0;100;0;182000;2191.5;85
50087;2023;20;20;0;100;0;192363.5;2009;101.2
50088;2023;5;5;0;100;0;117020;1414.6;90
50090;2023;14;14;0;100;0;73321.4285714286;912.857142857143;80.2857142857143
50092;2023;4;4;0;100;0;117500;1499;85
50093;2023;6;6;0;100;0;113666.666666667;1179.16666666667;93.6666666666667
50094;2023;8;8;0;100;0;162812.5;1632.875;99.125
50095;2023;21;21;0;100;0;163088.571428571;1622.66666666667;103.238095238095
50096;2023;3;3;0;100;0;128000;1557.66666666667;78.3333333333333
50098;2023;5;5;0;100;0;124220;1323;95.6
50099;2023;103;85;18;82.5242718446602;17.4757281553398;171896.844660194;1819.67961165049;98.3495145631068
50101;2023;6;6;0;100;0;142266.666666667;1687.5;92
50102;2023;19;17;2;89.4736842105263;10.5263157894737;344175.421052632;3354.10526315789;109.210526315789
50105;2023;4;4;0;100;0;162500;1615;113
50106;2023;1;1;0;100;0;175000;2333;75
50108;2023;3;3;0;100;0;318063;4341.33333333333;73
50109;2023;28;28;0;100;0;155464.285714286;1769.75;92.4642857142857
50110;2023;12;12;0;100;0;163115;1492.58333333333;100.666666666667
50111;2023;11;11;0;100;0;118945.454545455;1291.81818181818;100.272727272727
50112;2023;5;5;0;100;0;127380;1663.4;79.2
50115;2023;4;4;0;100;0;220000;2846.25;89.5
50117;2023;10;10;0;100;0;189840;2660;74.3
50118;2023;2;2;0;100;0;179250;1834.5;91.5
50120;2023;8;8;0;100;0;175875;2441.375;77.25
50121;2023;3;3;0;100;0;92666.6666666667;1893;50.6666666666667
50124;2023;1;1;0;100;0;102500;1314;78
50126;2023;1;1;0;100;0;105000;1167;90
50129;2023;891;588;303;65.993265993266;34.006734006734;187357.55667789;2381.6632996633;81.2334455667789
50130;2023;9;9;0;100;0;188322.222222222;1505.44444444444;127.666666666667
50135;2023;4;4;0;100;0;190917.5;1976;97.25
50137;2023;7;7;0;100;0;140500;1408.14285714286;101
50138;2023;8;8;0;100;0;164562.5;1502.375;123.5
50139;2023;40;39;1;97.5;2.5;153533.75;1551.075;102.175
50142;2023;20;20;0;100;0;167265.8;2195.65;83.7
50143;2023;8;8;0;100;0;210875;3636.25;88.5
50144;2023;13;13;0;100;0;113932.692307692;1637.84615384615;71.6153846153846
50145;2023;9;9;0;100;0;190161.111111111;2124.44444444444;93
50146;2023;7;7;0;100;0;158025.714285714;1974.57142857143;81
50147;2023;117;70;47;59.8290598290598;40.1709401709402;169148.547008547;1930.28205128205;87.5982905982906
50148;2023;10;10;0;100;0;150350;1393.4;113.3
50149;2023;14;14;0;100;0;228232.142857143;1965.5;119.142857142857
50150;2023;2;2;0;100;0;1,00E+05;1133.5;80
50151;2023;22;21;1;95.4545454545455;4.54545454545455;138876.681818182;1668.31818181818;86.1818181818182
50152;2023;4;4;0;100;0;58750;945;68.25
50155;2023;3;3;0;100;0;116933.333333333;1459.33333333333;83.6666666666667
50156;2023;1;1;0;100;0;157902;2770;57
50158;2023;2;2;0;100;0;90250;1309.5;70
50159;2023;10;10;0;100;0;125350;1144.9;108
50161;2023;3;3;0;100;0;151833.333333333;1201;127.666666666667
50162;2023;16;16;0;100;0;260057.6875;2331.375;115.9375
50164;2023;15;15;0;100;0;194204;1507;120.866666666667
50165;2023;67;41;26;61.1940298507463;38.8059701492537;259913.731343284;3373.26865671642;80
50166;2023;2;2;0;100;0;217500;1387.5;154.5
50167;2023;11;11;0;100;0;191409.090909091;2216.72727272727;87.4545454545455
50168;2023;23;23;0;100;0;217143.47826087;1872.04347826087;104
50172;2023;4;4;0;100;0;169000;1765.5;103.25
50174;2023;1;1;0;100;0;165000;2845;58
50175;2023;2;2;0;100;0;205000;1502.5;136.5
50176;2023;4;4;0;100;0;111250;1990;49.75
50177;2023;2;2;0;100;0;149475;1897.5;79.5
50178;2023;19;19;0;100;0;222486.842105263;2766.05263157895;82.0526315789474
50181;2023;3;3;0;100;0;132944.333333333;1308;117.666666666667
50182;2023;6;6;0;100;0;94183.3333333333;1409.66666666667;65.5
50183;2023;8;8;0;100;0;185656.25;2294.5;85.875
50184;2023;13;13;0;100;0;201379.230769231;2404.23076923077;82.6923076923077
50185;2023;14;14;0;100;0;204789.285714286;2377.5;94.5
50186;2023;1;1;0;100;0;125000;2016;62
50188;2023;13;13;0;100;0;158500;1853.84615384615;87.6153846153846
50190;2023;3;3;0;100;0;147500;1778;91.3333333333333
50192;2023;1;1;0;100;0;223500;1195;187
50193;2023;6;6;0;100;0;149916.666666667;1722.16666666667;85.3333333333333
50194;2023;2;2;0;100;0;122500;1566.5;59
50195;2023;4;4;0;100;0;96250;1665.75;60.5
50196;2023;13;13;0;100;0;281038.461538462;2580.61538461538;100
50197;2023;25;25;0;100;0;135106;1538.44;91.2
50198;2023;2;2;0;100;0;201500;1846.5;111
50199;2023;14;14;0;100;0;282624.285714286;2659.57142857143;97.5714285714286
50200;2023;13;13;0;100;0;81703.6153846154;1054.84615384615;87.0769230769231
50205;2023;5;5;0;100;0;169400;1665.6;100.2
50207;2023;2;2;0;100;0;270000;3365;79
50208;2023;5;5;0;100;0;123400;1131.6;108.6
50209;2023;18;18;0;100;0;171125;1636.66666666667;102.5
50210;2023;6;6;0;100;0;149000;1634.33333333333;93.6666666666667
50214;2023;9;9;0;100;0;121111.111111111;1223.77777777778;97.7777777777778
50215;2023;36;35;1;97.2222222222222;2.77777777777778;237421.138888889;2543.63888888889;95.3333333333333
50216;2023;20;20;0;100;0;130548.45;1273.5;101.25
50217;2023;6;6;0;100;0;137333.333333333;1475.33333333333;86.8333333333333
50218;2023;272;98;174;36.0294117647059;63.9705882352941;261034.867647059;3703.45220588235;71.7683823529412
50219;2023;8;8;0;100;0;198250;1879.75;109.375
50221;2023;2;2;0;100;0;118650;1334.5;85.5
50222;2023;7;7;0;100;0;212977.142857143;1767.71428571429;117.428571428571
50227;2023;3;3;0;100;0;149383.333333333;1613.33333333333;91
50228;2023;16;16;0;100;0;138975;2021;80.8125
50229;2023;1;1;0;100;0;134450;2689;50
50230;2023;1;1;0;100;0;227130;2950;77
50231;2023;23;20;3;86.9565217391304;13.0434782608696;249634.565217391;4122.82608695652;66.7391304347826
50232;2023;6;6;0;100;0;120916.666666667;1378.33333333333;88.1666666666667
50235;2023;2;2;0;100;0;198500;3564.5;73
50236;2023;74;70;4;94.5945945945946;5.40540540540541;169080.405405405;1826.91891891892;94.3513513513514
50237;2023;23;21;2;91.304347826087;8.69565217391304;159826.52173913;1838.52173913043;87.8260869565217
50238;2023;4;4;0;100;0;168111.5;2156.25;74.25
50239;2023;15;15;0;100;0;181469.8;1796.33333333333;107.333333333333
50240;2023;3;3;0;100;0;228140;2703.33333333333;84
50241;2023;2;2;0;100;0;359150;3017;119
50243;2023;8;8;0;100;0;245312.5;2171.625;114.875
50247;2023;2;2;0;100;0;352500;2625.5;134
50251;2023;2;2;0;100;0;180000;1634.5;110.5
50252;2023;17;17;0;100;0;219491.117647059;2315.05882352941;95.7647058823529
50253;2023;1;1;0;100;0;230000;2212;104
50256;2023;38;38;0;100;0;150241.552631579;1613.31578947368;95.6842105263158
50259;2023;8;8;0;100;0;142187.5;1524.25;93.25
50260;2023;31;31;0;100;0;91591.3548387097;1331.12903225806;79.3870967741936
50261;2023;1;1;0;100;0;80000;1333;60
50262;2023;6;6;0;100;0;183333.333333333;2251.16666666667;89.5
50263;2023;9;9;0;100;0;82944.4444444444;1316.44444444444;62.1111111111111
50265;2023;3;3;0;100;0;50000;1277;41.3333333333333
50266;2023;11;11;0;100;0;132295.454545455;1297.90909090909;105.454545454545
50267;2023;32;31;1;96.875;3.125;169795.3125;2086.375;83.5
50268;2023;3;3;0;100;0;124333.333333333;1446.33333333333;83.3333333333333
50269;2023;2;2;0;100;0;161700;1514.5;106
50270;2023;3;3;0;100;0;198333.333333333;2384;78
50271;2023;2;2;0;100;0;213800.5;1773;119
50272;2023;13;13;0;100;0;248412.846153846;2223.76923076923;109.615384615385
50273;2023;26;26;0;100;0;140492.884615385;1494.76923076923;96.8461538461538
50274;2023;16;16;0;100;0;125697.5625;1845.875;70.1875
50275;2023;1;1;0;100;0;28000;1037;27
50276;2023;2;2;0;100;0;163650;2702;65
50277;2023;15;15;0;100;0;241366.666666667;2583.66666666667;101.466666666667
50278;2023;7;7;0;100;0;133785.714285714;1603.57142857143;87.5714285714286
50279;2023;6;6;0;100;0;145021.666666667;1679.33333333333;86.1666666666667
50281;2023;10;10;0;100;0;131987.7;1454.5;85.5
50282;2023;1;1;0;100;0;157000;2039;77
50285;2023;6;6;0;100;0;170700;2278.16666666667;74.1666666666667
50288;2023;16;16;0;100;0;199956.5625;2099.6875;99.25
50289;2023;6;6;0;100;0;194325;1643.83333333333;117.333333333333
50290;2023;5;5;0;100;0;152700;1671;94.2
50291;2023;5;5;0;100;0;113860;1142;95.4
50292;2023;32;32;0;100;0;166088.4375;1631.875;101.71875
50294;2023;13;13;0;100;0;249153.846153846;2329.23076923077;107.538461538462
50297;2023;14;14;0;100;0;147754.357142857;1266;124.714285714286
50298;2023;4;4;0;100;0;181250;1722;105.75
50299;2023;3;3;0;100;0;152883.333333333;1842.33333333333;79
50300;2023;4;4;0;100;0;133850;2835;55.5
50302;2023;2;2;0;100;0;75000;692.5;105.5
50304;2023;1;1;0;100;0;130000;1566;83
50305;2023;4;4;0;100;0;265825;2614.5;102.25
50310;2023;3;3;0;100;0;214295.666666667;2022;94.3333333333333
50311;2023;1;1;0;100;0;228460;1873;122
50312;2023;5;5;0;100;0;83800;895;97.6
50315;2023;2;2;0;100;0;128215;1275.5;105
50317;2023;3;3;0;100;0;225000;3189.33333333333;63
50321;2023;1;1;0;100;0;302300;1708;177
50324;2023;2;2;0;100;0;119410;1051;103
50326;2023;5;5;0;100;0;172400;2118.6;100.8
50327;2023;1;1;0;100;0;270000;1849;146
50328;2023;11;11;0;100;0;144045.454545455;1688.18181818182;82.7272727272727
50332;2023;8;8;0;100;0;216168.75;2067.625;102.5
50334;2023;3;3;0;100;0;144533.333333333;1451;95.6666666666667
50335;2023;7;7;0;100;0;243928.571428571;1911.42857142857;120.428571428571
50336;2023;1;1;0;100;0;148460;1470;101
50338;2023;10;10;0;100;0;124800;1255.4;101.3
50340;2023;3;3;0;100;0;114666.666666667;1735;67.6666666666667
50341;2023;30;30;0;100;0;168086.666666667;1812.66666666667;97.1333333333333
50342;2023;14;14;0;100;0;319739.714285714;2937;112.928571428571
50345;2023;5;5;0;100;0;269600;2164.6;133.8
50347;2023;6;6;0;100;0;198211.666666667;1431.33333333333;141
50349;2023;16;16;0;100;0;224837.5;3097.75;89.625
50350;2023;7;7;0;100;0;236164.285714286;1659.14285714286;129.428571428571
50352;2023;4;4;0;100;0;135125;1838;80.5
50356;2023;11;11;0;100;0;150427.272727273;1561.90909090909;93
50357;2023;2;2;0;100;0;119500;1738.5;83
50359;2023;46;43;3;93.4782608695652;6.52173913043478;117580.260869565;1247.36956521739;95.6739130434783
50361;2023;2;2;0;100;0;151500;1106.5;129
50362;2023;4;4;0;100;0;88143.75;1100.5;102.75
50363;2023;16;16;0;100;0;166310.625;1542.5625;107.125
50364;2023;11;11;0;100;0;187787.272727273;2119.45454545455;104.636363636364
50365;2023;3;3;0;100;0;283100;1741;149.333333333333
50369;2023;9;9;0;100;0;197011.111111111;2408.44444444444;88
50370;2023;11;11;0;100;0;153500;1950.45454545455;91.0909090909091
50371;2023;9;9;0;100;0;115866.666666667;1167.66666666667;92.4444444444444
50373;2023;2;2;0;100;0;171297.5;2103;68
50374;2023;1;1;0;100;0;77800;972;80
50376;2023;1;1;0;100;0;315000;2917;108
50378;2023;9;9;0;100;0;137771.111111111;1383.77777777778;101.444444444444
50382;2023;8;8;0;100;0;291425.75;2337.25;124
50384;2023;4;4;0;100;0;133262.5;1435;95.5
50387;2023;1;1;0;100;0;183000;1968;93
50388;2023;8;8;0;100;0;204943.75;2036.75;104.875
50389;2023;3;3;0;100;0;82333.3333333333;1490.66666666667;48
50390;2023;3;3;0;100;0;174000;1689.33333333333;99.6666666666667
50391;2023;35;33;2;94.2857142857143;5.71428571428571;118832.657142857;1453.02857142857;90.1714285714286
50393;2023;27;26;1;96.2962962962963;3.7037037037037;140267.962962963;1428.51851851852;98.3703703703704
50394;2023;39;35;4;89.7435897435898;10.2564102564103;140018.051282051;1435.46153846154;95.025641025641
50395;2023;3;3;0;100;0;171666.666666667;1414.33333333333;122.333333333333
50397;2023;4;4;0;100;0;133750;1702;80.5
50398;2023;3;3;0;100;0;85000;960.666666666667;91.3333333333333
50399;2023;1;1;0;100;0;60000;1622;37
50400;2023;37;37;0;100;0;135265.135135135;1514.02702702703;90.2972972972973
50401;2023;13;13;0;100;0;200268.461538462;2249.69230769231;89.9230769230769
50402;2023;38;38;0;100;0;226511.710526316;2356.57894736842;100.078947368421
50403;2023;26;25;1;96.1538461538462;3.84615384615385;181061.538461538;2802.73076923077;75.7692307692308
50405;2023;3;3;0;100;0;151333.333333333;1746;78.3333333333333
50407;2023;10;10;0;100;0;187760;1818.6;99.7
50408;2023;8;8;0;100;0;167687.5;1899.125;88.5
50409;2023;30;27;3;90;10;139733.333333333;1443.63333333333;97.5
50410;2023;51;44;7;86.2745098039216;13.7254901960784;133828.333333333;1902.35294117647;80
50411;2023;11;11;0;100;0;203103.636363636;1932.63636363636;107.181818181818
50412;2023;61;61;0;100;0;206648.393442623;2614.80327868852;83.2622950819672
50413;2023;6;6;0;100;0;113333.333333333;1036;113.833333333333
50417;2023;17;15;2;88.2352941176471;11.7647058823529;176018.823529412;2207.35294117647;90.5294117647059
50419;2023;29;29;0;100;0;180812.24137931;2013.86206896552;97.2413793103448
50420;2023;11;11;0;100;0;152705.454545455;1440.90909090909;107.090909090909
50421;2023;7;7;0;100;0;246828.571428571;2629.42857142857;89.5714285714286
50422;2023;4;4;0;100;0;98168.75;1275.5;84.75
50423;2023;2;2;0;100;0;257500;1560;166
50425;2023;11;11;0;100;0;207541.363636364;2078.72727272727;105.727272727273
50426;2023;6;6;0;100;0;128853.333333333;1606.16666666667;92.5
50428;2023;3;3;0;100;0;108666.666666667;1296.33333333333;83.3333333333333
50429;2023;10;10;0;100;0;290740;2805.8;103.3
50431;2023;18;18;0;100;0;130252.777777778;1208.11111111111;110.666666666667
50433;2023;14;13;1;92.8571428571429;7.14285714285714;330577.071428571;2857.42857142857;108.214285714286
50435;2023;3;3;0;100;0;153166.666666667;1478.66666666667;101.333333333333
50436;2023;15;15;0;100;0;114452.333333333;1225.4;96.4
50437;2023;6;6;0;100;0;130150;1259.16666666667;112.833333333333
50442;2023;3;3;0;100;0;208654;2258;108.666666666667
50443;2023;2;2;0;100;0;92500;1649;60.5
50444;2023;22;22;0;100;0;173463.636363636;1600.72727272727;114.5
50445;2023;2;2;0;100;0;189000;1440;136.5
50446;2023;7;7;0;100;0;164164.285714286;1334.28571428571;134.428571428571
50447;2023;2;2;0;100;0;339775;2299;155
50448;2023;7;7;0;100;0;113257.142857143;1085.85714285714;90
50450;2023;8;8;0;100;0;153081.25;1752.5;102.75
50452;2023;10;10;0;100;0;129540;1603.4;83.2
50453;2023;11;11;0;100;0;178962.727272727;1887.09090909091;101.636363636364
50454;2023;2;2;0;100;0;248000;2026.5;124.5
50455;2023;8;8;0;100;0;155508.125;1570.625;102.375
50456;2023;9;9;0;100;0;106892.777777778;1529.88888888889;70.2222222222222
50457;2023;2;2;0;100;0;176000;2093;95.5
50462;2023;4;4;0;100;0;77125;1033.75;75.25
50463;2023;11;11;0;100;0;125125.454545455;1309.45454545455;97.3636363636364
50464;2023;7;7;0;100;0;179257.142857143;1512.42857142857;119.857142857143
50467;2023;5;5;0;100;0;198190;1880.4;109.6
50468;2023;12;12;0;100;0;118525;1266.25;95.75
50469;2023;2;2;0;100;0;72500;1174;63
50471;2023;5;5;0;100;0;107400;2041.8;61.4
50472;2023;6;6;0;100;0;84333.3333333333;1141.33333333333;84
50473;2023;3;3;0;100;0;181000;1635.33333333333;99.3333333333333
50474;2023;3;3;0;100;0;101466.666666667;1367.66666666667;71.6666666666667
50475;2023;17;16;1;94.1176470588235;5.88235294117647;164503.823529412;1704.47058823529;100.882352941176
50476;2023;3;3;0;100;0;78000;919.333333333333;85.6666666666667
50478;2023;4;4;0;100;0;171000;1519.25;109.5
50479;2023;3;3;0;100;0;210283.333333333;3206;64.3333333333333
50480;2023;11;11;0;100;0;243792.363636364;2226;102.545454545455
50481;2023;26;26;0;100;0;208447.884615385;2840.69230769231;77.9615384615385
50482;2023;2;2;0;100;0;90000;942;89.5
50483;2023;10;10;0;100;0;281645;2260.4;125.5
50484;2023;80;69;11;86.25;13.75;118799.125;1447.15;85.9125
50486;2023;3;3;0;100;0;105666.666666667;1433.66666666667;73.6666666666667
50487;2023;59;56;3;94.9152542372881;5.08474576271187;127378.050847458;1483.8813559322;88.9491525423729
50488;2023;9;9;0;100;0;155650.888888889;1458;109.222222222222
50489;2023;8;8;0;100;0;157375;1728.125;96.375
50490;2023;12;10;2;83.3333333333333;16.6666666666667;279308.333333333;3522.41666666667;91.75
50491;2023;3;3;0;100;0;136666.666666667;1905;74.3333333333333
50492;2023;19;19;0;100;0;158839.473684211;1432.73684210526;104.473684210526
50493;2023;14;14;0;100;0;199395.714285714;1971.64285714286;102.714285714286
50496;2023;16;16;0;100;0;260923.6875;2780.3125;94.5625
50498;2023;12;12;0;100;0;206925;1997.08333333333;102.916666666667
50499;2023;10;10;0;100;0;114700;1549.7;74.7
50500;2023;9;9;0;100;0;123615.555555556;1538.66666666667;88.3333333333333
50502;2023;266;129;137;48.4962406015038;51.5037593984962;126903.507518797;1672.42105263158;75.9548872180451
50504;2023;4;4;0;100;0;121505;2551;71.75
50505;2023;4;4;0;100;0;218900;1891;114.75
50506;2023;5;5;0;100;0;167000;2174;77.4
50507;2023;9;9;0;100;0;241944.444444444;2341.33333333333;104.777777777778
50509;2023;14;14;0;100;0;180994.285714286;1805.92857142857;100.428571428571
50510;2023;6;6;0;100;0;152666.666666667;1801.33333333333;91.5
50511;2023;2;2;0;100;0;281313.5;2094.5;105.5
50512;2023;10;10;0;100;0;181035;1544.2;127
50514;2023;5;5;0;100;0;76680;854;92.2
50517;2023;2;2;0;100;0;292870;2107.5;125.5
50518;2023;5;5;0;100;0;119100;1427;85.2
50519;2023;11;11;0;100;0;240502.272727273;2439.72727272727;102.272727272727
50521;2023;3;3;0;100;0;145500;2043;69.6666666666667
50522;2023;3;3;0;100;0;217000;2106.33333333333;92.3333333333333
50523;2023;38;37;1;97.3684210526316;2.63157894736842;201354.526315789;2140.68421052632;100.868421052632
50525;2023;7;7;0;100;0;97021.4285714286;1119.71428571429;82.5714285714286
50528;2023;3;3;0;100;0;157666.666666667;1434;110.333333333333
50529;2023;1;1;0;100;0;560000;6222;90
50531;2023;10;10;0;100;0;125925;1620.6;81.4
50532;2023;86;68;18;79.0697674418605;20.9302325581395;339074.651162791;3950.40697674419;91.5930232558139
50533;2023;2;2;0;100;0;72000;1131;62.5
50535;2023;11;11;0;100;0;146318.181818182;1606.81818181818;89.0909090909091
50536;2023;6;6;0;100;0;176666.666666667;1586.5;124
50537;2023;4;4;0;100;0;310687.5;2035.75;142.25
50538;2023;5;5;0;100;0;179460;1499.6;121
50539;2023;20;19;1;95;5;168157.5;1818.15;100.85
50540;2023;7;7;0;100;0;246571.428571429;2521.57142857143;92.8571428571429
50541;2023;18;17;1;94.4444444444444;5.55555555555556;240866.666666667;2486.66666666667;95
50542;2023;9;9;0;100;0;81051.6666666667;1118;71.2222222222222
50543;2023;14;14;0;100;0;186107.142857143;1937.57142857143;93.7857142857143
50546;2023;45;45;0;100;0;172366.888888889;1562.51111111111;110.155555555556
50548;2023;2;2;0;100;0;77500;1164;60
50549;2023;4;4;0;100;0;208925;2316.75;88.5
50550;2023;45;45;0;100;0;132238.222222222;1323.42222222222;100.155555555556
50551;2023;20;20;0;100;0;125631.5;1433.1;88.85
50552;2023;6;6;0;100;0;155941.666666667;1687.33333333333;98.5
50553;2023;2;2;0;100;0;212453;1824.5;121.5
50554;2023;17;17;0;100;0;210070.588235294;2063.58823529412;102.294117647059
50556;2023;4;4;0;100;0;93500;1275;72.75
50562;2023;34;30;4;88.2352941176471;11.7647058823529;240182.352941176;2685.23529411765;100.735294117647
50563;2023;5;5;0;100;0;144270;1563.4;96.2
50564;2023;14;14;0;100;0;148348.214285714;1314.85714285714;117.142857142857
50565;2023;32;30;2;93.75;6.25;180278.75;2200.15625;82.78125
50567;2023;11;11;0;100;0;188456.363636364;2112.09090909091;91.5454545454545
50568;2023;2;2;0;100;0;157500;1698;94
50569;2023;6;6;0;100;0;155300;1470.83333333333;103.666666666667
50570;2023;9;9;0;100;0;143811.111111111;1494.22222222222;101.444444444444
50572;2023;2;2;0;100;0;287075;2422;120
50574;2023;3;3;0;100;0;146166.666666667;1358.66666666667;98
50575;2023;3;3;0;100;0;162666.666666667;2698.33333333333;62.6666666666667
50576;2023;13;11;2;84.6153846153846;15.3846153846154;212882.307692308;2703.92307692308;82
50577;2023;5;5;0;100;0;155800;1533.6;94
50578;2023;1;1;0;100;0;295000;1980;149
50579;2023;18;18;0;100;0;199530.555555556;2073.11111111111;99.6111111111111
50582;2023;52;51;1;98.0769230769231;1.92307692307692;110190.192307692;1340.28846153846;88.2115384615385
50584;2023;1;1;0;100;0;350000;2991;117
50585;2023;20;20;0;100;0;203299.3;2583.6;86.8
50588;2023;9;9;0;100;0;207783.222222222;1731.88888888889;120.777777777778
50589;2023;4;4;0;100;0;152300;2101.75;81
50590;2023;4;4;0;100;0;204662.5;1742.5;118.75
50591;2023;40;40;0;100;0;91590;1146.875;82.675
50592;2023;18;18;0;100;0;156652.777777778;1434.88888888889;113.888888888889
50593;2023;6;6;0;100;0;123333.333333333;1510;85.6666666666667
50594;2023;9;9;0;100;0;292508.222222222;2515.66666666667;112.888888888889
50596;2023;4;4;0;100;0;219250;1720.25;126
50597;2023;9;9;0;100;0;208188.888888889;1992.77777777778;103.888888888889
50598;2023;2;1;1;50;50;117500;1660;66.5
50599;2023;15;15;0;100;0;277576.666666667;2605.86666666667;114.866666666667
50601;2023;43;42;1;97.6744186046512;2.32558139534884;155071.860465116;1526.81395348837;104.139534883721
50603;2023;18;18;0;100;0;295435;2475;117.944444444444
50604;2023;10;10;0;100;0;190762;1984.6;109.8
50606;2023;7;7;0;100;0;148132.571428571;1634;94.4285714285714
50607;2023;4;4;0;100;0;126729.5;1841.5;74.75
50609;2023;2;2;0;100;0;150500;1261.5;115.5
50612;2023;6;6;0;100;0;217784.833333333;2373.66666666667;93.3333333333333
50613;2023;5;5;0;100;0;179600;1679;108.6
50615;2023;72;62;10;86.1111111111111;13.8888888888889;210944.694444444;2293.54166666667;89.8611111111111
50616;2023;20;20;0;100;0;306465.7;2634;117.75
50617;2023;12;12;0;100;0;143117.583333333;1506.41666666667;99.1666666666667
50618;2023;2;2;0;100;0;228000;1753;135
50619;2023;5;5;0;100;0;130800;1541.4;90.6
50621;2023;3;3;0;100;0;212900;2043.33333333333;105.333333333333
50624;2023;4;4;0;100;0;212575;2172;98.75
50626;2023;13;13;0;100;0;197867.769230769;2040.07692307692;99.5384615384615
50628;2023;1;1;0;100;0;1,00E+05;1124;89
50629;2023;10;10;0;100;0;150600;1532.6;106.4
50633;2023;3;3;0;100;0;241000;1650.33333333333;143.333333333333
50634;2023;3;3;0;100;0;135333.333333333;1309.66666666667;110.333333333333
50637;2023;6;6;0;100;0;148455;1397;102.833333333333
50639;2023;53;43;10;81.1320754716981;18.8679245283019;127252.754716981;1657;81.8490566037736
50641;2023;7;7;0;100;0;202751.428571429;1559.85714285714;129.714285714286
50643;2023;8;8;0;100;0;188600;2331.25;86.375
50647;2023;12;12;0;100;0;284569.75;3014;95.75
50648;2023;13;13;0;100;0;242636.923076923;2175.92307692308;114.153846153846
51001;2023;3;3;0;100;0;130000;1354.33333333333;95.6666666666667
51002;2023;16;14;2;87.5;12.5;213965.875;2598.0625;97.625
51003;2023;2;2;0;100;0;183200;2060;88.5
51006;2023;1;1;0;100;0;204500;1794;114
51007;2023;12;12;0;100;0;150844.166666667;1878.58333333333;82.0833333333333
51008;2023;4;4;0;100;0;181250;1374.25;129.75
51009;2023;11;11;0;100;0;114999.545454545;1587.54545454545;83.6363636363636
51010;2023;2;2;0;100;0;80000;1131.5;70.5
51013;2023;1;1;0;100;0;250000;2193;114
51014;2023;1;1;0;100;0;167193;1706;98
51015;2023;1;1;0;100;0;237500;1448;164
51016;2023;3;3;0;100;0;70000;1475;46
51018;2023;2;2;0;100;0;161500;1848.5;85.5
51019;2023;3;3;0;100;0;275033.333333333;1942;142
51020;2023;1;1;0;100;0;264600;2242;118
51022;2023;1;1;0;100;0;170000;1889;90
51023;2023;2;2;0;100;0;211225;1816.5;129
51025;2023;7;7;0;100;0;258197.142857143;2589.57142857143;97.4285714285714
51027;2023;2;2;0;100;0;200150;1300.5;157
51028;2023;11;10;1;90.9090909090909;9.09090909090909;176967;2430.18181818182;85.0909090909091
51029;2023;14;11;3;78.5714285714286;21.4285714285714;190017.857142857;2081.21428571429;91.5
51030;2023;55;42;13;76.3636363636364;23.6363636363636;179231.109090909;2092.18181818182;86.3636363636364
51031;2023;1;1;0;100;0;259850;2240;116
51032;2023;6;6;0;100;0;119383.333333333;1474;85
51033;2023;4;4;0;100;0;168237.5;1464;118.5
51035;2023;1;1;0;100;0;160000;1143;140
51036;2023;7;7;0;100;0;77714.2857142857;855.571428571429;94.8571428571429
51037;2023;4;4;0;100;0;170625;1130.25;147
51038;2023;1;1;0;100;0;140000;1308;107
51039;2023;1;1;0;100;0;125000;1374;91
51040;2023;1;1;0;100;0;155000;1761;88
51042;2023;5;5;0;100;0;83930;876.2;99.8
51043;2023;17;17;0;100;0;189567.764705882;2077.41176470588;92.6470588235294
51044;2023;5;5;0;100;0;234578;2263.2;109.6
51045;2023;1;1;0;100;0;307400;1635;188
51046;2023;7;7;0;100;0;269452.857142857;2182.28571428571;122.428571428571
51047;2023;1;1;0;100;0;60000;759;79
51048;2023;2;2;0;100;0;182700;1641;112
51049;2023;6;5;1;83.3333333333333;16.6666666666667;184833.333333333;1636.33333333333;110
51050;2023;2;2;0;100;0;81250;1069;72
51051;2023;2;2;0;100;0;335000;2407.5;139
51052;2023;1;1;0;100;0;274500;2128;129
51054;2023;8;8;0;100;0;219574.375;2174.375;99.875
51055;2023;66;43;23;65.1515151515152;34.8484848484849;235693.909090909;2540.27272727273;91.8787878787879
51056;2023;4;4;0;100;0;100750;1415.5;72.25
51058;2023;53;8;45;15.0943396226415;84.9056603773585;207578.245283019;3098.2641509434;68.2641509433962
51060;2023;4;4;0;100;0;117000;1073.25;103.25
51062;2023;2;2;0;100;0;60750;944;63
51063;2023;1;1;0;100;0;195000;1127;173
51065;2023;2;2;0;100;0;132250;1085.5;121.5
51066;2023;5;5;0;100;0;138270;1504.4;92.2
51068;2023;2;2;0;100;0;70000;769;90
51069;2023;3;3;0;100;0;259000;2321;111.666666666667
51070;2023;1;1;0;100;0;120000;1200;100
51071;2023;2;2;0;100;0;86250;1002;94.5
51072;2023;1;1;0;100;0;235550;2944;80
51074;2023;20;20;0;100;0;246661.05;2661.75;97.45
51075;2023;7;6;1;85.7142857142857;14.2857142857143;266914.285714286;2601.14285714286;101.285714285714
51076;2023;4;4;0;100;0;205875;1606.5;145
51077;2023;3;3;0;100;0;131833.333333333;1924;67
51078;2023;4;4;0;100;0;189131.25;1920.25;104.5
51079;2023;9;9;0;100;0;234552.777777778;1710.44444444444;118.444444444444
51081;2023;5;5;0;100;0;293060;2633.6;112.8
51082;2023;1;1;0;100;0;215000;2172;99
51083;2023;1;1;0;100;0;87500;1029;85
51085;2023;6;6;0;100;0;103583.333333333;1374.83333333333;77.5
51086;2023;3;3;0;100;0;313003.333333333;2331;138.333333333333
51088;2023;3;3;0;100;0;238333.333333333;2878.66666666667;85
51090;2023;4;4;0;100;0;161025;1276.75;142
51091;2023;1;1;0;100;0;147150;1502;98
51092;2023;1;1;0;100;0;102000;1378;74
51093;2023;2;2;0;100;0;458500;2519.5;215.5
51094;2023;2;2;0;100;0;182000;1294.5;142
51097;2023;4;4;0;100;0;134999.75;1044;154.5
51101;2023;1;1;0;100;0;459000;2942;156
51102;2023;5;5;0;100;0;256480;2186.4;119
51103;2023;1;1;0;100;0;123990;1148;108
51104;2023;2;2;0;100;0;160500;1263;137.5
51105;2023;13;12;1;92.3076923076923;7.69230769230769;392472.307692308;2986.23076923077;136.153846153846
51107;2023;3;3;0;100;0;138333.333333333;1468.33333333333;122.333333333333
51108;2023;419;177;242;42.2434367541766;57.7565632458234;127465.572792363;1613.00477326969;79.6563245823389
51109;2023;3;3;0;100;0;203333.333333333;3547.33333333333;57.3333333333333
51111;2023;1;1;0;100;0;115000;1150;100
51113;2023;1;1;0;100;0;169650;2651;64
51115;2023;2;2;0;100;0;322450;2325;154.5
51116;2023;2;2;0;100;0;157000;1903.5;90.5
51117;2023;3;3;0;100;0;191816.666666667;2209.66666666667;91.3333333333333
51118;2023;8;8;0;100;0;398931.25;3006.875;127.375
51119;2023;2;2;0;100;0;362500;2432;191
51121;2023;5;5;0;100;0;137646;1710.8;82.6
51122;2023;1;1;0;100;0;73042;803;91
51125;2023;1;1;0;100;0;118000;1157;102
51127;2023;1;1;0;100;0;80000;889;90
51128;2023;1;1;0;100;0;370000;2624;141
51129;2023;1;1;0;100;0;72000;857;84
51130;2023;5;5;0;100;0;71128;820.4;86.8
51134;2023;1;1;0;100;0;150500;1730;87
51135;2023;2;2;0;100;0;93125;1498.5;63.5
51136;2023;10;10;0;100;0;156365;1547.5;99.1
51137;2023;5;5;0;100;0;136820;1405.8;93
51138;2023;2;2;0;100;0;107500;877.5;117.5
51139;2023;1;1;0;100;0;210000;1050;200
51140;2023;2;2;0;100;0;255386;2088;115.5
51141;2023;13;12;1;92.3076923076923;7.69230769230769;194591.153846154;1508.53846153846;134.230769230769
51142;2023;5;5;0;100;0;118000;1393.6;91
51144;2023;4;4;0;100;0;133625;1099.75;117.75
51145;2023;3;3;0;100;0;313183.333333333;3199;98.6666666666667
51148;2023;1;1;0;100;0;1,00E+05;813;123
51149;2023;1;1;0;100;0;171550;1682;102
51151;2023;1;1;0;100;0;107500;995;108
51152;2023;2;1;1;50;50;291510;2742;113.5
51153;2023;9;9;0;100;0;265366.666666667;2788.11111111111;97.5555555555556
51154;2023;2;2;0;100;0;169650;1472;108.5
51155;2023;4;4;0;100;0;120700;1563.5;88.5
51156;2023;1;1;0;100;0;110000;1429;77
51157;2023;1;1;0;100;0;95000;1532;62
51158;2023;3;3;0;100;0;118833.333333333;874.666666666667;134.333333333333
51160;2023;9;9;0;100;0;167194.444444444;1637.44444444444;102.222222222222
51161;2023;4;4;0;100;0;177875;1491;116
51162;2023;9;9;0;100;0;92111.1111111111;1214.77777777778;81
51163;2023;1;1;0;100;0;315000;1658;190
51165;2023;5;5;0;100;0;149600;1354.6;108.4
51167;2023;3;3;0;100;0;129666.666666667;1270.66666666667;102.666666666667
51168;2023;1;1;0;100;0;58000;1184;49
51169;2023;1;1;0;100;0;110000;1222;90
51171;2023;14;14;0;100;0;264201.428571429;2206.64285714286;118.142857142857
51172;2023;86;68;18;79.0697674418605;20.9302325581395;263089.313953488;2756.82558139535;94.953488372093
51173;2023;1;1;0;100;0;35000;833;42
51174;2023;1;1;0;100;0;229400;1480;155
51175;2023;2;2;0;100;0;82500;902;91
51176;2023;1;1;0;100;0;40000;889;45
51177;2023;1;1;0;100;0;324000;1841;176
51179;2023;2;2;0;100;0;157500;1679.5;93.5
51181;2023;4;4;0;100;0;402250;3076.5;127.5
51182;2023;2;2;0;100;0;89250;693;117.5
51183;2023;13;11;2;84.6153846153846;15.3846153846154;249103.846153846;2202.38461538462;111
51184;2023;1;1;0;100;0;127200;1445;88
51185;2023;5;5;0;100;0;96600;1479.4;74.2
51187;2023;1;1;0;100;0;230000;2130;108
51190;2023;1;1;0;100;0;187500;1974;95
51192;2023;3;3;0;100;0;153500;1264.66666666667;107.333333333333
51193;2023;21;21;0;100;0;201246.19047619;1761.66666666667;118.238095238095
51194;2023;4;4;0;100;0;179811.75;1617.5;111.5
51195;2023;3;3;0;100;0;125266.666666667;1725.33333333333;72.6666666666667
51196;2023;12;12;0;100;0;146791.75;1501.08333333333;104.083333333333
51197;2023;1;1;0;100;0;198500;2005;99
51198;2023;5;5;0;100;0;249738;1663.6;148.2
51199;2023;1;1;0;100;0;150000;2381;63
51200;2023;5;5;0;100;0;177852;1870.8;88.8
51201;2023;1;1;0;100;0;45000;750;60
51202;2023;8;6;2;75;25;152900;1851.25;86.75
51203;2023;2;2;0;100;0;169025;2245;75.5
51204;2023;10;10;0;100;0;266265;2168;127.6
51205;2023;2;2;0;100;0;164875;1460.5;141
51210;2023;17;14;3;82.3529411764706;17.6470588235294;267973.529411765;2618.05882352941;93.0588235294118
51211;2023;1;1;0;100;0;166000;678;245
51212;2023;2;2;0;100;0;192250;1349;141.5
51213;2023;1;1;0;100;0;163000;1430;114
51215;2023;1;1;0;100;0;188100;1636;115
51216;2023;4;4;0;100;0;152437.5;1577.75;101
51217;2023;24;24;0;100;0;182059.166666667;1826.41666666667;101.958333333333
51218;2023;1;1;0;100;0;106750;945;113
51219;2023;2;2;0;100;0;72750;713.5;110
51220;2023;1;1;0;100;0;125000;1437;87
51224;2023;1;1;0;100;0;114000;1213;94
51225;2023;7;7;0;100;0;343085.428571429;3093.57142857143;113.428571428571
51226;2023;2;2;0;100;0;192132.5;1752;112.5
51227;2023;1;1;0;100;0;260000;1486;175
51228;2023;3;3;0;100;0;122000;1297.33333333333;85.3333333333333
51229;2023;2;2;0;100;0;92000;826.5;115.5
51230;2023;293;117;176;39.9317406143345;60.0682593856655;151615.798634812;2017.50511945392;74.5460750853242
51231;2023;8;8;0;100;0;227181.25;2111.5;112.5
51232;2023;7;7;0;100;0;235064.285714286;2096.57142857143;113
51234;2023;4;4;0;100;0;139250;1379.75;99.75
51235;2023;2;2;0;100;0;209900;1163;181.5
51236;2023;1;1;0;100;0;275000;2183;126
51237;2023;15;15;0;100;0;124660;1586.53333333333;80.2666666666667
51238;2023;2;2;0;100;0;115000;1617.5;73
51240;2023;2;2;0;100;0;79250;921;83
51241;2023;2;2;0;100;0;109500;1176;96
51242;2023;40;34;6;85;15;163391.8;1737.65;94.975
51243;2023;1;1;0;100;0;165000;1422;116
51245;2023;4;4;0;100;0;241700;1919.5;125.5
51247;2023;2;2;0;100;0;68750;930;75
51248;2023;23;21;2;91.304347826087;8.69565217391304;111203.913043478;1152.13043478261;95.3478260869565
51249;2023;3;3;0;100;0;215333.333333333;2572.66666666667;74.6666666666667
51250;2023;36;29;7;80.5555555555556;19.4444444444444;158703.472222222;1759.83333333333;92.7777777777778
51252;2023;8;8;0;100;0;168242.375;2656;78.125
51254;2023;3;3;0;100;0;104800;1228;82.3333333333333
51256;2023;2;2;0;100;0;283300;2704.5;103.5
51258;2023;3;3;0;100;0;102333.333333333;1724.66666666667;93.3333333333333
51259;2023;1;1;0;100;0;286918;1171;245
51262;2023;22;21;1;95.4545454545455;4.54545454545455;117762.727272727;1300.72727272727;90.4545454545455
51263;2023;4;4;0;100;0;111250;1075.75;100.25
51264;2023;7;7;0;100;0;134664.285714286;1753.71428571429;85.4285714285714
51265;2023;3;3;0;100;0;89167;1276;67.3333333333333
51266;2023;4;4;0;100;0;241450;2558.75;89.25
51267;2023;1;1;0;100;0;203000;1829;111
51268;2023;1;1;0;100;0;203250;1239;164
51269;2023;11;11;0;100;0;130884.545454545;2899.63636363636;51.3636363636364
51270;2023;1;1;0;100;0;153368;935;164
51272;2023;6;6;0;100;0;74166.6666666667;800.666666666667;94.1666666666667
51277;2023;2;2;0;100;0;142500;1455;100
51278;2023;4;4;0;100;0;173244.5;1325.25;129.75
51279;2023;3;3;0;100;0;156516.666666667;1325;115
51281;2023;5;5;0;100;0;205080;1986.8;108.6
51282;2023;22;22;0;100;0;548304.545454545;3473.63636363636;161.590909090909
51283;2023;1;1;0;100;0;81000;964;84
51284;2023;4;4;0;100;0;73750;1257.25;63.25
51285;2023;2;2;0;100;0;114500;854.5;141
51286;2023;1;1;0;100;0;20000;800;25
51287;2023;8;7;1;87.5;12.5;262896.25;2557.75;98.375
51288;2023;2;2;0;100;0;100500;724.5;143
51289;2023;4;4;0;100;0;118205;873.5;136.25
51290;2023;2;2;0;100;0;96750;1188.5;81.5
51291;2023;14;14;0;100;0;265000.714285714;2643.21428571429;104.571428571429
51293;2023;3;3;0;100;0;266933.333333333;2015.66666666667;153.333333333333
51294;2023;2;2;0;100;0;105000;1205.5;83
51295;2023;2;2;0;100;0;155000;1203.5;128.5
51296;2023;1;1;0;100;0;220000;1134;194
51298;2023;5;5;0;100;0;112600;1157;89.6
51299;2023;6;6;0;100;0;262625;2298.5;119.666666666667
51300;2023;1;1;0;100;0;87200;1104;79
51302;2023;2;2;0;100;0;214750;1435;217
51303;2023;5;5;0;100;0;164336;1740.4;91.6
51304;2023;1;1;0;100;0;130000;977;133
51305;2023;1;1;0;100;0;150000;743;202
51306;2023;1;1;0;100;0;149000;1242;120
51307;2023;4;4;0;100;0;179200;1903.75;95.75
51308;2023;18;18;0;100;0;237532.777777778;2247;111.666666666667
51311;2023;1;1;0;100;0;148000;1410;105
51312;2023;5;5;0;100;0;277624;2098.2;129.4
51314;2023;1;1;0;100;0;125000;1953;64
51315;2023;1;1;0;100;0;150000;968;155
51316;2023;4;4;0;100;0;114625;1293.25;89.5
51317;2023;1;1;0;100;0;80000;1143;70
51318;2023;2;2;0;100;0;110000;1243.5;91.5
51319;2023;2;2;0;100;0;146995;1193.5;117
51320;2023;2;2;0;100;0;83625;1465.5;48
51322;2023;2;2;0;100;0;268500;1651;148
51323;2023;1;1;0;100;0;129990;1300;100
51324;2023;1;1;0;100;0;152000;1974;77
51326;2023;7;7;0;100;0;182146.571428571;1657.71428571429;109.142857142857
51327;2023;2;2;0;100;0;105000;843;136.5
51328;2023;7;7;0;100;0;101571.428571429;1284.71428571429;86
51329;2023;8;7;1;87.5;12.5;282593.75;2671.625;109.5
51333;2023;4;4;0;100;0;359166;2748.75;142
51334;2023;4;4;0;100;0;162000;1510.25;104
51336;2023;2;2;0;100;0;84000;891.5;85
51337;2023;1;1;0;100;0;166000;2594;64
51338;2023;1;1;0;100;0;248000;2214;112
51339;2023;6;6;0;100;0;178950;1663.83333333333;108.833333333333
51340;2023;2;2;0;100;0;175000;1086;151
51341;2023;1;1;0;100;0;83550;844;99
51343;2023;8;8;0;100;0;93952.5;1312.375;74.75
51344;2023;12;12;0;100;0;263810;2468;107.833333333333
51345;2023;2;2;0;100;0;175000;2282;77.5
51346;2023;9;9;0;100;0;130944.444444444;1393.22222222222;99.3333333333333
51348;2023;1;1;0;100;0;104500;1451;72
51350;2023;1;1;0;100;0;53000;525;101
51351;2023;2;2;0;100;0;83000;1206;70
51352;2023;4;4;0;100;0;132750;1493.5;90.25
51353;2023;1;1;0;100;0;70000;946;74
51354;2023;3;3;0;100;0;103333.333333333;793.666666666667;120.666666666667
51355;2023;2;2;0;100;0;49500;710.5;69.5
51357;2023;6;6;0;100;0;166433.333333333;2240.33333333333;78.5
51358;2023;2;2;0;100;0;96375;1237.5;74.5
51359;2023;1;1;0;100;0;175000;2333;75
51360;2023;2;2;0;100;0;161500;1854.5;78.5
51362;2023;5;5;0;100;0;432660;2734.2;159.4
51363;2023;1;1;0;100;0;116000;1160;100
51364;2023;1;1;0;100;0;163500;1587;103
51365;2023;6;6;0;100;0;346183.333333333;3046.5;118.5
51367;2023;7;7;0;100;0;145520;1630.57142857143;87.5714285714286
51369;2023;3;3;0;100;0;154383.333333333;1841.66666666667;82
51370;2023;1;1;0;100;0;130000;1287;101
51372;2023;6;6;0;100;0;242604.166666667;2115.83333333333;114.166666666667
51374;2023;2;2;0;100;0;171754.5;1855;121
51375;2023;2;2;0;100;0;282750;2983;96
51379;2023;7;7;0;100;0;224857.142857143;2006;108.571428571429
51380;2023;36;36;0;100;0;136802.777777778;1463.97222222222;92.9166666666667
51381;2023;8;5;3;62.5;37.5;119946.25;1684.75;68
51382;2023;1;1;0;100;0;169600;2494;68
51384;2023;2;2;0;100;0;202950;1591.5;126
51388;2023;39;33;6;84.6153846153846;15.3846153846154;178912.820512821;1739.69230769231;104.794871794872
51389;2023;7;7;0;100;0;193597.857142857;2361.28571428571;88.4285714285714
51390;2023;1;1;0;100;0;267000;2384;112
51391;2023;19;18;1;94.7368421052632;5.26315789473684;228225.789473684;2652.21052631579;87.5789473684211
51393;2023;4;4;0;100;0;358875;2156.5;172.5
51395;2023;1;1;0;100;0;99544;1364;73
51396;2023;1;1;0;100;0;60000;1200;50
51397;2023;1;1;0;100;0;153000;1177;130
51398;2023;1;1;0;100;0;80000;899;89
51399;2023;6;6;0;100;0;78000;754.666666666667;110.333333333333
51402;2023;2;2;0;100;0;52000;890.5;59
51403;2023;1;1;0;100;0;120000;1176;102
51406;2023;1;1;0;100;0;210000;1780;118
51407;2023;1;1;0;100;0;192000;1129;170
51409;2023;4;4;0;100;0;205092.5;1562.75;145.25
51410;2023;4;4;0;100;0;219159;2241.25;90.25
51412;2023;1;1;0;100;0;106000;2120;50
51413;2023;5;5;0;100;0;202000;1814.4;108
51414;2023;4;4;0;100;0;214262.5;2503;86.75
51415;2023;4;4;0;100;0;109750;1225;89.75
51416;2023;4;4;0;100;0;124412.5;1584;74.75
51417;2023;3;3;0;100;0;86666.6666666667;1513.66666666667;63.6666666666667
51418;2023;5;5;0;100;0;454454;3425.6;146.2
51419;2023;3;3;0;100;0;85000;975.666666666667;83.3333333333333
51420;2023;1;1;0;100;0;95000;1000;95
51422;2023;4;4;0;100;0;542787.5;2920.25;184.25
51423;2023;22;22;0;100;0;104067.272727273;1033.40909090909;98.5909090909091
51424;2023;4;4;0;100;0;85250;801.75;111.5
51425;2023;5;5;0;100;0;211000;2874.8;78
51428;2023;4;4;0;100;0;208375;1706.75;124.5
51429;2023;1;1;0;100;0;310000;2385;130
51430;2023;3;3;0;100;0;55833.3333333333;771;65.3333333333333
51431;2023;9;9;0;100;0;233167.777777778;1951.77777777778;118.888888888889
51432;2023;8;8;0;100;0;132675;1213.75;110.875
51433;2023;4;4;0;100;0;137950;1090;109
51434;2023;3;3;0;100;0;290816.666666667;2743.33333333333;106.666666666667
51435;2023;2;2;0;100;0;120000;1018.5;120.5
51436;2023;6;6;0;100;0;173267.5;1702;102.333333333333
51439;2023;4;4;0;100;0;448955;3983.75;119.5
51440;2023;19;17;2;89.4736842105263;10.5263157894737;183007.894736842;1700.57894736842;112.631578947368
51441;2023;1;1;0;100;0;85000;1809;47
51442;2023;1;1;0;100;0;122900;1217;101
51444;2023;3;3;0;100;0;257500;1846;140.333333333333
51445;2023;3;3;0;100;0;421333.333333333;2406;186.666666666667
51446;2023;1;1;0;100;0;142000;1268;112
51447;2023;3;3;0;100;0;231600;2077;112.333333333333
51448;2023;6;6;0;100;0;143816.666666667;1818.5;91.3333333333333
51449;2023;8;8;0;100;0;279793.75;2623.5;113.25
51450;2023;5;5;0;100;0;330480;2197.6;147.8
51451;2023;1;1;0;100;0;168000;1244;135
51453;2023;6;6;0;100;0;196500;2000.5;102
51454;2023;2044;466;1578;22.7984344422701;77.2015655577299;188965.3018591;2777.20890410959;69.1286692759296
51455;2023;2;2;0;100;0;190000;1338.5;141
51457;2023;1;1;0;100;0;172250;1126;153
51458;2023;2;2;0;100;0;115075;1045.5;117.5
51459;2023;1;1;0;100;0;90000;1023;88
51461;2023;10;8;2;80;20;178725.4;2573.5;71.4
51463;2023;2;2;0;100;0;31750;497;68
51464;2023;3;3;0;100;0;136600;1627;82.3333333333333
51465;2023;1;1;0;100;0;532450;2802;190
51468;2023;3;3;0;100;0;425666.666666667;4388.66666666667;95.3333333333333
51469;2023;1;1;0;100;0;120000;1034;116
51471;2023;2;2;0;100;0;427500;3039;136
51472;2023;9;9;0;100;0;206351.111111111;2039.88888888889;104.888888888889
51473;2023;1;1;0;100;0;80000;533;150
51474;2023;32;18;14;56.25;43.75;211816.71875;2636.40625;80.75
51475;2023;2;2;0;100;0;93750;1145;79
51476;2023;10;9;1;90;10;226685;1914.3;119
51477;2023;6;6;0;100;0;266775;2351.5;114.333333333333
51479;2023;3;3;0;100;0;392918.333333333;3087.33333333333;128
51480;2023;3;3;0;100;0;168333.333333333;1929;97.3333333333333
51482;2023;6;6;0;100;0;241325;1852;137.5
51483;2023;4;4;0;100;0;184750;1701.75;109.25
51484;2023;4;4;0;100;0;180362.5;1337.5;133.5
51485;2023;3;3;0;100;0;227166.666666667;2032.33333333333;114.333333333333
51486;2023;4;4;0;100;0;130000;1287.5;110
51490;2023;2;2;0;100;0;258802.5;2189.5;118.5
51491;2023;2;2;0;100;0;75000;642;114
51492;2023;20;19;1;95;5;130231.5;1398.25;94.05
51493;2023;1;0;1;0;100;90000;1475;61
51496;2023;2;2;0;100;0;213275;1425;148.5
51498;2023;2;2;0;100;0;199385;1705;119.5
51499;2023;1;1;0;100;0;263000;1826;144
51502;2023;1;1;0;100;0;132500;2172;61
51504;2023;4;4;0;100;0;155090;1724.5;91
51505;2023;9;9;0;100;0;162166.666666667;1600.77777777778;107
51506;2023;45;30;15;66.6666666666667;33.3333333333333;200376.222222222;2040.66666666667;99.8888888888889
51507;2023;40;36;4;90;10;112224.75;1131.15;103.875
51508;2023;2;2;0;100;0;75000;886;92
51509;2023;2;2;0;100;0;230000;1479;158.5
51510;2023;1;1;0;100;0;1,00E+05;800;125
51511;2023;2;2;0;100;0;120000;877.5;137.5
51513;2023;4;3;1;75;25;80750;1032.5;71.25
51516;2023;2;2;0;100;0;56500;942;60
51518;2023;3;3;0;100;0;260806.666666667;1924;147.333333333333
51521;2023;1;1;0;100;0;227000;1410;161
51522;2023;3;3;0;100;0;161000;1080.66666666667;143
51523;2023;1;1;0;100;0;368600;2333;158
51524;2023;1;1;0;100;0;74000;755;98
51525;2023;16;16;0;100;0;209804.375;2107.5;99.5625
51526;2023;8;8;0;100;0;104673.75;1258.75;82.625
51527;2023;7;7;0;100;0;258371.428571429;2187;112.571428571429
51528;2023;2;2;0;100;0;73750;494;144.5
51529;2023;2;2;0;100;0;312500;2109.5;154
51530;2023;8;8;0;100;0;233107.5;2293.5;107.75
51531;2023;15;14;1;93.3333333333333;6.66666666666667;86473.3333333333;1049.46666666667;90.8
51532;2023;3;3;0;100;0;277800;2220.33333333333;121
51533;2023;2;2;0;100;0;69000;632.5;109.5
51534;2023;2;2;0;100;0;107000;1575;64
51535;2023;47;37;10;78.7234042553192;21.2765957446809;139646.978723404;1564.76595744681;89.5744680851064
51536;2023;34;15;19;44.1176470588235;55.8823529411765;207747.058823529;2496.47058823529;85.0294117647059
51537;2023;1;1;0;100;0;135000;1125;120
51539;2023;2;2;0;100;0;166000;824.5;207.5
51542;2023;2;2;0;100;0;94000;1532;62.5
51544;2023;1;1;0;100;0;165000;1542;107
51545;2023;4;4;0;100;0;142650;1362.5;120
51546;2023;5;5;0;100;0;186956;1689.6;111.4
51547;2023;1;1;0;100;0;190000;1061;179
51548;2023;4;4;0;100;0;208250;1947.5;107.75
51549;2023;1;1;0;100;0;130000;1512;86
51550;2023;4;4;0;100;0;195125;1636.25;114.75
51553;2023;1;1;0;100;0;175000;1042;168
51555;2023;1;1;0;100;0;32000;561;57
51556;2023;6;6;0;100;0;157366.666666667;1308.5;122.333333333333
51557;2023;4;4;0;100;0;78532.25;917.5;87.5
51559;2023;24;22;2;91.6666666666667;8.33333333333333;136526.25;1299.58333333333;104.375
51562;2023;30;24;6;80;20;269994.6;2470.66666666667;109.466666666667
51564;2023;3;3;0;100;0;679458.666666667;3917.33333333333;153
51565;2023;1;1;0;100;0;70000;972;72
51567;2023;3;3;0;100;0;181910;1359;143.666666666667
51568;2023;2;2;0;100;0;244000;1471;169
51569;2023;4;4;0;100;0;482875;2706.25;178.25
51570;2023;2;2;0;100;0;221000;1308;183.5
51571;2023;11;11;0;100;0;289990.909090909;2435.90909090909;124.454545454545
51572;2023;3;3;0;100;0;176433.333333333;2085.66666666667;86
51573;2023;93;60;33;64.5161290322581;35.4838709677419;247793.064516129;2791.27956989247;88.6989247311828
51576;2023;14;14;0;100;0;201400;1937.57142857143;102.928571428571
51577;2023;2;2;0;100;0;196000;1862;106.5
51580;2023;3;3;0;100;0;263300;2704.66666666667;105.333333333333
51581;2023;1;1;0;100;0;145000;2231;65
51582;2023;5;5;0;100;0;152400;2334;77.6
51584;2023;1;1;0;100;0;286200;2202;130
51585;2023;7;6;1;85.7142857142857;14.2857142857143;96342.8571428571;1093.42857142857;91.1428571428571
51586;2023;1;1;0;100;0;50000;556;90
51587;2023;2;2;0;100;0;236400;2675.5;86
51588;2023;1;1;0;100;0;192000;889;216
51589;2023;4;4;0;100;0;119585;825.75;134.25
51590;2023;1;1;0;100;0;79200;649;122
51591;2023;1;1;0;100;0;196000;3920;50
51592;2023;5;5;0;100;0;182700;1945.6;92.8
51594;2023;1;1;0;100;0;115000;1420;81
51595;2023;2;2;0;100;0;150750;1611;96
51596;2023;3;3;0;100;0;131666.666666667;1186;132.666666666667
51597;2023;4;4;0;100;0;202500;3276.75;86.75
51598;2023;13;13;0;100;0;84163.0769230769;1246.69230769231;66.4615384615385
51599;2023;2;2;0;100;0;133500;1360.5;97.5
51600;2023;3;3;0;100;0;100333.333333333;1147.33333333333;85
51603;2023;1;1;0;100;0;345000;2396;144
51604;2023;1;1;0;100;0;267500;2649;101
51605;2023;3;3;0;100;0;173616.666666667;1976.33333333333;89.3333333333333
51607;2023;3;3;0;100;0;302366.666666667;2626.33333333333;111
51608;2023;1;1;0;100;0;82500;927;89
51609;2023;5;5;0;100;0;147800;1612.4;94.4
51610;2023;5;5;0;100;0;135640;1003.8;138.6
51611;2023;2;2;0;100;0;142795;1149.5;162.5
51612;2023;26;26;0;100;0;200523.076923077;1690.42307692308;119.769230769231
51613;2023;5;5;0;100;0;130638.8;1949.6;64.6
51614;2023;11;11;0;100;0;352386.363636364;3040.72727272727;106.545454545455
51616;2023;1;1;0;100;0;182000;1802;101
51617;2023;4;4;0;100;0;176833.25;2139;88.75
51618;2023;2;2;0;100;0;158500;1575;121
51620;2023;2;2;0;100;0;82225;492.5;177.5
51621;2023;5;5;0;100;0;68525;725.4;89.2
51622;2023;1;1;0;100;0;107430;1249;86
51623;2023;4;4;0;100;0;327750;2634;124.25
51624;2023;3;3;0;100;0;237483.333333333;2328;102.666666666667
51625;2023;2;2;0;100;0;190500;1468.5;130.5
51626;2023;2;2;0;100;0;144000;1398;122.5
51627;2023;1;1;0;100;0;242500;1956;124
51629;2023;11;7;4;63.6363636363636;36.3636363636364;195779.818181818;2822.27272727273;67.6363636363636
51630;2023;4;4;0;100;0;338500;2907.25;106.75
51631;2023;2;2;0;100;0;417350;3645.5;112.5
51632;2023;2;2;0;100;0;119900;1404;84.5
51633;2023;1;1;0;100;0;360000;4615;78
51635;2023;4;4;0;100;0;198450;1437;132.25
51636;2023;5;5;0;100;0;257902;2515.8;104.4
51638;2023;1;1;0;100;0;60000;458;131
51640;2023;1;1;0;100;0;98600;1108;89
51641;2023;2;2;0;100;0;144500;1130;202
51642;2023;1;1;0;100;0;62000;1240;50
51643;2023;6;6;0;100;0;252820;2606.16666666667;103.333333333333
51644;2023;2;2;0;100;0;99900;1295;77
51646;2023;1;1;0;100;0;85000;914;93
51647;2023;5;5;0;100;0;167370;1710.2;104.2
51648;2023;5;5;0;100;0;145200;1333.2;112.6
51649;2023;90;48;42;53.3333333333333;46.6666666666667;113559.855555556;1426.77777777778;84.5666666666667
51655;2023;3;3;0;100;0;147833.333333333;1392.66666666667;101.333333333333
51656;2023;3;3;0;100;0;285762;2143;136.333333333333
51657;2023;1;1;0;100;0;290000;2990;97
51658;2023;1;1;0;100;0;50000;556;90
51660;2023;22;22;0;100;0;227859.090909091;2421.54545454545;98.0454545454545
51662;2023;34;29;5;85.2941176470588;14.7058823529412;283034.794117647;2616.5;112.264705882353
51663;2023;22;13;9;59.0909090909091;40.9090909090909;138806;1953.13636363636;70.0909090909091
52003;2023;3;3;0;100;0;55166.6666666667;471;129
52005;2023;1;1;0;100;0;119700;1185;101
52006;2023;6;6;0;100;0;115208.333333333;1396.5;85.1666666666667
52008;2023;6;6;0;100;0;81941.6666666667;881.833333333333;95.1666666666667
52009;2023;1;1;0;100;0;116375;1402;83
52013;2023;1;1;0;100;0;121480;1279;95
52014;2023;1;1;0;100;0;40000;471;85
52016;2023;1;1;0;100;0;55000;679;81
52017;2023;10;9;1;90;10;111815;947;123.7
52021;2023;2;2;0;100;0;111525;838.5;119
52022;2023;2;2;0;100;0;62500;747.5;90
52023;2023;3;3;0;100;0;107000;1238.33333333333;82.6666666666667
52029;2023;1;1;0;100;0;134000;2030;66
52030;2023;1;1;0;100;0;52000;1156;45
52031;2023;1;1;0;100;0;70000;1296;54
52034;2023;1;1;0;100;0;195500;1438;136
52037;2023;3;3;0;100;0;123283.333333333;1218.33333333333;99.6666666666667
52038;2023;2;2;0;100;0;38250;551.5;69.5
52040;2023;1;1;0;100;0;71500;715;100
52042;2023;1;1;0;100;0;1,00E+05;1031;97
52043;2023;1;1;0;100;0;35000;625;56
52044;2023;3;3;0;100;0;99170;863.333333333333;124.666666666667
52045;2023;15;15;0;100;0;276366.666666667;2543.2;95.7333333333333
52047;2023;1;1;0;100;0;116655;1356;86
52050;2023;14;14;0;100;0;100078.571428571;1160;85.5
52056;2023;1;1;0;100;0;69000;406;170
52057;2023;1;1;0;100;0;115000;1027;112
52058;2023;19;19;0;100;0;119296.315789474;1165.26315789474;108.315789473684
52059;2023;1;1;0;100;0;80000;792;101
52060;2023;25;17;8;68;32;90478.8;1165.36;81.44
52061;2023;3;3;0;100;0;93583.3333333333;1120;91.6666666666667
52062;2023;1;1;0;100;0;225350;2049;110
52063;2023;2;2;0;100;0;120000;1063;120
52064;2023;5;5;0;100;0;94200;989.6;96
52067;2023;2;2;0;100;0;97191;593.5;163
52072;2023;1;1;0;100;0;149000;1520;98
52074;2023;5;5;0;100;0;101000;1037.6;91
52075;2023;4;4;0;100;0;139687.5;1281.25;112.25
52076;2023;1;1;0;100;0;99000;762;130
52079;2023;9;9;0;100;0;84200;890.666666666667;95.3333333333333
52083;2023;5;5;0;100;0;119400;1238;100
52087;2023;1;1;0;100;0;130000;1585;82
52088;2023;5;5;0;100;0;197607;1541;128.2
52089;2023;1;1;0;100;0;135000;1500;90
52090;2023;4;4;0;100;0;58000;643.5;88.25
52092;2023;1;1;0;100;0;295000;1077;274
52093;2023;29;27;2;93.1034482758621;6.89655172413793;105568.275862069;1105.48275862069;94.8965517241379
52094;2023;1;1;0;100;0;447400;3442;130
52095;2023;6;6;0;100;0;87998.3333333333;802.666666666667;107.5
52099;2023;8;8;0;100;0;143733.75;1153.25;131.875
52102;2023;3;3;0;100;0;181750;1670.66666666667;117.333333333333
52103;2023;1;1;0;100;0;75000;625;120
52104;2023;8;8;0;100;0;153244.375;1425.75;115.125
52105;2023;7;7;0;100;0;129614.285714286;1385.57142857143;93.8571428571429
52106;2023;2;2;0;100;0;106350;1080.5;95.5
52107;2023;2;2;0;100;0;96500;1024;107.5
52108;2023;2;2;0;100;0;103500;1232;92
52113;2023;1;1;0;100;0;129000;949;136
52114;2023;10;10;0;100;0;126120;1213.9;112.5
52118;2023;1;1;0;100;0;1,00E+05;794;126
52119;2023;2;2;0;100;0;135250;1333.5;101
52120;2023;6;6;0;100;0;60816.6666666667;731.166666666667;83.6666666666667
52121;2023;214;130;84;60.7476635514019;39.2523364485981;138920.135514019;1662.38317757009;84.5841121495327
52123;2023;6;6;0;100;0;86750;1097.66666666667;82.3333333333333
52124;2023;2;2;0;100;0;60500;721;86
52125;2023;5;4;1;80;20;176200;1364;121
52126;2023;1;1;0;100;0;186595;1414;132
52128;2023;1;1;0;100;0;70000;1148;61
52130;2023;1;1;0;100;0;42000;600;70
52131;2023;1;1;0;100;0;195000;1444;135
52132;2023;4;4;0;100;0;141500;1630.75;84.75
52133;2023;1;1;0;100;0;155000;1449;107
52134;2023;2;2;0;100;0;58000;767;67
52135;2023;3;3;0;100;0;140526.666666667;1063.66666666667;125
52136;2023;1;1;0;100;0;127270;561;227
52140;2023;7;7;0;100;0;144866.285714286;1230.14285714286;118.285714285714
52141;2023;5;5;0;100;0;168800;1794;102
52142;2023;1;1;0;100;0;54000;730;74
52151;2023;2;2;0;100;0;105500;960;103.5
52155;2023;5;5;0;100;0;189300;1312.8;111.6
52156;2023;2;2;0;100;0;76500;1011.5;65.5
52158;2023;1;1;0;100;0;170300;990;172
52160;2023;1;1;0;100;0;107000;1070;100
52163;2023;5;5;0;100;0;99580;987.8;105.4
52164;2023;2;2;0;100;0;56000;778.5;71
52165;2023;1;1;0;100;0;75000;500;150
52167;2023;2;2;0;100;0;110000;978.5;111.5
52171;2023;2;2;0;100;0;41250;614;77
52172;2023;2;2;0;100;0;116000;570;182.5
52173;2023;2;2;0;100;0;91600;1107.5;74
52174;2023;1;1;0;100;0;432000;2310;187
52175;2023;3;3;0;100;0;103931.666666667;666.333333333333;146.666666666667
52177;2023;4;4;0;100;0;90000;600;132.75
52178;2023;1;1;0;100;0;69000;627;110
52182;2023;27;26;1;96.2962962962963;3.7037037037037;149750.925925926;1546.62962962963;97.9259259259259
52185;2023;1;1;0;100;0;140000;1273;110
52187;2023;1;1;0;100;0;80000;400;200
52189;2023;3;3;0;100;0;195166.666666667;1247.66666666667;149
52190;2023;5;5;0;100;0;99100;1001.4;100.8
52193;2023;2;2;0;100;0;145000;1160.5;134.5
52194;2023;30;28;2;93.3333333333333;6.66666666666667;115409.7;1247.86666666667;94.4333333333333
52195;2023;2;2;0;100;0;32240;472.5;70
52196;2023;3;3;0;100;0;133000;1233.66666666667;109
52197;2023;10;10;0;100;0;115160;1012.3;105.2
52200;2023;1;1;0;100;0;60000;714;84
52203;2023;1;1;0;100;0;29000;439;66
52205;2023;4;4;0;100;0;155080;1429;108.5
52206;2023;3;3;0;100;0;257116.666666667;1965;133.333333333333
52207;2023;2;2;0;100;0;89000;965;94.5
52208;2023;2;2;0;100;0;89500;1208.5;77
52211;2023;11;10;1;90.9090909090909;9.09090909090909;51990.9090909091;755.181818181818;68.3636363636364
52212;2023;2;2;0;100;0;159500;889;178
52213;2023;2;2;0;100;0;134750;1529.5;90.5
52214;2023;1;1;0;100;0;205000;1934;106
52218;2023;1;1;0;100;0;29000;483;60
52220;2023;1;1;0;100;0;81700;614;133
52221;2023;3;3;0;100;0;166333.333333333;1714.66666666667;100.666666666667
52222;2023;1;1;0;100;0;57055;2113;27
52227;2023;1;1;0;100;0;128000;1164;110
52229;2023;1;1;0;100;0;64100;577;111
52233;2023;1;1;0;100;0;55288;790;70
52234;2023;1;1;0;100;0;57000;712;80
52235;2023;3;3;0;100;0;52000;577;86.6666666666667
52237;2023;2;2;0;100;0;92500;890.5;103.5
52240;2023;1;1;0;100;0;190000;1845;103
52242;2023;18;18;0;100;0;116043.333333333;998;122.777777777778
52243;2023;1;1;0;100;0;210000;1167;180
52244;2023;2;2;0;100;0;88300;1002;91.5
52246;2023;3;3;0;100;0;72500;829;91
52247;2023;1;1;0;100;0;1,00E+05;800;125
52248;2023;8;8;0;100;0;91243.75;1045;91.25
52249;2023;1;1;0;100;0;171000;1879;91
52250;2023;28;25;3;89.2857142857143;10.7142857142857;98026.7857142857;1184.07142857143;89.3928571428571
52251;2023;7;7;0;100;0;191605.714285714;1595.42857142857;122
52253;2023;2;2;0;100;0;143440;1651;118
52256;2023;1;1;0;100;0;2,00E+05;2083;96
52258;2023;3;3;0;100;0;91726;671.333333333333;144.333333333333
52265;2023;20;20;0;100;0;114445;1183.6;99.55
52267;2023;3;3;0;100;0;136666.666666667;1211.66666666667;113
52269;2023;68;34;34;50;50;134481.764705882;1459.73529411765;96.8382352941177
52271;2023;1;1;0;100;0;50000;610;82
52272;2023;1;1;0;100;0;95000;819;116
52273;2023;2;2;0;100;0;93825;734;118.5
52274;2023;3;3;0;100;0;43333.3333333333;564.333333333333;84.6666666666667
52275;2023;1;1;0;100;0;60000;1000;60
52276;2023;1;1;0;100;0;110000;1196;92
52278;2023;1;1;0;100;0;150000;1154;130
52280;2023;2;2;0;100;0;276250;1827;149.5
52282;2023;1;1;0;100;0;220000;1325;166
52284;2023;1;1;0;100;0;128000;1488;86
52286;2023;2;2;0;100;0;83500;898;98
52287;2023;3;3;0;100;0;115666.666666667;777;160.666666666667
52289;2023;2;2;0;100;0;90585;916.5;99
52290;2023;1;1;0;100;0;90000;796;113
52291;2023;1;1;0;100;0;44000;500;88
52292;2023;2;2;0;100;0;96250;988.5;96
52294;2023;5;5;0;100;0;131890;1273;108
52297;2023;2;2;0;100;0;123544;1004;116
52298;2023;1;1;0;100;0;30000;462;65
52300;2023;1;1;0;100;0;157500;1500;105
52302;2023;2;2;0;100;0;95300;935;100
52303;2023;4;4;0;100;0;85330.5;1217.25;73.5
52304;2023;1;1;0;100;0;95000;1000;95
52305;2023;7;7;0;100;0;167017.857142857;1649.28571428571;98
52306;2023;4;4;0;100;0;97990;925.75;98.5
52307;2023;1;1;0;100;0;140000;946;148
52308;2023;2;2;0;100;0;164235;675.5;212.5
52310;2023;2;2;0;100;0;74420;443;168
52311;2023;4;4;0;100;0;52256.25;569.25;87.25
52313;2023;1;1;0;100;0;215000;1319;163
52315;2023;1;1;0;100;0;179550;1632;110
52318;2023;6;6;0;100;0;78282.5;741;100.5
52320;2023;3;3;0;100;0;80166.6666666667;811.333333333333;98
52321;2023;2;2;0;100;0;106900;925;109.5
52322;2023;1;1;0;100;0;60000;594;101
52327;2023;2;2;0;100;0;168000;1480.5;115
52330;2023;1;1;0;100;0;195550;1995;98
52331;2023;17;17;0;100;0;141355.882352941;1541.29411764706;94.7647058823529
52332;2023;13;13;0;100;0;100167.384615385;994.461538461538;104.230769230769
52335;2023;2;2;0;100;0;94500;935;98.5
52336;2023;1;1;0;100;0;170000;1717;99
52346;2023;3;3;0;100;0;91500;988;96
52347;2023;1;1;0;100;0;215000;1503;143
52348;2023;2;2;0;100;0;88600;825;113.5
52349;2023;4;4;0;100;0;181125;1366.5;128.25
52353;2023;35;29;6;82.8571428571429;17.1428571428571;94006.6571428571;1046.08571428571;87.6857142857143
52355;2023;2;2;0;100;0;88500;671.5;142.5
52357;2023;1;1;0;100;0;98015;1065;92
52358;2023;1;1;0;100;0;60400;711;85
52360;2023;4;4;0;100;0;576375;5309.75;97.5
52362;2023;1;1;0;100;0;245000;1485;165
52363;2023;1;1;0;100;0;66000;673;98
52365;2023;2;2;0;100;0;159530;1152;134
52366;2023;1;1;0;100;0;85000;654;130
52369;2023;1;1;0;100;0;180000;1978;91
52370;2023;1;1;0;100;0;74000;474;156
52371;2023;1;1;0;100;0;110000;932;118
52374;2023;2;2;0;100;0;131500;1213.5;127.5
52375;2023;1;1;0;100;0;87650;790;111
52376;2023;1;1;0;100;0;117000;1083;108
52377;2023;5;5;0;100;0;87940;756;114.6
52380;2023;1;1;0;100;0;151500;2047;74
52383;2023;10;10;0;100;0;112530.5;1339.6;85.7
52384;2023;2;1;1;50;50;80500;739.5;98
52386;2023;5;5;0;100;0;93800;855;103.2
52388;2023;2;2;0;100;0;34500;589.5;58
52390;2023;1;1;0;100;0;109475;897;122
52391;2023;4;4;0;100;0;156375;1821.25;93.25
52392;2023;2;2;0;100;0;72500;543.5;124.5
52393;2023;1;1;0;100;0;80000;842;95
52394;2023;4;4;0;100;0;196525;1366.75;149
52397;2023;2;2;0;100;0;46750;719.5;64.5
52398;2023;3;3;0;100;0;106753.333333333;1169.66666666667;90.3333333333333
52399;2023;3;3;0;100;0;100766.666666667;920.666666666667;109
52400;2023;1;1;0;100;0;53000;530;100
52401;2023;4;4;0;100;0;98125;1180.25;87.25
52405;2023;10;10;0;100;0;115269;1056;110.8
52406;2023;4;4;0;100;0;78125;654.25;125.25
52411;2023;17;17;0;100;0;121633.882352941;1043.17647058824;112.647058823529
52414;2023;5;5;0;100;0;148000;1731;91.6
52415;2023;1;1;0;100;0;145000;906;160
52419;2023;1;1;0;100;0;71000;763;93
52420;2023;1;1;0;100;0;32000;438;73
52421;2023;2;2;0;100;0;109250;1144.5;105.5
52422;2023;1;1;0;100;0;96000;444;216
52423;2023;2;2;0;100;0;81500;1226.5;67.5
52424;2023;2;2;0;100;0;94000;957;114.5
52425;2023;5;5;0;100;0;120746;1086.4;117.4
52426;2023;1;1;0;100;0;93000;1224;76
52429;2023;5;5;0;100;0;96000;964.4;106.2
52431;2023;2;2;0;100;0;45000;532;84.5
52432;2023;12;12;0;100;0;130165;1407.25;93.6666666666667
52433;2023;2;2;0;100;0;41500;515;80.5
52436;2023;1;1;0;100;0;279800;1782;157
52437;2023;1;1;0;100;0;110000;2200;50
52438;2023;1;1;0;100;0;70000;854;82
52439;2023;1;1;0;100;0;57000;588;97
52440;2023;1;1;0;100;0;51000;580;88
52442;2023;4;4;0;100;0;73250;707.5;112.25
52443;2023;2;2;0;100;0;104250;1151.5;84
52444;2023;1;1;0;100;0;125000;2049;61
52445;2023;1;1;0;100;0;160150;1430;112
52446;2023;3;3;0;100;0;50280.6666666667;667;72.3333333333333
52447;2023;1;1;0;100;0;172600;1984;87
52448;2023;218;131;87;60.091743119266;39.9082568807339;100879.591743119;1238.96788990826;81.3302752293578
52449;2023;9;9;0;100;0;167577.777777778;1428.77777777778;117.555555555556
52450;2023;1;1;0;100;0;70000;467;150
52455;2023;5;5;0;100;0;96800;1046.4;91.4
52456;2023;3;3;0;100;0;122433.333333333;1177.33333333333;98.6666666666667
52461;2023;6;6;0;100;0;97350;1205.83333333333;94
52463;2023;1;1;0;100;0;50000;581;86
52467;2023;2;2;0;100;0;43000;516.5;82.5
52468;2023;1;1;0;100;0;35000;461;76
52469;2023;2;1;1;50;50;124250;1139;119
52470;2023;5;5;0;100;0;149140;983.4;131.6
52472;2023;3;3;0;100;0;158216.666666667;1043;172
52474;2023;1;1;0;100;0;35000;583;60
52479;2023;1;1;0;100;0;32000;667;48
52480;2023;2;2;0;100;0;121000;1425;98.5
52482;2023;1;1;0;100;0;124455;1556;80
52484;2023;2;2;0;100;0;150000;1487;100
52487;2023;1;1;0;100;0;82500;494;167
52488;2023;1;1;0;100;0;66000;559;118
52490;2023;6;6;0;100;0;63750;731.833333333333;89.5
52491;2023;1;1;0;100;0;75000;765;98
52492;2023;3;3;0;100;0;167866.666666667;1370.33333333333;119.666666666667
52493;2023;1;1;0;100;0;28900;482;60
52494;2023;1;1;0;100;0;189500;1914;99
52495;2023;2;2;0;100;0;93420;652.5;154
52497;2023;3;3;0;100;0;83000;772;108.666666666667
52500;2023;6;6;0;100;0;177766.666666667;1540.16666666667;116
52504;2023;4;4;0;100;0;84190;1106;77.25
52510;2023;5;5;0;100;0;99342;1005.6;96
52512;2023;2;2;0;100;0;54700;793;69
52513;2023;2;2;0;100;0;47000;736.5;66.5
52514;2023;1;1;0;100;0;153000;1515;101
52517;2023;3;3;0;100;0;96633.3333333333;674.666666666667;137.666666666667
52519;2023;1;1;0;100;0;77000;895;86
52520;2023;4;4;0;100;0;58785.5;531.5;108
52524;2023;3;3;0;100;0;51786.6666666667;771;66.6666666666667
52526;2023;2;2;0;100;0;60000;478;125.5
52528;2023;1;1;0;100;0;42000;700;60
52529;2023;11;11;0;100;0;129718.181818182;1199.81818181818;115.818181818182
52534;2023;16;16;0;100;0;114500.625;1318;89.8125
52535;2023;8;8;0;100;0;114561.25;1424.875;79.625
52538;2023;3;3;0;100;0;125333.333333333;1071.33333333333;115.333333333333
52539;2023;2;2;0;100;0;69345;655;109.5
52541;2023;2;2;0;100;0;201550;1326.5;150.5
52543;2023;1;1;0;100;0;120000;1644;73
52544;2023;4;4;0;100;0;87375;1119.25;74.5
52545;2023;1;1;0;100;0;105000;2188;48
52550;2023;20;20;0;100;0;109612;1148.2;97.75
53001;2023;18;18;0;100;0;174400;1818.61111111111;97.7777777777778
53002;2023;3;3;0;100;0;146000;1290.33333333333;107
53003;2023;33;32;1;96.969696969697;3.03030303030303;95464.3636363636;1066.54545454545;87.3939393939394
53005;2023;23;23;0;100;0;160830.434782609;1608.34782608696;98.9130434782609
53007;2023;21;21;0;100;0;200991.428571429;1849.90476190476;109
53008;2023;23;23;0;100;0;164325;1603.13043478261;102.869565217391
53009;2023;8;8;0;100;0;182730;1658;113.125
53010;2023;6;6;0;100;0;114726.666666667;1179.83333333333;111
53011;2023;7;7;0;100;0;167655.714285714;1574.71428571429;106.571428571429
53012;2023;4;4;0;100;0;133250;1220.5;107
53013;2023;8;8;0;100;0;73047.375;1041.375;83.875
53015;2023;17;17;0;100;0;146905.941176471;1523.47058823529;101
53016;2023;12;12;0;100;0;102083.333333333;1333.58333333333;76.4166666666667
53017;2023;19;19;0;100;0;126502.894736842;1244.78947368421;107.947368421053
53018;2023;11;11;0;100;0;133520.909090909;1559.36363636364;82.9090909090909
53019;2023;1;1;0;100;0;95076;1056;90
53021;2023;11;11;0;100;0;210568.272727273;1892.36363636364;113.636363636364
53022;2023;4;4;0;100;0;175000;1133;145.5
53023;2023;3;3;0;100;0;120895;1215.33333333333;96.6666666666667
53025;2023;9;9;0;100;0;119185.888888889;1453.66666666667;89.7777777777778
53026;2023;10;10;0;100;0;123657.4;1475.7;82.1
53027;2023;4;4;0;100;0;116000;1257.75;92.5
53028;2023;3;3;0;100;0;101683.333333333;877.333333333333;124
53029;2023;14;14;0;100;0;137521.428571429;1192.64285714286;112.071428571429
53030;2023;1;1;0;100;0;48900;699;70
53031;2023;10;10;0;100;0;147548.3;1603.5;93.3
53034;2023;68;67;1;98.5294117647059;1.47058823529412;229332.735294118;2295.23529411765;103.823529411765
53035;2023;9;9;0;100;0;150530;1808.11111111111;91
53036;2023;8;8;0;100;0;117875;1486.625;93.875
53037;2023;8;8;0;100;0;112500;1324.875;82.25
53038;2023;1;1;0;100;0;80000;3200;25
53039;2023;15;14;1;93.3333333333333;6.66666666666667;167960;1717.93333333333;99.8
53040;2023;9;9;0;100;0;119777.777777778;1481;81.7777777777778
53041;2023;5;5;0;100;0;176226.4;1298;161.8
53042;2023;17;17;0;100;0;117247.647058824;1173.47058823529;107.882352941176
53043;2023;6;6;0;100;0;120457.333333333;1163;106
53045;2023;6;6;0;100;0;166433.333333333;1489.33333333333;113.166666666667
53046;2023;2;2;0;100;0;74250;990.5;67
53047;2023;9;9;0;100;0;68666.6666666667;794.444444444444;83.1111111111111
53048;2023;12;11;1;91.6666666666667;8.33333333333333;111645.833333333;1399.41666666667;86.5
53049;2023;2;2;0;100;0;191250;1607;113.5
53051;2023;9;9;0;100;0;108928.777777778;1191.66666666667;94.7777777777778
53052;2023;2;2;0;100;0;104825;1355.5;72.5
53053;2023;7;7;0;100;0;127757.142857143;1096.14285714286;115.285714285714
53054;2023;68;62;6;91.1764705882353;8.82352941176471;250492.794117647;2508.07352941176;108.382352941176
53055;2023;11;10;1;90.9090909090909;9.09090909090909;85469.9090909091;1169.54545454545;77.9090909090909
53056;2023;10;10;0;100;0;183476.3;1773.2;104.7
53057;2023;5;5;0;100;0;95030;1037.8;98.6
53058;2023;4;4;0;100;0;167146.75;1367.5;124.75
53059;2023;3;3;0;100;0;166800;1363.33333333333;126
53061;2023;8;8;0;100;0;68000;850.75;82.625
53062;2023;211;187;24;88.6255924170616;11.3744075829384;167875.142180095;1867.15639810427;91.4644549763033
53063;2023;4;4;0;100;0;95000;1419;63.5
53064;2023;13;13;0;100;0;114670.769230769;1428.61538461538;87.9230769230769
53066;2023;25;25;0;100;0;198223.8;1868.36;105.4
53067;2023;6;6;0;100;0;123258.333333333;1193.66666666667;97
53068;2023;4;4;0;100;0;73250;1445.75;60.5
53069;2023;5;5;0;100;0;50964;723.8;73.8
53071;2023;7;7;0;100;0;136152.857142857;1097.14285714286;118.142857142857
53072;2023;10;10;0;100;0;127432.5;1416.5;93.1
53073;2023;11;11;0;100;0;143100;1420.63636363636;102.636363636364
53074;2023;3;3;0;100;0;117133.333333333;1195;94.6666666666667
53075;2023;3;3;0;100;0;99666.6666666667;901.666666666667;110.333333333333
53076;2023;6;6;0;100;0;160416.666666667;1192.66666666667;136.166666666667
53077;2023;33;32;1;96.969696969697;3.03030303030303;152404.212121212;1621.30303030303;91.9393939393939
53078;2023;6;6;0;100;0;194000;1502.66666666667;133.333333333333
53079;2023;9;9;0;100;0;75611.1111111111;829.333333333333;91.6666666666667
53080;2023;4;4;0;100;0;122500;927.5;113.75
53082;2023;2;2;0;100;0;201500;1581;130.5
53083;2023;6;6;0;100;0;111187.166666667;996.833333333333;105.166666666667
53084;2023;72;69;3;95.8333333333333;4.16666666666667;146676.152777778;1525.51388888889;96
53086;2023;6;6;0;100;0;124628.333333333;1617.16666666667;72.6666666666667
53087;2023;3;3;0;100;0;142606.666666667;1177;131
53088;2023;13;13;0;100;0;149870.384615385;1346.61538461538;114.769230769231
53089;2023;8;8;0;100;0;155562.5;1459.5;106.625
53091;2023;15;15;0;100;0;76126.6666666667;959.4;87
53093;2023;2;2;0;100;0;80915;987;94.5
53094;2023;18;18;0;100;0;178056.944444444;2111;85.0555555555556
53096;2023;77;74;3;96.1038961038961;3.8961038961039;111374.87012987;1249.64935064935;90.4285714285714
53097;2023;107;97;10;90.6542056074766;9.34579439252336;137540.112149533;1649.21495327103;88.1869158878505
53098;2023;6;6;0;100;0;96000;1011;100.333333333333
53099;2023;15;15;0;100;0;180633.333333333;1611.4;107.866666666667
53100;2023;27;27;0;100;0;118398.407407407;1083.77777777778;109.074074074074
53101;2023;10;10;0;100;0;163259;1689;95.5
53102;2023;1;1;0;100;0;83000;1038;80
53103;2023;26;26;0;100;0;156054.346153846;1825.80769230769;86.8846153846154
53104;2023;12;12;0;100;0;145333.333333333;1668.75;91.25
53105;2023;3;3;0;100;0;151666.666666667;1405.33333333333;119.333333333333
53106;2023;7;7;0;100;0;119021.428571429;1277.85714285714;86.8571428571429
53107;2023;44;41;3;93.1818181818182;6.81818181818182;104283.75;1114.52272727273;92.7272727272727
53108;2023;8;8;0;100;0;169050;1371.625;126.25
53109;2023;5;5;0;100;0;103081.8;966;104
53110;2023;8;8;0;100;0;142087.5;1354.125;115.875
53111;2023;3;3;0;100;0;151700.666666667;1246;112.333333333333
53112;2023;8;8;0;100;0;73052.5;919.875;72.375
53113;2023;14;14;0;100;0;95560.7142857143;1267.35714285714;80.2857142857143
53114;2023;2;2;0;100;0;79000;749.5;106
53115;2023;4;4;0;100;0;100218.75;1533.5;71.5
53116;2023;15;15;0;100;0;103099;1224.26666666667;84.4666666666667
53117;2023;7;7;0;100;0;155752.857142857;1782.42857142857;88.2857142857143
53118;2023;5;5;0;100;0;77000;1007.6;76.8
53119;2023;33;33;0;100;0;222427.121212121;2280.78787878788;102.545454545455
53120;2023;7;7;0;100;0;111428.571428571;1274;91.8571428571429
53121;2023;9;9;0;100;0;93652.2222222222;1006.77777777778;92.7777777777778
53122;2023;13;13;0;100;0;128793.153846154;1181.92307692308;106
53123;2023;22;22;0;100;0;137815.909090909;1680.86363636364;101.545454545455
53124;2023;12;12;0;100;0;168397.583333333;1487.08333333333;111.75
53125;2023;18;18;0;100;0;121207.277777778;1462.77777777778;87.6666666666667
53126;2023;15;14;1;93.3333333333333;6.66666666666667;101250;1085.93333333333;92.1333333333333
53127;2023;32;32;0;100;0;139643.21875;1292.125;114.65625
53128;2023;4;4;0;100;0;147497.5;1625.75;94
53129;2023;3;3;0;100;0;199666.666666667;1729;120
53130;2023;742;344;398;46.3611859838275;53.6388140161725;168293.551212938;2252.33018867925;76.3652291105121
53131;2023;2;2;0;100;0;48705;808;60
53132;2023;2;2;0;100;0;47050;1003;50
53133;2023;14;14;0;100;0;105017.714285714;1254.57142857143;86.8571428571429
53134;2023;4;4;0;100;0;133250;1583.5;86
53135;2023;16;16;0;100;0;121417.125;1135.75;102.4375
53136;2023;11;11;0;100;0;180000;1715.09090909091;109.545454545455
53137;2023;17;16;1;94.1176470588235;5.88235294117647;134820.588235294;1443;92.9411764705882
53139;2023;4;4;0;100;0;116337.5;1136;107.25
53140;2023;42;39;3;92.8571428571429;7.14285714285714;193665.380952381;1966.59523809524;97.1666666666667
53141;2023;12;12;0;100;0;152784.833333333;1547.25;98.4166666666667
53142;2023;5;5;0;100;0;134080;1190.4;110.2
53143;2023;4;4;0;100;0;135750;1632.25;80.75
53144;2023;10;10;0;100;0;109695;1188.7;91
53145;2023;2;2;0;100;0;116000;1071.5;110
53146;2023;22;22;0;100;0;204207.681818182;1881.27272727273;109.5
53147;2023;166;128;38;77.1084337349398;22.8915662650602;141179.897590361;1596.81927710843;90.4518072289157
53148;2023;3;3;0;100;0;135666.666666667;1225.33333333333;122.333333333333
53150;2023;10;10;0;100;0;194210;1736.1;118.6
53151;2023;9;9;0;100;0;133561.333333333;1197.44444444444;117.111111111111
53152;2023;28;25;3;89.2857142857143;10.7142857142857;125629.642857143;1602.17857142857;79.3214285714286
53153;2023;7;7;0;100;0;198276.857142857;2882.71428571429;90.5714285714286
53154;2023;13;13;0;100;0;90200;998.230769230769;88.8461538461538
53155;2023;11;11;0;100;0;126363.636363636;1110.63636363636;107.454545454545
53156;2023;4;4;0;100;0;177750;1820;99.75
53157;2023;8;8;0;100;0;201530;1796.5;114.25
53158;2023;13;13;0;100;0;132923.076923077;1399.84615384615;94.5384615384615
53160;2023;5;5;0;100;0;86400;1797;81.6
53161;2023;45;44;1;97.7777777777778;2.22222222222222;124424.044444444;1381.44444444444;87.2
53162;2023;12;11;1;91.6666666666667;8.33333333333333;152737.5;1718.33333333333;95.0833333333333
53163;2023;8;8;0;100;0;140025;1311.375;101.25
53164;2023;4;4;0;100;0;68750;857.5;71.5
53165;2023;4;4;0;100;0;160000;1289.25;123.5
53168;2023;11;11;0;100;0;179819.090909091;1930.54545454545;96.8181818181818
53169;2023;3;3;0;100;0;122833.333333333;1445.66666666667;86.6666666666667
53170;2023;12;12;0;100;0;88233.3333333333;1103.08333333333;79.1666666666667
53172;2023;3;3;0;100;0;233333.333333333;1234.66666666667;190
53173;2023;3;3;0;100;0;133333.333333333;1289.66666666667;105.333333333333
53174;2023;5;5;0;100;0;157430;1475.8;102.8
53175;2023;12;12;0;100;0;208554.166666667;1947.33333333333;105.583333333333
53176;2023;12;12;0;100;0;110344;1070;111.666666666667
53177;2023;2;2;0;100;0;140000;1178;115
53179;2023;9;9;0;100;0;96800;1210;81.7777777777778
53180;2023;10;10;0;100;0;119600;1267.2;104.4
53181;2023;15;15;0;100;0;106473.333333333;1233.93333333333;87.0666666666667
53182;2023;34;33;1;97.0588235294118;2.94117647058824;135340.588235294;1565.5;84.2352941176471
53184;2023;2;2;0;100;0;209000;1106.5;225.5
53185;2023;43;43;0;100;0;106190.697674419;1089.46511627907;94.8837209302326
53186;2023;30;30;0;100;0;168731.833333333;1837.7;96.5666666666667
53187;2023;4;4;0;100;0;202862;1181.75;163.5
53188;2023;38;37;1;97.3684210526316;2.63157894736842;121789.473684211;1308.5;94.6052631578947
53190;2023;11;11;0;100;0;104181.818181818;1096.54545454545;90
53191;2023;3;3;0;100;0;118333.333333333;1457.66666666667;82.3333333333333
53192;2023;4;4;0;100;0;123375;1475;76
53193;2023;9;9;0;100;0;147222.222222222;1135.77777777778;116.444444444444
53195;2023;10;10;0;100;0;201985;1600;130.8
53196;2023;7;7;0;100;0;101482.857142857;1195.85714285714;89.7142857142857
53197;2023;13;13;0;100;0;101469.230769231;1163.30769230769;94.5384615384615
53198;2023;10;10;0;100;0;145306.4;1303.4;112.4
53199;2023;5;5;0;100;0;142960;1222.8;145.2
53200;2023;10;10;0;100;0;206966.5;1823.3;111.2
53201;2023;95;85;10;89.4736842105263;10.5263157894737;205147.694736842;2204.25263157895;94.6736842105263
53202;2023;11;11;0;100;0;109363.636363636;1171.36363636364;89.1818181818182
53203;2023;2;2;0;100;0;79000;811;99
53204;2023;7;7;0;100;0;106692.857142857;933.714285714286;121.714285714286
53206;2023;2;2;0;100;0;150000;1158;129.5
53208;2023;7;7;0;100;0;85214.2857142857;993.428571428571;91.4285714285714
53209;2023;9;9;0;100;0;113833.333333333;1322.88888888889;90.6666666666667
53210;2023;22;21;1;95.4545454545455;4.54545454545455;120100.681818182;1280.27272727273;99.1818181818182
53211;2023;31;31;0;100;0;115604.483870968;1153.12903225806;101.612903225806
53212;2023;4;4;0;100;0;192500;1340.25;136
53213;2023;7;7;0;100;0;165053.571428571;1870.85714285714;89.2857142857143
53214;2023;4;4;0;100;0;111765;1409;76.75
53216;2023;10;10;0;100;0;143950;1343;101.1
53218;2023;10;10;0;100;0;180660;2259.7;85.5
53219;2023;12;11;1;91.6666666666667;8.33333333333333;102908.333333333;1218.58333333333;80.8333333333333
53220;2023;5;5;0;100;0;132500;1190.4;113.6
53221;2023;6;6;0;100;0;65833.3333333333;886;73
53222;2023;3;3;0;100;0;147316.666666667;1554.33333333333;93.3333333333333
53223;2023;5;5;0;100;0;118640;1211.8;99.4
53224;2023;11;11;0;100;0;158246.363636364;1532;100.090909090909
53225;2023;3;3;0;100;0;118000;1145.33333333333;109
53226;2023;13;13;0;100;0;110884.615384615;1401.84615384615;80.4615384615385
53228;2023;10;10;0;100;0;101745;1113.2;95.3
53229;2023;16;16;0;100;0;175625;1683.8125;103.25
53230;2023;2;2;0;100;0;183380;1707.5;116
53232;2023;4;4;0;100;0;236625;3400.5;95.25
53233;2023;4;4;0;100;0;120725;1292.5;87
53234;2023;5;5;0;100;0;113500;1042.6;114.2
53235;2023;3;3;0;100;0;309023.333333333;2315.66666666667;124.666666666667
53236;2023;6;6;0;100;0;104166.666666667;1497.83333333333;93.6666666666667
53237;2023;7;7;0;100;0;114405.857142857;1500.57142857143;79
53238;2023;10;10;0;100;0;127483;1355.6;105.4
53240;2023;5;5;0;100;0;104400;1182.2;93.6
53242;2023;1;1;0;100;0;137000;2978;46
53243;2023;12;12;0;100;0;204616.666666667;1741.5;116.166666666667
53245;2023;17;17;0;100;0;116322;1358.58823529412;95
53246;2023;18;18;0;100;0;137622.222222222;1546.44444444444;87.8888888888889
53247;2023;22;21;1;95.4545454545455;4.54545454545455;171261.363636364;1688.59090909091;103.681818181818
53248;2023;2;2;0;100;0;186625;1988;104.5
53249;2023;19;19;0;100;0;101738.052631579;1014.05263157895;98.8421052631579
53250;2023;8;8;0;100;0;115040.5;1106.25;101.375
53251;2023;3;3;0;100;0;120389;1249.33333333333;98
53253;2023;2;2;0;100;0;121000;1264;97
53255;2023;10;10;0;100;0;118400;1314.1;93.4
53256;2023;4;4;0;100;0;71700;1167.75;64.25
53257;2023;5;4;1;80;20;140018;1011.8;131
53258;2023;11;11;0;100;0;100236.363636364;1036.90909090909;97.1818181818182
53259;2023;10;10;0;100;0;115850;1311.3;94.5
53260;2023;5;5;0;100;0;137448;1639.4;84.6
53261;2023;2;2;0;100;0;66300;952;69.5
53262;2023;10;10;0;100;0;157700;1647;100.6
53263;2023;7;7;0;100;0;85292.8571428571;1200.71428571429;72.5714285714286
53264;2023;2;2;0;100;0;131000;1349.5;95.5
53265;2023;11;11;0;100;0;110204.545454545;1077;97.3636363636364
53266;2023;1;1;0;100;0;20000;667;30
53267;2023;11;11;0;100;0;151000;1511.36363636364;105.090909090909
53269;2023;10;10;0;100;0;140699.5;1357.2;118.7
53271;2023;37;32;5;86.4864864864865;13.5135135135135;97734.3243243243;1171.89189189189;88.5405405405405
53272;2023;6;6;0;100;0;130650;1075.5;137.5
53273;2023;12;12;0;100;0;182283.333333333;1707.33333333333;100
53276;2023;9;9;0;100;0;126242.222222222;1154.77777777778;98.7777777777778
54001;2023;1;1;0;100;0;142000;1775;80
54002;2023;4;4;0;100;0;183476.25;1614;109.5
54004;2023;1;1;0;100;0;273600;1668;164
54006;2023;4;2;2;50;50;256612.5;2353.75;113.5
54007;2023;6;6;0;100;0;190508.333333333;1558.16666666667;122.333333333333
54008;2023;3;3;0;100;0;177416.666666667;1591.33333333333;106.666666666667
54010;2023;7;7;0;100;0;153592.857142857;1235.42857142857;136.571428571429
54011;2023;2;1;1;50;50;228600;1851.5;121
54012;2023;5;4;1;80;20;261180;2119;149.8
54014;2023;2;2;0;100;0;145725;1271.5;112.5
54015;2023;7;7;0;100;0;130602;1359.28571428571;109.714285714286
54016;2023;1;1;0;100;0;1,00E+05;1053;95
54018;2023;1;1;0;100;0;230000;1917;120
54020;2023;5;5;0;100;0;120110;1632.6;83.8
54021;2023;4;3;1;75;25;223550;4695.75;85
54022;2023;11;11;0;100;0;218285.454545455;1658.81818181818;134
54023;2023;1;1;0;100;0;51000;680;75
54024;2023;4;4;0;100;0;164612.5;1257;125.75
54025;2023;15;13;2;86.6666666666667;13.3333333333333;225957.333333333;2237.33333333333;107.266666666667
54026;2023;3;3;0;100;0;98516.6666666667;1292;82
54027;2023;4;4;0;100;0;212400;2153;99
54028;2023;51;29;22;56.8627450980392;43.1372549019608;118688.176470588;1481.01960784314;81.3137254901961
54029;2023;32;23;9;71.875;28.125;221596.96875;2251.96875;98.46875
54030;2023;2;2;0;100;0;60000;648;86.5
54031;2023;1;1;0;100;0;145000;1074;135
54032;2023;4;4;0;100;0;236312.5;2140.5;112.25
54033;2023;1;0;1;0;100;150000;824;182
54034;2023;1;1;0;100;0;216600;1969;110
54035;2023;2;2;0;100;0;82250;1055.5;71.5
54036;2023;4;4;0;100;0;399150;2519;153.75
54037;2023;2;2;0;100;0;174000;2241.5;77
54038;2023;14;14;0;100;0;166171.428571429;1507.07142857143;115.357142857143
54039;2023;53;30;23;56.6037735849057;43.3962264150943;118770.566037736;1235.69811320755;93.4905660377358
54040;2023;21;19;2;90.4761904761905;9.52380952380952;80205.7142857143;1057.14285714286;81.8571428571429
54041;2023;1;1;0;100;0;255000;1700;150
54042;2023;5;5;0;100;0;109624;856;147.8
54043;2023;12;9;3;75;25;191334.25;1696.83333333333;111.5
54044;2023;3;3;0;100;0;152300;1253;119
54045;2023;6;5;1;83.3333333333333;16.6666666666667;222283.333333333;2156.5;110
54046;2023;5;4;1;80;20;167300;1471.4;125
54047;2023;6;6;0;100;0;102816.666666667;1086;93.1666666666667
54048;2023;2;1;1;50;50;226000;1617;128.5
54049;2023;10;10;0;100;0;155086;1948.9;82.2
54051;2023;10;10;0;100;0;158500;1642.4;99.1
54052;2023;1;1;0;100;0;101000;571;177
54053;2023;2;2;0;100;0;147000;956.5;158
54054;2023;17;17;0;100;0;187294.117647059;1673.88235294118;113.529411764706
54055;2023;5;5;0;100;0;212694;1997.4;124.8
54056;2023;3;2;1;66.6666666666667;33.3333333333333;164266.666666667;1378;112.333333333333
54057;2023;1;1;0;100;0;220920;1699;130
54059;2023;9;9;0;100;0;202666.666666667;1898.33333333333;105.666666666667
54060;2023;22;21;1;95.4545454545455;4.54545454545455;197568.454545455;1973.86363636364;98.8636363636364
54061;2023;7;7;0;100;0;169357.142857143;1633.28571428571;104.142857142857
54062;2023;2;2;0;100;0;223000;1629;145.5
54063;2023;1;1;0;100;0;1,00E+05;971;103
54064;2023;3;3;0;100;0;69866.6666666667;583.333333333333;130
54065;2023;12;12;0;100;0;146794.166666667;1290.16666666667;111.916666666667
54066;2023;3;3;0;100;0;195266.666666667;1925.33333333333;101
54067;2023;6;6;0;100;0;264161.666666667;2819.5;93
54068;2023;2;2;0;100;0;116500;877;147
54069;2023;5;5;0;100;0;389000;2775;143.2
54070;2023;3;3;0;100;0;440733.333333333;2284.66666666667;192.333333333333
54071;2023;3;3;0;100;0;155416.666666667;1262;121.333333333333
54072;2023;2;2;0;100;0;275725;2232.5;120.5
54073;2023;7;7;0;100;0;122352.857142857;1377;88.8571428571429
54075;2023;4;4;0;100;0;159000;1528.25;105.75
54076;2023;28;26;2;92.8571428571429;7.14285714285714;173763.571428571;1830.25;93.9285714285714
54077;2023;6;5;1;83.3333333333333;16.6666666666667;79916.6666666667;816.166666666667;96.6666666666667
54079;2023;40;29;11;72.5;27.5;172584.5;2057.8;87.625
54080;2023;9;9;0;100;0;153011.111111111;1625.88888888889;96
54081;2023;4;3;1;75;25;193542.5;2282.25;86.75
54082;2023;1;1;0;100;0;185000;1276;145
54083;2023;2;2;0;100;0;161950;1175.5;133
54084;2023;14;14;0;100;0;135788.642857143;1522.71428571429;88.5714285714286
54085;2023;1;1;0;100;0;222000;1291;172
54086;2023;4;4;0;100;0;90000;928.5;98.5
54088;2023;3;3;0;100;0;96733.3333333333;1177;88
54089;2023;16;16;0;100;0;267660.625;2143.4375;124.4375
54090;2023;44;39;5;88.6363636363636;11.3636363636364;214020.909090909;2332.90909090909;93.5
54091;2023;2;2;0;100;0;249000;2343;107
54093;2023;2;2;0;100;0;117000;939;123.5
54094;2023;2;2;0;100;0;159750;1431.5;112
54095;2023;1;1;0;100;0;291000;1265;230
54096;2023;4;4;0;100;0;324962.5;2984.5;111.5
54098;2023;2;2;0;100;0;164850;1681;100
54099;2023;110;67;43;60.9090909090909;39.0909090909091;142546.781818182;1574.7;89.9090909090909
54100;2023;6;6;0;100;0;176566.666666667;1996.66666666667;89.1666666666667
54102;2023;3;3;0;100;0;198833.333333333;1465;145.666666666667
54103;2023;2;2;0;100;0;121250;1052.5;112.5
54104;2023;1;1;0;100;0;257000;1932;133
54105;2023;10;10;0;100;0;139716;1338.3;113.2
54108;2023;4;4;0;100;0;200825;1951;98
54109;2023;8;8;0;100;0;234895;2186.5;105.5
54110;2023;3;3;0;100;0;154000;1455.66666666667;119.666666666667
54111;2023;25;21;4;84;16;153612.8;1863.44;82.16
54112;2023;9;9;0;100;0;182628.222222222;1566.55555555556;132.111111111111
54113;2023;14;12;2;85.7142857142857;14.2857142857143;208079.285714286;2445.85714285714;93.0714285714286
54114;2023;5;5;0;100;0;175560;1991;90.6
54115;2023;71;37;34;52.112676056338;47.887323943662;155012.943661972;1883.29577464789;80.7605633802817
54116;2023;15;14;1;93.3333333333333;6.66666666666667;191868.8;1794.6;110.533333333333
54118;2023;7;6;1;85.7142857142857;14.2857142857143;124392.857142857;1448.14285714286;109
54119;2023;1;1;0;100;0;208600;1738;120
54120;2023;1;1;0;100;0;109800;722;152
54121;2023;2;2;0;100;0;159500;1079.5;146.5
54122;2023;9;9;0;100;0;250124.444444444;1983.11111111111;127.333333333333
54123;2023;25;22;3;88;12;192351.2;2105.52;93.56
54125;2023;5;5;0;100;0;210010;1919.6;102.4
54126;2023;2;2;0;100;0;127000;1462.5;87
54127;2023;9;8;1;88.8888888888889;11.1111111111111;330847.777777778;2549.55555555556;133.444444444444
54128;2023;9;9;0;100;0;162011.111111111;1836.11111111111;94.8888888888889
54129;2023;15;14;1;93.3333333333333;6.66666666666667;80730;861.533333333333;90.6666666666667
54130;2023;1;1;0;100;0;134000;838;160
54131;2023;2;2;0;100;0;145925;773;175.5
54133;2023;1;1;0;100;0;159000;612;260
54134;2023;3;3;0;100;0;178633.333333333;1133;156
54135;2023;6;5;1;83.3333333333333;16.6666666666667;138125;1770.66666666667;89.6666666666667
54136;2023;39;33;6;84.6153846153846;15.3846153846154;158958.717948718;1831.92307692308;86.8974358974359
54137;2023;5;3;2;60;40;138113.4;1290;109.2
54138;2023;23;15;8;65.2173913043478;34.7826086956522;244422.217391304;2422.17391304348;104.739130434783
54139;2023;2;1;1;50;50;191500;1726;112
54141;2023;2;2;0;100;0;127500;1241;100.5
54143;2023;3;2;1;66.6666666666667;33.3333333333333;147566.666666667;1152.66666666667;138.333333333333
54144;2023;2;2;0;100;0;268500;2206.5;121.5
54145;2023;6;6;0;100;0;202958.333333333;1647.33333333333;133.333333333333
54146;2023;1;1;0;100;0;313500;2010;156
54148;2023;4;3;1;75;25;163000;1495;112.75
54149;2023;30;29;1;96.6666666666667;3.33333333333333;207989.4;2530.56666666667;88.4333333333333
54150;2023;28;25;3;89.2857142857143;10.7142857142857;202543.285714286;2147.92857142857;96.7857142857143
54151;2023;10;10;0;100;0;302481;2364.9;131.7
54152;2023;22;20;2;90.9090909090909;9.09090909090909;168843.636363636;1697.40909090909;98.8636363636364
54153;2023;1;1;0;100;0;105000;1154;91
54154;2023;4;4;0;100;0;72497.5;751.75;99.5
54155;2023;4;4;0;100;0;181275;1598.5;115.75
54156;2023;9;9;0;100;0;125444.444444444;1085.88888888889;118.444444444444
54157;2023;48;42;6;87.5;12.5;153574.583333333;1840.16666666667;90.375
54158;2023;2;2;0;100;0;132500;839.5;148
54159;2023;79;72;7;91.1392405063291;8.86075949367089;180873.164556962;1889.6835443038;98.0253164556962
54160;2023;3;3;0;100;0;233466.666666667;1766.33333333333;133
54162;2023;17;16;1;94.1176470588235;5.88235294117647;174075;1606.35294117647;108.117647058824
54163;2023;3;3;0;100;0;157553.333333333;1234.33333333333;136
54164;2023;1;1;0;100;0;105000;700;150
54165;2023;10;10;0;100;0;422814;3169.7;127.9
54166;2023;1;1;0;100;0;30000;469;64
54167;2023;22;15;7;68.1818181818182;31.8181818181818;157117.727272727;1498.18181818182;101.590909090909
54171;2023;7;7;0;100;0;209387.142857143;2298.28571428571;90.8571428571429
54172;2023;3;3;0;100;0;256533.333333333;1836.33333333333;134
54173;2023;2;2;0;100;0;108000;1244;91
54174;2023;38;22;16;57.8947368421053;42.1052631578947;142217.289473684;1681.71052631579;82.7631578947368
54175;2023;5;5;0;100;0;163440;1756.2;92.6
54176;2023;13;12;1;92.3076923076923;7.69230769230769;105850.307692308;1094.07692307692;100.846153846154
54177;2023;1;1;0;100;0;171000;1660;103
54178;2023;1;1;0;100;0;90000;1200;75
54179;2023;3;3;0;100;0;184983.333333333;1225.66666666667;159
54181;2023;8;8;0;100;0;316044.875;2806.25;110.75
54182;2023;1;1;0;100;0;65800;833;79
54184;2023;137;53;84;38.6861313868613;61.3138686131387;165373.605839416;2088.97810218978;78.5766423357664
54185;2023;3;3;0;100;0;187800;1622;121.666666666667
54186;2023;18;18;0;100;0;316924.5;2497.66666666667;136.833333333333
54188;2023;6;5;1;83.3333333333333;16.6666666666667;210750;2292;91.6666666666667
54189;2023;8;8;0;100;0;162225;1310.875;134.5
54190;2023;2;2;0;100;0;93075;492.5;188
54191;2023;1;1;0;100;0;99000;990;100
54192;2023;3;3;0;100;0;230466.666666667;2063.33333333333;110
54193;2023;1;1;0;100;0;170000;1181;144
54194;2023;8;7;1;87.5;12.5;241593.75;2211.875;109
54195;2023;1;1;0;100;0;1,00E+05;1053;95
54196;2023;15;12;3;80;20;239856.666666667;2274.86666666667;115.066666666667
54197;2023;15;15;0;100;0;294063.333333333;2751;108.4
54199;2023;1;1;0;100;0;110000;1571;70
54200;2023;2;2;0;100;0;158550;1204.5;131.5
54201;2023;2;2;0;100;0;77825;831;87
54202;2023;4;4;0;100;0;113712.5;1338.75;94.25
54203;2023;2;2;0;100;0;118700;1398.5;81
54204;2023;1;1;0;100;0;56000;467;120
54205;2023;39;33;6;84.6153846153846;15.3846153846154;124394.487179487;1338.58974358974;95.9230769230769
54206;2023;3;3;0;100;0;104743.333333333;1132.33333333333;90.6666666666667
54207;2023;1;0;1;0;100;52250;630;83
54208;2023;3;3;0;100;0;133103.333333333;1930;76.6666666666667
54210;2023;2;2;0;100;0;100750;926;108
54211;2023;4;4;0;100;0;122475;963.5;123
54212;2023;4;4;0;100;0;225500;2248.75;102.5
54213;2023;9;8;1;88.8888888888889;11.1111111111111;126040.111111111;1337.88888888889;95
54214;2023;5;5;0;100;0;229632;1779.4;130.6
54215;2023;77;54;23;70.1298701298701;29.8701298701299;163162.467532468;1954.77922077922;83.4155844155844
54217;2023;1;1;0;100;0;45000;600;75
54222;2023;20;20;0;100;0;112820;1298.5;88.85
54223;2023;1;1;0;100;0;63000;875;72
54224;2023;3;3;0;100;0;147833.333333333;1365.33333333333;107.333333333333
54225;2023;3;3;0;100;0;116750;998.666666666667;114.666666666667
54226;2023;1;1;0;100;0;88000;595;148
54227;2023;20;20;0;100;0;151889;1733.3;87.8
54229;2023;7;7;0;100;0;182200;1136;141.571428571429
54230;2023;2;2;0;100;0;66635;614.5;105
54231;2023;4;4;0;100;0;202171.25;1628;105.25
54232;2023;20;18;2;90;10;262384.35;2080.7;125.5
54234;2023;27;22;5;81.4814814814815;18.5185185185185;217277.407407407;2605.92592592593;85.8518518518518
54235;2023;3;3;0;100;0;117266.666666667;1199.66666666667;85
54236;2023;4;4;0;100;0;212425;1993.75;104.5
54238;2023;2;2;0;100;0;150800;1014;143.5
54239;2023;3;3;0;100;0;125000;1208;102.666666666667
54247;2023;1;1;0;100;0;195700;1938;101
54248;2023;1;1;0;100;0;70000;1014;69
54249;2023;4;4;0;100;0;122203.75;1081.5;112.25
54250;2023;8;8;0;100;0;220562.5;1876.375;119.25
54251;2023;2;2;0;100;0;74000;924.5;83
54252;2023;5;4;1;80;20;126000;1512;83.4
54253;2023;13;10;3;76.9230769230769;23.0769230769231;196364.615384615;1932.84615384615;103
54254;2023;30;29;1;96.6666666666667;3.33333333333333;249349.3;2558.9;96.9333333333333
54256;2023;5;5;0;100;0;128100;1377;93.6
54257;2023;31;27;4;87.0967741935484;12.9032258064516;274704.225806452;2689.83870967742;102.645161290323
54258;2023;1;1;0;100;0;98000;754;130
54259;2023;2;2;0;100;0;127000;915;136
54260;2023;7;7;0;100;0;176900;1527.57142857143;124.428571428571
54261;2023;58;37;21;63.7931034482759;36.2068965517241;149084.896551724;1964.13793103448;77.5344827586207
54263;2023;89;67;22;75.2808988764045;24.7191011235955;117983.494382022;1492.80898876404;79.6292134831461
54264;2023;1;1;0;100;0;257000;2254;114
54265;2023;18;14;4;77.7777777777778;22.2222222222222;244261.555555556;2594.61111111111;94.3888888888889
54266;2023;5;5;0;100;0;200364;2062.2;133.8
54268;2023;2;2;0;100;0;170000;1462;120
54269;2023;4;4;0;100;0;148000;1633.75;91.5
54270;2023;55;41;14;74.5454545454545;25.4545454545455;232089;2662.6;86.4727272727273
54271;2023;1;1;0;100;0;36000;878;41
54272;2023;2;2;0;100;0;172750;1324;102.5
54273;2023;111;86;25;77.4774774774775;22.5225225225225;138559.018018018;1742.98198198198;82.0630630630631
54274;2023;89;32;57;35.9550561797753;64.0449438202247;140764.033707865;1969.3595505618;69.6179775280899
54275;2023;2;2;0;100;0;280000;5015.5;76
54276;2023;7;7;0;100;0;182792.857142857;2103.57142857143;87.7142857142857
54277;2023;4;4;0;100;0;116275;1163;99.5
54278;2023;2;2;0;100;0;53000;570.5;86
54279;2023;18;16;2;88.8888888888889;11.1111111111111;185756.611111111;1823.72222222222;103.833333333333
54280;2023;111;70;41;63.0630630630631;36.9369369369369;99631.6936936937;1225.1981981982;80.3603603603604
54281;2023;5;5;0;100;0;218580;1885.6;117.8
54282;2023;1;1;0;100;0;268000;2144;125
54283;2023;3;3;0;100;0;202000;1633.66666666667;109.333333333333
54284;2023;32;32;0;100;0;89083.28125;1153.0625;75.15625
54286;2023;20;19;1;95;5;170329.25;1694.45;99.95
54287;2023;1;1;0;100;0;96200;962;100
54288;2023;2;2;0;100;0;171125;1763.5;92.5
54289;2023;2;1;1;50;50;184657.5;1736.5;104
54292;2023;2;2;0;100;0;127500;1335;97
54293;2023;2;2;0;100;0;145000;993;158
54294;2023;1;1;0;100;0;131000;1120;117
54295;2023;16;11;5;68.75;31.25;162487.5;1797.375;87.4375
54296;2023;5;5;0;100;0;256320;2175;136.2
54299;2023;1;1;0;100;0;165000;1684;98
54300;2023;60;50;10;83.3333333333333;16.6666666666667;216742.483333333;2217.51666666667;97.5
54301;2023;1;1;0;100;0;251750;2189;115
54302;2023;7;7;0;100;0;257132.857142857;2122.28571428571;116.714285714286
54303;2023;1;1;0;100;0;80000;800;100
54304;2023;168;46;122;27.3809523809524;72.6190476190476;179914.553571429;2083.19642857143;81.6071428571429
54305;2023;27;26;1;96.2962962962963;3.7037037037037;263801.925925926;2309.07407407407;120.148148148148
54306;2023;7;7;0;100;0;95157.1428571429;918.285714285714;101
54307;2023;1;1;0;100;0;120175;1414;85
54308;2023;3;2;1;66.6666666666667;33.3333333333333;118333.333333333;1381;110
54309;2023;3;3;0;100;0;269833.333333333;2372.66666666667;112.333333333333
54311;2023;7;7;0;100;0;288905.714285714;2025;144.428571428571
54312;2023;1;1;0;100;0;297800;3346;89
54313;2023;1;1;0;100;0;4,00E+05;2721;147
54314;2023;35;29;6;82.8571428571429;17.1428571428571;265427.142857143;2822.88571428571;92.5714285714286
54315;2023;9;9;0;100;0;166911.555555556;1621;103.888888888889
54316;2023;2;2;0;100;0;240250;1522.5;158.5
54318;2023;57;49;8;85.9649122807018;14.0350877192982;181542.263157895;1936.84210526316;93.9824561403509
54320;2023;1;1;0;100;0;199500;2078;96
54321;2023;19;16;3;84.2105263157895;15.7894736842105;169286.157894737;2242.57894736842;74.7368421052632
54322;2023;75;46;29;61.3333333333333;38.6666666666667;125129.413333333;1396.78666666667;88.76
54323;2023;125;66;59;52.8;47.2;170525.832;2021.336;86.04
54324;2023;4;4;0;100;0;127225;993.25;116
54325;2023;1;1;0;100;0;121600;1788;68
54326;2023;3;3;0;100;0;244600;2200.33333333333;128.333333333333
54327;2023;10;9;1;90;10;209425;2043.8;114.9
54328;2023;63;47;16;74.6031746031746;25.3968253968254;246645.793650794;2480.38095238095;97.1111111111111
54329;2023;188;93;95;49.468085106383;50.531914893617;114163.324468085;1352.28191489362;85.3351063829787
54330;2023;4;4;0;100;0;285712.5;2506.25;129
54331;2023;2;2;0;100;0;78500;1192;70
54332;2023;23;18;5;78.2608695652174;21.7391304347826;174912.608695652;1850.5652173913;96.1739130434783
54333;2023;4;4;0;100;0;109925;1270.5;90.75
54334;2023;8;8;0;100;0;190078.125;1671.75;124
54335;2023;5;4;1;80;20;135650;1354.2;97.6
54336;2023;7;6;1;85.7142857142857;14.2857142857143;233034.285714286;2178.71428571429;107.428571428571
54337;2023;2;2;0;100;0;364750;3589.5;102
54338;2023;11;11;0;100;0;222114.545454545;2105.09090909091;103.545454545455
54339;2023;105;42;63;40;60;179724;2118.01904761905;82.9809523809524
54343;2023;2;2;0;100;0;158150;1188;170.5
54344;2023;3;3;0;100;0;99000;978.666666666667;98.6666666666667
54345;2023;4;4;0;100;0;164582.5;1743.75;92.25
54346;2023;3;3;0;100;0;100966.666666667;1124.66666666667;92
54348;2023;3;3;0;100;0;126666.666666667;1423;81.6666666666667
54349;2023;1;1;0;100;0;206000;2341;88
54350;2023;11;8;3;72.7272727272727;27.2727272727273;121795.454545455;1365.27272727273;108.090909090909
54351;2023;14;10;4;71.4285714285714;28.5714285714286;163342.857142857;2042.5;83.9285714285714
54352;2023;12;12;0;100;0;138795.833333333;1732.41666666667;85.1666666666667
54353;2023;4;4;0;100;0;187237.5;1929.25;106.5
54357;2023;72;33;39;45.8333333333333;54.1666666666667;159057.847222222;2092.01388888889;74.7083333333333
54358;2023;3;3;0;100;0;139375;1712.66666666667;86.3333333333333
54360;2023;2;2;0;100;0;158250;1148;143.5
54362;2023;14;14;0;100;0;124625;1598.07142857143;77.2142857142857
54363;2023;4;4;0;100;0;236787.5;1997;130.5
54364;2023;9;9;0;100;0;244988.888888889;2156.55555555556;118
54365;2023;5;5;0;100;0;122600;1298;96
54366;2023;16;14;2;87.5;12.5;196908.375;2038.875;97.4375
54367;2023;35;31;4;88.5714285714286;11.4285714285714;230303.885714286;2554.25714285714;90.2285714285714
54368;2023;1;1;0;100;0;104000;743;140
54369;2023;11;11;0;100;0;168969.818181818;1708.18181818182;106.727272727273
54370;2023;1;1;0;100;0;140000;1591;88
54371;2023;14;13;1;92.8571428571429;7.14285714285714;222704.928571429;2201.28571428571;104.642857142857
54372;2023;6;6;0;100;0;218666.666666667;1765.5;132.166666666667
54373;2023;1;1;0;100;0;260000;3171;82
54374;2023;5;5;0;100;0;239500;1894.6;152
54375;2023;10;9;1;90;10;164690;2404.4;85.3
54376;2023;4;4;0;100;0;141362.5;1624;84.5
54377;2023;1;1;0;100;0;140000;1186;118
54378;2023;5;3;2;60;40;149970;1805;71
54379;2023;1;1;0;100;0;123000;1150;107
54380;2023;4;4;0;100;0;149062.5;1041;142
54382;2023;68;58;10;85.2941176470588;14.7058823529412;202503.529411765;2146.66176470588;92.4264705882353
54383;2023;10;10;0;100;0;185500;1677.8;122.8
54385;2023;6;6;0;100;0;174741.666666667;1766.33333333333;102.5
54387;2023;2;2;0;100;0;226500;2229;112.5
54388;2023;1;1;0;100;0;110500;1005;110
54390;2023;2;1;1;50;50;73500;1190;61
54391;2023;20;20;0;100;0;115227.5;1523.5;75.25
54393;2023;9;9;0;100;0;87555.5555555556;897.222222222222;100.777777777778
54394;2023;3;3;0;100;0;198000;1685.33333333333;116.666666666667
54395;2023;1673;166;1507;9.92229527794381;90.0777047220562;160082.806335923;2433.94739988045;66
54397;2023;83;60;23;72.289156626506;27.710843373494;147811.144578313;1821.15662650602;80.2289156626506
54398;2023;1;1;0;100;0;221000;2232;99
54399;2023;7;7;0;100;0;72735.7142857143;1013.28571428571;71.8571428571429
54400;2023;10;8;2;80;20;224256.4;2634.9;100.6
54401;2023;2;2;0;100;0;112500;965;116
54402;2023;3;3;0;100;0;242833.333333333;2409.33333333333;103.666666666667
54403;2023;9;8;1;88.8888888888889;11.1111111111111;234874.555555556;1874.77777777778;124.777777777778
54404;2023;3;3;0;100;0;169000;1545.66666666667;118.666666666667
54405;2023;4;4;0;100;0;210025;1422;182.25
54406;2023;3;2;1;66.6666666666667;33.3333333333333;119751.333333333;736;176.333333333333
54407;2023;2;2;0;100;0;37500;570.5;64
54409;2023;3;3;0;100;0;100083.333333333;1104.66666666667;90.6666666666667
54410;2023;2;2;0;100;0;128500;1121;114
54411;2023;2;2;0;100;0;2,00E+05;1356;148
54412;2023;1;1;0;100;0;115000;1162;99
54414;2023;5;5;0;100;0;162014;2039.2;94.6
54415;2023;40;29;11;72.5;27.5;211737.775;2159.675;89.3
54416;2023;2;2;0;100;0;115000;1555.5;65
54418;2023;3;3;0;100;0;86133.3333333333;1196.66666666667;67
54419;2023;1;1;0;100;0;159904;1333;120
54420;2023;1;1;0;100;0;235700;2619;90
54421;2023;2;2;0;100;0;89000;678;122.5
54423;2023;7;7;0;100;0;41514.2857142857;525;78.7142857142857
54424;2023;1;1;0;100;0;263250;1350;195
54425;2023;40;30;10;75;25;128175.625;1601.9;81
54426;2023;1;1;0;100;0;170000;1717;99
54427;2023;2;2;0;100;0;110500;1137;95
54428;2023;10;6;4;60;40;120014;1412.6;84.3
54429;2023;3;3;0;100;0;197966.666666667;1637.66666666667;110.666666666667
54430;2023;51;37;14;72.5490196078431;27.4509803921569;137752.941176471;1580.96078431373;84.9607843137255
54431;2023;172;86;86;50;50;145348.122093023;1653.25581395349;89.1395348837209
54432;2023;14;9;5;64.2857142857143;35.7142857142857;132294.857142857;1456.85714285714;91.2857142857143
54433;2023;2;2;0;100;0;151375;1402;99.5
54434;2023;2;2;0;100;0;156600;1453.5;107
54435;2023;4;4;0;100;0;154375;1393.5;110.25
54436;2023;3;3;0;100;0;207133.333333333;2248.66666666667;90
54437;2023;12;11;1;91.6666666666667;8.33333333333333;169941.916666667;1844.41666666667;87.8333333333333
54438;2023;1;1;0;100;0;237500;2220;107
54439;2023;47;31;16;65.9574468085106;34.0425531914894;230915.255319149;2513.48936170213;95.4042553191489
54440;2023;2;2;0;100;0;103250;724;153
54442;2023;1;1;0;100;0;254750;2006;127
54443;2023;1;1;0;100;0;82000;828;99
54444;2023;2;2;0;100;0;303900;2847.5;114
54445;2023;2;2;0;100;0;74250;852.5;89.5
54449;2023;12;12;0;100;0;211145.833333333;1943.5;110.833333333333
54451;2023;50;33;17;66;34;188698.02;2136.88;88.92
54453;2023;2;2;0;100;0;70918.5;688;102.5
54455;2023;2;2;0;100;0;159000;1561.5;101.5
54456;2023;9;9;0;100;0;182288.111111111;1813.44444444444;114.777777777778
54458;2023;1;1;0;100;0;212500;2104;101
54459;2023;23;21;2;91.304347826087;8.69565217391304;252169.217391304;2319.04347826087;111.04347826087
54462;2023;27;24;3;88.8888888888889;11.1111111111111;176754.62962963;1875.81481481481;96.3333333333333
54463;2023;3;3;0;100;0;210809.666666667;1717;129.333333333333
54464;2023;2;2;0;100;0;289000;1297.5;195
54465;2023;5;4;1;80;20;162598;1835.4;102.6
54466;2023;1;1;0;100;0;2,00E+05;1538;130
54467;2023;3;3;0;100;0;104166.666666667;1316.66666666667;77.3333333333333
54469;2023;2;2;0;100;0;257950;1552.5;148
54471;2023;3;3;0;100;0;108333.333333333;850;151.333333333333
54472;2023;4;3;1;75;25;99687.5;968.75;102.75
54474;2023;1;1;0;100;0;165500;1839;90
54475;2023;2;2;0;100;0;116250;1015;117.5
54476;2023;7;7;0;100;0;157642.857142857;1682.42857142857;98.7142857142857
54477;2023;1;1;0;100;0;169800;1530;111
54481;2023;1;1;0;100;0;91000;615;148
54482;2023;153;45;108;29.4117647058824;70.5882352941177;164532.287581699;2036.50980392157;78.5490196078431
54483;2023;97;63;34;64.9484536082474;35.0515463917526;155945.855670103;1761.07216494845;88.9690721649485
54484;2023;2;2;0;100;0;139675;864.5;162.5
54485;2023;3;3;0;100;0;255750;2138.33333333333;123.333333333333
54486;2023;7;7;0;100;0;148521.428571429;1371.71428571429;109
54487;2023;1;1;0;100;0;120000;1304;92
54490;2023;10;7;3;70;30;191030;1810.4;109.4
54491;2023;3;3;0;100;0;196134;1779;96.3333333333333
54493;2023;45;33;12;73.3333333333333;26.6666666666667;167420.155555556;2246.4;73.8666666666667
54495;2023;43;31;12;72.0930232558139;27.906976744186;201720.186046512;2348.41860465116;88.9302325581395
54496;2023;8;8;0;100;0;158618.75;1320.5;124.5
54498;2023;41;39;2;95.1219512195122;4.8780487804878;215752;2357.07317073171;92
54499;2023;1;1;0;100;0;287850;2503;115
54500;2023;3;3;0;100;0;60533.3333333333;562.333333333333;106.333333333333
54504;2023;7;4;3;57.1428571428571;42.8571428571429;184508.428571429;1910.85714285714;97.1428571428571
54505;2023;4;4;0;100;0;206625;1963.5;107.5
54508;2023;1;1;0;100;0;197400;1880;105
54509;2023;13;13;0;100;0;119345;1461.92307692308;90.5384615384615
54510;2023;4;4;0;100;0;208325;1335.75;152.25
54511;2023;2;2;0;100;0;153500;1445.5;122
54513;2023;3;3;0;100;0;310023.333333333;2394;184.666666666667
54514;2023;2;2;0;100;0;194900;2267;74.5
54515;2023;1;1;0;100;0;2,00E+05;1961;102
54518;2023;13;10;3;76.9230769230769;23.0769230769231;125596.153846154;1095.84615384615;113.923076923077
54519;2023;5;5;0;100;0;126200;1084.2;118.6
54520;2023;3;3;0;100;0;143666.666666667;1171;139.666666666667
54521;2023;36;26;10;72.2222222222222;27.7777777777778;213254.166666667;2555.47222222222;83.8055555555556
54523;2023;2;1;1;50;50;147675;1116;130.5
54524;2023;1;1;0;100;0;75000;463;162
54525;2023;9;8;1;88.8888888888889;11.1111111111111;332255.666666667;2869.77777777778;114.111111111111
54526;2023;116;73;43;62.9310344827586;37.0689655172414;206327.543103448;2470.41379310345;83.4827586206897
54527;2023;1;1;0;100;0;208000;1719;121
54528;2023;172;79;93;45.9302325581395;54.0697674418605;136883.226744186;1552.18023255814;85.4825581395349
54531;2023;2;2;0;100;0;104850;842.5;124
54532;2023;2;2;0;100;0;124900;987;131.5
54533;2023;32;30;2;93.75;6.25;236500.875;2491.875;96.75
54534;2023;4;4;0;100;0;108900;3011.25;62
54535;2023;2;2;0;100;0;213500;2239.5;94.5
54536;2023;32;30;2;93.75;6.25;126945.3125;1504.125;83.84375
54537;2023;3;3;0;100;0;382566.666666667;2906.66666666667;141.333333333333
54538;2023;2;2;0;100;0;160000;878;175
54539;2023;7;7;0;100;0;113331.428571429;959.142857142857;118.714285714286
54540;2023;7;7;0;100;0;76050;832.571428571429;89.1428571428571
54541;2023;1;1;0;100;0;140000;1373;102
54542;2023;19;16;3;84.2105263157895;15.7894736842105;279040.210526316;2154.26315789474;103.421052631579
54543;2023;1;1;0;100;0;107500;1236;87
54544;2023;2;2;0;100;0;213000;2647.5;83.5
54545;2023;3;3;0;100;0;70833.3333333333;825.666666666667;92.6666666666667
54546;2023;13;11;2;84.6153846153846;15.3846153846154;201984.230769231;2005.15384615385;104.923076923077
54547;2023;346;75;271;21.6763005780347;78.3236994219653;131369.820809249;2019.45086705202;65.8265895953757
54548;2023;10;10;0;100;0;114775;1074.7;104.1
54549;2023;61;42;19;68.8524590163934;31.1475409836066;158578.360655738;1773.44262295082;92.8524590163934
54550;2023;2;2;0;100;0;135750;1098.5;125
54551;2023;1;1;0;100;0;180000;1385;130
54553;2023;2;2;0;100;0;188000;1345.5;130.5
54555;2023;1;1;0;100;0;120000;2353;51
54557;2023;18;16;2;88.8888888888889;11.1111111111111;352138.444444444;2779.05555555556;126.277777777778
54558;2023;3;3;0;100;0;185150;1909.33333333333;95.3333333333333
54559;2023;2;2;0;100;0;228625;2072.5;110
54561;2023;2;2;0;100;0;85005;854;101.5
54562;2023;1;1;0;100;0;50000;595;84
54563;2023;11;11;0;100;0;178749.090909091;1600.81818181818;117.818181818182
54565;2023;1;1;0;100;0;174350;1744;100
54566;2023;2;1;1;50;50;174000;1336.5;151.5
54567;2023;6;6;0;100;0;111583.333333333;1034.16666666667;112.833333333333
54568;2023;1;1;0;100;0;180000;1875;96
54569;2023;2;2;0;100;0;182800;1737.5;106
54570;2023;1;1;0;100;0;106550;919;116
54571;2023;2;2;0;100;0;267700;2207;120
54572;2023;5;5;0;100;0;211110;1749.4;126.2
54573;2023;1;1;0;100;0;1,00E+05;1053;95
54574;2023;2;2;0;100;0;706900;3448.5;214.5
54575;2023;16;13;3;81.25;18.75;252086.4375;2603.625;99.25
54576;2023;1;1;0;100;0;95000;950;100
54577;2023;1;1;0;100;0;137500;2292;60
54578;2023;210;91;119;43.3333333333333;56.6666666666667;195451.89047619;2301.46666666667;84.3666666666667
54579;2023;2;2;0;100;0;225750;1519.5;120
54580;2023;139;107;32;76.9784172661871;23.021582733813;191350.079136691;2529.01438848921;76.9208633093525
54581;2023;2;2;0;100;0;177450;1973;92.5
54582;2023;1;1;0;100;0;256000;3657;70
54583;2023;4;4;0;100;0;128875;1824.75;69.5
54584;2023;6;5;1;83.3333333333333;16.6666666666667;269509.5;2050.66666666667;130.333333333333
54585;2023;3;3;0;100;0;182400;1638.33333333333;113
54586;2023;7;7;0;100;0;248097.714285714;1932.85714285714;125.285714285714
54587;2023;2;2;0;100;0;119500;1560;73
54590;2023;9;9;0;100;0;223416.666666667;2656.55555555556;97.6666666666667
54591;2023;4;4;0;100;0;176887.5;1735.75;111.5
54592;2023;2;1;1;50;50;170175;1902.5;90
54593;2023;11;11;0;100;0;163745.454545455;1709.54545454545;97.5454545454545
54594;2023;1;1;0;100;0;132000;2200;60
54595;2023;2;2;0;100;0;184207.5;1874.5;99.5
54596;2023;11;11;0;100;0;209522.727272727;1996.18181818182;104.363636363636
54597;2023;6;6;0;100;0;152925;1339.66666666667;110.833333333333
54598;2023;3;3;0;100;0;193000;1656.66666666667;129.666666666667
54600;2023;2;2;0;100;0;150000;1019.5;144
54601;2023;2;2;0;100;0;126000;1151.5;109
54602;2023;1;1;0;100;0;139000;1635;85
55001;2023;6;6;0;100;0;82599.8333333333;739.833333333333;110.833333333333
55002;2023;3;3;0;100;0;127080;1919.66666666667;73.3333333333333
55004;2023;1;1;0;100;0;176500;1634;108
55007;2023;1;1;0;100;0;245000;1667;147
55008;2023;3;3;0;100;0;118833.333333333;1070.66666666667;112
55009;2023;6;6;0;100;0;172573.333333333;1487.83333333333;117
55010;2023;26;25;1;96.1538461538462;3.84615384615385;117038.461538462;1313.69230769231;92.5384615384615
55011;2023;5;5;0;100;0;133200;1193;128.2
55012;2023;6;6;0;100;0;99983.3333333333;918.166666666667;112.5
55013;2023;5;5;0;100;0;132000;929.8;136.6
55014;2023;6;6;0;100;0;73716.6666666667;727;99.1666666666667
55015;2023;5;5;0;100;0;138640;1078.4;124
55017;2023;2;2;0;100;0;67500;669;102.5
55021;2023;4;4;0;100;0;79150;975.5;80
55022;2023;4;4;0;100;0;134750;1356.5;96
55024;2023;2;2;0;100;0;86750;710.5;121
55025;2023;2;2;0;100;0;94500;704;124
55026;2023;1;1;0;100;0;29000;659;44
55027;2023;4;4;0;100;0;80620;893.75;91.25
55028;2023;1;1;0;100;0;30000;400;75
55029;2023;171;104;67;60.8187134502924;39.1812865497076;116352.105263158;1293.88304093567;90.2046783625731
55031;2023;3;3;0;100;0;162223.333333333;1714.66666666667;94.6666666666667
55035;2023;1;1;0;100;0;56000;718;78
55038;2023;2;2;0;100;0;131500;1208;119.5
55040;2023;3;3;0;100;0;72696.6666666667;854.333333333333;83.3333333333333
55041;2023;2;2;0;100;0;79850.5;851.5;111
55042;2023;4;4;0;100;0;139250;1589.25;86.75
55043;2023;30;21;9;70;30;123083.766666667;1378.76666666667;93.4
55044;2023;1;1;0;100;0;50000;510;98
55045;2023;1;1;0;100;0;90000;1475;61
55046;2023;1;1;0;100;0;70125;674;104
55047;2023;2;2;0;100;0;81000;746.5;112.5
55049;2023;9;9;0;100;0;101296.666666667;1296.77777777778;77.2222222222222
55051;2023;1;1;0;100;0;239500;887;270
55053;2023;7;7;0;100;0;94707.1428571429;922.571428571429;107.571428571429
55054;2023;1;1;0;100;0;152000;817;186
55057;2023;1;1;0;100;0;172000;1654;104
55058;2023;2;2;0;100;0;98500;981;93
55059;2023;1;1;0;100;0;159000;1691;94
55060;2023;2;2;0;100;0;143710;1237;113
55061;2023;1;1;0;100;0;60000;923;65
55063;2023;43;42;1;97.6744186046512;2.32558139534884;113218.348837209;1316.04651162791;91.5581395348837
55064;2023;1;1;0;100;0;27000;415;65
55066;2023;2;2;0;100;0;150875;1199.5;123.5
55067;2023;1;1;0;100;0;61500;439;140
55068;2023;4;4;0;100;0;134018.75;1025.75;129.5
55069;2023;2;2;0;100;0;108250;1257;88
55071;2023;2;2;0;100;0;117990;1269;90.5
55072;2023;1;1;0;100;0;80000;1000;80
55073;2023;6;6;0;100;0;201291.666666667;1722.16666666667;133.166666666667
55075;2023;3;3;0;100;0;43333.3333333333;664.666666666667;78.6666666666667
55076;2023;1;1;0;100;0;72000;610;118
55077;2023;5;5;0;100;0;185046;1802.6;106
55078;2023;4;4;0;100;0;128100;1229.75;113.5
55079;2023;6;6;0;100;0;115416.666666667;1124.66666666667;104
55081;2023;4;4;0;100;0;87375;1120.75;81.5
55082;2023;1;1;0;100;0;60000;759;79
55083;2023;1;1;0;100;0;108000;1350;80
55084;2023;1;1;0;100;0;60000;632;95
55085;2023;6;6;0;100;0;117375;1024.83333333333;119.5
55087;2023;1;1;0;100;0;100073;625;160
55088;2023;2;2;0;100;0;135500;774;175
55089;2023;4;3;1;75;25;69930;872.75;84.75
55093;2023;4;4;0;100;0;80937.5;1008.5;89.75
55094;2023;3;3;0;100;0;180133.333333333;2021.66666666667;93.6666666666667
55095;2023;2;2;0;100;0;91665;1225.5;85
55097;2023;3;3;0;100;0;110666.666666667;937.333333333333;130
55101;2023;1;1;0;100;0;225000;1731;130
55102;2023;6;6;0;100;0;161416.666666667;1734.16666666667;98.3333333333333
55103;2023;1;1;0;100;0;74900;567;132
55104;2023;2;2;0;100;0;86500;827;110
55105;2023;5;5;0;100;0;133130;1008.2;134.2
55106;2023;2;2;0;100;0;87250;1138;76
55109;2023;5;5;0;100;0;129450;1011;133
55110;2023;3;3;0;100;0;166666.666666667;1366;117.333333333333
55111;2023;5;5;0;100;0;129901.2;1263.6;108
55113;2023;1;1;0;100;0;95000;772;123
55114;2023;2;2;0;100;0;88750;784;113
55115;2023;2;2;0;100;0;85682;1047.5;68
55116;2023;1;1;0;100;0;150000;1250;120
55117;2023;8;7;1;87.5;12.5;86125;985.125;89.875
55119;2023;3;3;0;100;0;93666.6666666667;1074.66666666667;87
55120;2023;10;10;0;100;0;180570;1745.3;103.7
55122;2023;38;29;9;76.3157894736842;23.6842105263158;119909.473684211;1370.55263157895;91.4210526315789
55123;2023;6;6;0;100;0;154300;1295;131.666666666667
55124;2023;4;3;1;75;25;106000;1188;99.25
55125;2023;5;5;0;100;0;169239;1362.6;128.8
55132;2023;20;18;2;90;10;143790;1239.85;120.05
55138;2023;1;1;0;100;0;111123;1883;59
55141;2023;1;1;0;100;0;38000;475;80
55142;2023;3;3;0;100;0;73333.3333333333;729.666666666667;100.666666666667
55144;2023;2;2;0;100;0;140950;1303;114.5
55145;2023;7;7;0;100;0;222100;1317.28571428571;166.428571428571
55146;2023;2;2;0;100;0;118950;763.5;160.5
55149;2023;1;1;0;100;0;67000;670;100
55150;2023;4;4;0;100;0;72375;631.75;114.25
55153;2023;3;3;0;100;0;119000;799;143
55154;2023;15;15;0;100;0;173468.666666667;1240.8;140.8
55155;2023;7;7;0;100;0;122990.428571429;1342;106.857142857143
55157;2023;1;1;0;100;0;150300;2424;62
55158;2023;7;7;0;100;0;148087.142857143;1676.71428571429;92.4285714285714
55159;2023;5;5;0;100;0;132500;1093.4;127.4
55163;2023;1;1;0;100;0;150000;750;200
55165;2023;5;5;0;100;0;73910;706.4;104.8
55166;2023;12;12;0;100;0;159683.333333333;1537.41666666667;108.666666666667
55167;2023;14;14;0;100;0;96394.3571428571;1262;77.6428571428571
55168;2023;1;1;0;100;0;22000;440;50
55169;2023;6;4;2;66.6666666666667;33.3333333333333;140000;1599.66666666667;90.1666666666667
55170;2023;2;2;0;100;0;95500;1148;92
55171;2023;2;2;0;100;0;265000;2013;133.5
55173;2023;2;2;0;100;0;61500;700;90
55174;2023;2;2;0;100;0;155000;1140.5;134.5
55175;2023;2;2;0;100;0;159500;1128;129
55178;2023;1;1;0;100;0;152000;1216;125
55179;2023;1;1;0;100;0;132500;697;190
55180;2023;4;4;0;100;0;99250;957.75;107
55181;2023;47;38;9;80.8510638297872;19.1489361702128;124333.85106383;1274.10638297872;99.0851063829787
55182;2023;1;1;0;100;0;68000;895;76
55183;2023;1;1;0;100;0;70000;583;120
55184;2023;17;17;0;100;0;123950;1356.70588235294;91.4705882352941
55185;2023;3;2;1;66.6666666666667;33.3333333333333;117533.333333333;945;123.666666666667
55186;2023;14;14;0;100;0;137696.428571429;1392.64285714286;98.2142857142857
55188;2023;2;2;0;100;0;220450;1617;133.5
55191;2023;2;2;0;100;0;149750;1464.5;97.5
55195;2023;2;2;0;100;0;109475;807;130
55196;2023;3;3;0;100;0;131283.333333333;922.666666666667;134.666666666667
55198;2023;7;7;0;100;0;154058.571428571;1341.14285714286;122.714285714286
55199;2023;1;1;0;100;0;110000;667;165
55200;2023;1;1;0;100;0;115000;821;140
55202;2023;1;1;0;100;0;131000;936;140
55204;2023;4;4;0;100;0;99750;1026.25;104.5
55208;2023;1;1;0;100;0;30000;400;75
55211;2023;1;1;0;100;0;140000;1273;110
55212;2023;1;1;0;100;0;233000;1503;155
55215;2023;9;9;0;100;0;82888.8888888889;744.555555555556;108
55217;2023;1;1;0;100;0;103675;628;165
55219;2023;2;2;0;100;0;212500;1685;124.5
55224;2023;5;5;0;100;0;154436;1535;104.4
55225;2023;1;1;0;100;0;135000;1184;114
55226;2023;3;3;0;100;0;122833.333333333;1106.33333333333;100.666666666667
55228;2023;5;5;0;100;0;113048;949;119.8
55229;2023;3;3;0;100;0;97666.6666666667;814.666666666667;126
55232;2023;2;2;0;100;0;132500;1230;116
55236;2023;5;5;0;100;0;211140;1758.4;116.4
55237;2023;1;1;0;100;0;65000;663;98
55241;2023;1;1;0;100;0;141000;2043;69
55242;2023;1;1;0;100;0;70000;625;112
55243;2023;2;2;0;100;0;127500;1231;110
55244;2023;3;3;0;100;0;76466.6666666667;1326.66666666667;62.3333333333333
55245;2023;1;1;0;100;0;115000;1211;95
55247;2023;1;1;0;100;0;75000;694;108
55248;2023;2;2;0;100;0;125625;852;147
55250;2023;2;2;0;100;0;94500;825;152.5
55251;2023;2;2;0;100;0;76500;708;99
55252;2023;1;1;0;100;0;309500;6190;50
55253;2023;2;2;0;100;0;69250;1009;62.5
55254;2023;1;1;0;100;0;272300;1028;265
55255;2023;2;2;0;100;0;46100;651;65
55257;2023;1;1;0;100;0;125000;1420;88
55258;2023;7;7;0;100;0;101214.285714286;1033.28571428571;96
55260;2023;2;2;0;100;0;141500;1442;98.5
55261;2023;2;2;0;100;0;42333.5;487.5;87
55262;2023;5;5;0;100;0;70900;923.8;78
55263;2023;5;5;0;100;0;120500;939.2;119.2
55264;2023;3;3;0;100;0;118833.333333333;941;130
55266;2023;1;1;0;100;0;90000;900;100
55267;2023;1;1;0;100;0;200290;2225;90
55268;2023;11;11;0;100;0;135343.636363636;1249;117.545454545455
55269;2023;1;1;0;100;0;149500;1557;96
55270;2023;1;1;0;100;0;121333;682;178
55271;2023;1;1;0;100;0;120000;1091;110
55272;2023;5;5;0;100;0;158060;1616.2;97.4
55275;2023;2;2;0;100;0;101400;1064.5;118
55276;2023;1;1;0;100;0;60000;513;117
55278;2023;1;1;0;100;0;185125;1371;135
55279;2023;5;5;0;100;0;56101;814.6;67.2
55282;2023;1;1;0;100;0;55000;514;107
55285;2023;5;4;1;80;20;92200;1213.2;80.4
55286;2023;1;1;0;100;0;165000;1854;89
55288;2023;16;16;0;100;0;119420;1251.125;99
55291;2023;34;26;8;76.4705882352941;23.5294117647059;123433.823529412;1213.64705882353;101.382352941176
55292;2023;2;2;0;100;0;95000;1024.5;93.5
55293;2023;1;1;0;100;0;42000;400;105
55296;2023;8;8;0;100;0;110687.5;1150.5;99.875
55297;2023;1;1;0;100;0;174000;1359;128
55299;2023;1;1;0;100;0;160000;1778;90
55300;2023;3;3;0;100;0;85083.3333333333;767.333333333333;114
55301;2023;2;2;0;100;0;152250;1284.5;131.5
55302;2023;10;10;0;100;0;152275;1401.9;111.4
55304;2023;1;1;0;100;0;144000;847;170
55310;2023;2;2;0;100;0;56000;645.5;76
55311;2023;1;1;0;100;0;121500;2025;60
55312;2023;1;1;0;100;0;75000;1071;70
55315;2023;1;1;0;100;0;163040;1630;100
55316;2023;9;8;1;88.8888888888889;11.1111111111111;171288.888888889;1185.33333333333;142
55317;2023;3;3;0;100;0;187466.666666667;1860.33333333333;106.333333333333
55321;2023;2;2;0;100;0;167950;1688;99
55323;2023;2;2;0;100;0;78000;683;116
55324;2023;5;5;0;100;0;165160;1273.6;128
55327;2023;4;4;0;100;0;91904.5;678;142.75
55328;2023;5;5;0;100;0;100020;942.4;111.2
55329;2023;3;3;0;100;0;72333.3333333333;683.333333333333;107
55331;2023;1;1;0;100;0;40000;412;97
55332;2023;2;2;0;100;0;90500;1033.5;92.5
55334;2023;2;2;0;100;0;3,00E+05;974.5;326
55335;2023;4;4;0;100;0;87980;1083.25;83.5
55336;2023;2;2;0;100;0;164450;1193.5;139
55338;2023;4;4;0;100;0;171500;1152.5;147
55340;2023;3;3;0;100;0;91033.3333333333;995.666666666667;102.333333333333
55343;2023;2;2;0;100;0;112500;1105;102.5
55345;2023;6;6;0;100;0;92119.1666666667;1401.66666666667;91.1666666666667
55346;2023;4;4;0;100;0;105195.5;1280;83
55347;2023;2;2;0;100;0;114500;1101;101.5
55348;2023;6;6;0;100;0;53166.6666666667;650.833333333333;83.8333333333333
55349;2023;2;2;0;100;0;88750;1187.5;78.5
55350;2023;1;1;0;100;0;30000;625;48
55351;2023;14;14;0;100;0;149663.214285714;1370.35714285714;125.857142857143
55352;2023;2;2;0;100;0;136000;1101;121
55353;2023;4;4;0;100;0;108750;1147.75;107.25
55355;2023;2;2;0;100;0;70550;672;106.5
55356;2023;1;1;0;100;0;150000;1744;86
55357;2023;1;1;0;100;0;105000;1050;100
55358;2023;1;1;0;100;0;50000;667;75
55359;2023;3;3;0;100;0;73583.3333333333;1187;65.6666666666667
55360;2023;4;4;0;100;0;59750;1613;51.75
55361;2023;2;2;0;100;0;1,00E+05;1413.5;71
55362;2023;3;3;0;100;0;104666.666666667;1033.66666666667;102.666666666667
55363;2023;2;2;0;100;0;70500;662;103
55364;2023;7;7;0;100;0;113571.428571429;1058;108.857142857143
55365;2023;1;1;0;100;0;109000;1090;100
55366;2023;13;13;0;100;0;167413.923076923;1527.76923076923;107.461538461538
55367;2023;1;1;0;100;0;142500;1484;96
55368;2023;3;3;0;100;0;110633.333333333;1266.33333333333;73
55369;2023;10;9;1;90;10;121373.5;1288.8;98.2
55370;2023;1;1;0;100;0;25000;417;60
55372;2023;3;3;0;100;0;82000;742.666666666667;117
55374;2023;2;2;0;100;0;66250;927.5;74.5
55376;2023;1;1;0;100;0;63800;751;85
55377;2023;1;1;0;100;0;145000;792;183
55378;2023;5;5;0;100;0;107816.2;875.4;118.4
55380;2023;1;1;0;100;0;140000;1261;111
55381;2023;1;1;0;100;0;186000;1033;180
55382;2023;3;3;0;100;0;122666.666666667;982;125.333333333333
55384;2023;1;1;0;100;0;117000;1045;112
55385;2023;5;5;0;100;0;154200;1800.6;90.2
55387;2023;1;1;0;100;0;95000;1792;53
55388;2023;3;3;0;100;0;155226.666666667;1026;163
55389;2023;4;4;0;100;0;113418.75;956;134.25
55391;2023;3;3;0;100;0;174775;1372.66666666667;126
55395;2023;1;1;0;100;0;107400;537;200
55396;2023;3;3;0;100;0;50333.3333333333;774.666666666667;65.3333333333333
55397;2023;3;3;0;100;0;137333.333333333;1180.33333333333;106
55398;2023;9;8;1;88.8888888888889;11.1111111111111;126716.666666667;1330.55555555556;103.333333333333
55400;2023;1;1;0;100;0;129750;701;185
55401;2023;1;1;0;100;0;159000;1223;130
55404;2023;3;3;0;100;0;172149;1247.66666666667;136.666666666667
55405;2023;3;3;0;100;0;167833.333333333;1062.33333333333;144.333333333333
55406;2023;1;1;0;100;0;253000;1581;160
55408;2023;1;1;0;100;0;63000;2739;23
55410;2023;1;1;0;100;0;151210;1057;143
55411;2023;1;1;0;100;0;120600;997;121
55412;2023;4;3;1;75;25;184550;1389;129
55414;2023;1;1;0;100;0;125000;1316;95
55415;2023;1;1;0;100;0;188000;1480;127
55416;2023;3;3;0;100;0;91583.3333333333;783.666666666667;141.333333333333
55419;2023;5;5;0;100;0;102600;1081;103.2
55421;2023;1;1;0;100;0;176000;1073;164
55423;2023;3;3;0;100;0;61000;555;103.333333333333
55425;2023;2;2;0;100;0;71615;768;92.5
55426;2023;3;3;0;100;0;157833.333333333;932.333333333333;171.333333333333
55427;2023;29;29;0;100;0;112167.655172414;1119.79310344828;100.931034482759
55430;2023;1;1;0;100;0;90000;612;147
55433;2023;2;2;0;100;0;119000;1220;88.5
55435;2023;5;5;0;100;0;96378;993.6;97.2
55437;2023;2;2;0;100;0;160000;1454.5;110
55438;2023;8;8;0;100;0;72762.5;883.375;83.875
55439;2023;2;2;0;100;0;132300;734;188.5
55442;2023;2;2;0;100;0;96500;765.5;116.5
55443;2023;2;2;0;100;0;98500;1153;75.5
55444;2023;1;1;0;100;0;102500;649;158
55445;2023;1;1;0;100;0;265000;2944;90
55446;2023;1;1;0;100;0;169800;1587;107
55447;2023;8;8;0;100;0;120350;1065.875;126.5
55449;2023;1;1;0;100;0;81000;844;96
55452;2023;1;1;0;100;0;133450;834;160
55453;2023;4;4;0;100;0;120387.5;1384;94
55454;2023;4;4;0;100;0;134250;1355;105.5
55456;2023;3;3;0;100;0;74666.6666666667;871.666666666667;87
55457;2023;3;3;0;100;0;140500;1262;113.666666666667
55458;2023;1;1;0;100;0;60000;667;90
55459;2023;3;3;0;100;0;68333.3333333333;789;87.3333333333333
55461;2023;6;6;0;100;0;152796.666666667;2061.83333333333;116.666666666667
55462;2023;7;7;0;100;0;112090;883.571428571429;122.571428571429
55463;2023;31;29;2;93.5483870967742;6.45161290322581;97923.2258064516;1045.93548387097;96.0322580645161
55466;2023;3;3;0;100;0;83166.6666666667;977.333333333333;78
55467;2023;4;4;0;100;0;100705;1007.5;92.5
55469;2023;2;2;0;100;0;80000;932.5;85.5
55470;2023;1;1;0;100;0;169500;1378;123
55472;2023;3;3;0;100;0;153000;1078.66666666667;141.666666666667
55474;2023;5;5;0;100;0;63800;676.4;96.8
55475;2023;1;1;0;100;0;33500;838;40
55476;2023;3;2;1;66.6666666666667;33.3333333333333;110666.666666667;1211;93
55477;2023;4;4;0;100;0;130150;1360.25;98.25
55479;2023;3;3;0;100;0;101333.333333333;1054.66666666667;100.666666666667
55481;2023;1;1;0;100;0;185000;1745;106
55482;2023;1;1;0;100;0;45600;456;100
55484;2023;3;3;0;100;0;55463.3333333333;747;76.3333333333333
55485;2023;2;2;0;100;0;84025;650;119
55487;2023;3;3;0;100;0;126466.666666667;1033.33333333333;114
55488;2023;5;5;0;100;0;119060;1402.6;94.8
55489;2023;2;2;0;100;0;83000;913;86.5
55490;2023;8;7;1;87.5;12.5;104093.75;761.375;131.75
55492;2023;11;11;0;100;0;97051.8181818182;975;102.090909090909
55493;2023;4;4;0;100;0;99725;981;103.5
55494;2023;3;3;0;100;0;157050;1193;138
55495;2023;2;2;0;100;0;265756.5;2310.5;147.5
55496;2023;4;4;0;100;0;139875;1464;100.5
55497;2023;3;3;0;100;0;148260;1164.33333333333;125.333333333333
55498;2023;4;4;0;100;0;66175;910;69.5
55500;2023;3;3;0;100;0;90600;851.666666666667;104
55501;2023;2;2;0;100;0;180500;1467.5;127.5
55502;2023;19;17;2;89.4736842105263;10.5263157894737;98152.6315789474;1166.94736842105;84.3157894736842
55503;2023;1;1;0;100;0;38000;475;80
55504;2023;8;8;0;100;0;191516.25;1564.375;119.125
55505;2023;20;17;3;85;15;194500;1620.35;123.05
55507;2023;2;2;0;100;0;143000;1266;118
55508;2023;3;3;0;100;0;241658.333333333;1879.33333333333;135
55509;2023;6;6;0;100;0;110833.333333333;1184.16666666667;95
55510;2023;1;1;0;100;0;136350;1377;99
55511;2023;1;1;0;100;0;41000;410;100
55512;2023;1;1;0;100;0;20000;500;40
55514;2023;5;5;0;100;0;131400;1143.4;122
55516;2023;10;10;0;100;0;122488;1093.6;119.7
55517;2023;9;9;0;100;0;94816.6666666667;1051.77777777778;101.222222222222
55519;2023;8;8;0;100;0;99587.5;894.75;120.875
55520;2023;3;3;0;100;0;157700;1351.33333333333;109.666666666667
55521;2023;2;2;0;100;0;128500;1010;126
55522;2023;2;2;0;100;0;110535;1150.5;101
55523;2023;2;2;0;100;0;399735;1852;215
55526;2023;1;1;0;100;0;66500;485;137
55527;2023;3;3;0;100;0;106666.666666667;871.333333333333;112
55530;2023;1;1;0;100;0;120000;536;224
55531;2023;3;3;0;100;0;133166.666666667;1144;116.666666666667
55532;2023;3;3;0;100;0;88333.3333333333;999.333333333333;89.3333333333333
55533;2023;13;13;0;100;0;90803.9230769231;890.923076923077;92.2307692307692
55536;2023;1;1;0;100;0;57500;612;94
55537;2023;1;1;0;100;0;182570;1826;100
55541;2023;4;4;0;100;0;108087.5;717.25;152
55543;2023;8;8;0;100;0;113147.5;1089.25;107.875
55544;2023;3;3;0;100;0;93000;741.333333333333;124.666666666667
55545;2023;172;98;74;56.9767441860465;43.0232558139535;134657.656976744;1540.20930232558;87.2616279069767
55546;2023;4;4;0;100;0;171625;1692.25;104.25
55547;2023;1;1;0;100;0;1,00E+05;833;120
55549;2023;3;3;0;100;0;78333.3333333333;998.666666666667;93.6666666666667
55551;2023;25;25;0;100;0;132619.6;1257.68;108.12
55553;2023;15;13;2;86.6666666666667;13.3333333333333;124713.333333333;1349.13333333333;92.8666666666667
55554;2023;4;4;0;100;0;184915;1727;108.25
55555;2023;1;1;0;100;0;56000;622;90
55557;2023;3;3;0;100;0;72750;891;91.6666666666667
55562;2023;3;3;0;100;0;96666.6666666667;668;146
55563;2023;1;1;0;100;0;268000;1763;152
55565;2023;2;2;0;100;0;146000;1408.5;105
55566;2023;2;2;0;100;0;160450;1303;127
55568;2023;5;5;0;100;0;173100;1296.8;133.4
55569;2023;3;3;0;100;0;147766.666666667;1462.66666666667;102
55570;2023;1;1;0;100;0;154000;1791;86
55571;2023;1;1;0;100;0;48000;436;110
55573;2023;16;16;0;100;0;136809.375;1429.75;96.3125
55577;2023;1;1;0;100;0;167000;856;195
55580;2023;2;2;0;100;0;221500;1827.5;121
55581;2023;2;2;0;100;0;92750;1230;75
55582;2023;2;2;0;100;0;126000;867;146
55583;2023;4;4;0;100;0;173062.5;1501.75;112.25
55586;2023;4;4;0;100;0;117200;1147.75;120.25
56001;2023;37;35;2;94.5945945945946;5.40540540540541;197901.810810811;2159.18918918919;100.567567567568
56002;2023;23;23;0;100;0;295106.304347826;2740.04347826087;103.739130434783
56003;2023;65;47;18;72.3076923076923;27.6923076923077;637772.784615385;5208.38461538462;113.184615384615
56004;2023;26;22;4;84.6153846153846;15.3846153846154;207743.192307692;2774.19230769231;80.3461538461538
56005;2023;109;47;62;43.1192660550459;56.8807339449541;386848.71559633;5426.35779816514;68.3853211009174
56006;2023;20;20;0;100;0;157682.4;1762.3;90.2
56007;2023;224;92;132;41.0714285714286;58.9285714285714;275842.589285714;3723.10267857143;75.7544642857143
56008;2023;52;50;2;96.1538461538462;3.84615384615385;614965.211538462;5095.28846153846;122.807692307692
56009;2023;28;28;0;100;0;489896.428571429;5480.64285714286;91.3571428571429
56010;2023;94;85;9;90.4255319148936;9.57446808510638;195398.606382979;2221.70212765957;88.531914893617
56011;2023;24;24;0;100;0;243431.458333333;2127.45833333333;110.291666666667
56012;2023;19;19;0;100;0;226047.368421053;1936.15789473684;115.105263157895
56013;2023;62;52;10;83.8709677419355;16.1290322580645;339627.612903226;3704.96774193548;97.5322580645161
56014;2023;26;26;0;100;0;157315.538461538;1601.92307692308;101.038461538462
56015;2023;18;16;2;88.8888888888889;11.1111111111111;270872.444444444;2959.16666666667;90.8888888888889
56017;2023;25;25;0;100;0;194538.24;1876.56;101.44
56018;2023;17;17;0;100;0;284001.705882353;3023.94117647059;95.4705882352941
56019;2023;8;8;0;100;0;106962.375;1047.875;96.375
56020;2023;8;8;0;100;0;150300;1692;87.75
56021;2023;15;15;0;100;0;251000.666666667;2437.73333333333;104.2
56022;2023;21;21;0;100;0;291797.80952381;2529.42857142857;115.857142857143
56023;2023;67;60;7;89.5522388059701;10.4477611940298;346522.343283582;3264.5671641791;109.179104477612
56024;2023;27;27;0;100;0;148336.111111111;1617.37037037037;94.7777777777778
56025;2023;3;3;0;100;0;73833.3333333333;1043.66666666667;66.3333333333333
56026;2023;41;40;1;97.5609756097561;2.4390243902439;152135.390243902;1675.0243902439;88.9756097560976
56027;2023;10;10;0;100;0;130500;1977.4;67.5
56028;2023;24;24;0;100;0;186424.25;2045.79166666667;95.625
56029;2023;6;6;0;100;0;259566.666666667;2343.83333333333;108.5
56030;2023;14;14;0;100;0;192969.285714286;3052.85714285714;78.1428571428571
56031;2023;38;38;0;100;0;185835.5;1946.10526315789;95.9210526315789
56032;2023;17;17;0;100;0;139323.529411765;1569.94117647059;87.7647058823529
56033;2023;40;38;2;95;5;126884.075;1567.275;80.825
56034;2023;176;83;93;47.1590909090909;52.8409090909091;452586.988636364;6142.91477272727;77.7613636363636
56035;2023;19;19;0;100;0;135320.263157895;1533.89473684211;87.4736842105263
56036;2023;65;58;7;89.2307692307692;10.7692307692308;291735.569230769;2861.49230769231;105.4
56039;2023;19;19;0;100;0;218825.421052632;1873.05263157895;122.421052631579
56040;2023;25;25;0;100;0;277320.2;2317.32;126.16
56041;2023;39;38;1;97.4358974358974;2.56410256410256;132647.564102564;1576.87179487179;87.5384615384615
56042;2023;19;19;0;100;0;225376.315789474;2127.52631578947;109.105263157895
56043;2023;10;10;0;100;0;133640;1739.8;77
56044;2023;14;14;0;100;0;198267.142857143;1627.85714285714;118.928571428571
56045;2023;5;5;0;100;0;193599.2;2161.8;81.2
56046;2023;43;43;0;100;0;452396.837209302;4290.95348837209;108.697674418605
56047;2023;11;11;0;100;0;160048.090909091;1815.54545454545;87.5454545454545
56048;2023;24;24;0;100;0;116975;1291.83333333333;94.1666666666667
56050;2023;15;15;0;100;0;191819.866666667;1667.8;114.8
56051;2023;13;13;0;100;0;116188.461538462;1659.76923076923;71.1538461538462
56052;2023;59;44;15;74.5762711864407;25.4237288135593;317318.338983051;4684.42372881356;74.7796610169491
56053;2023;62;57;5;91.9354838709677;8.06451612903226;294774.016129032;2911.75806451613;105.225806451613
56054;2023;43;37;6;86.046511627907;13.953488372093;331061.627906977;4328.13953488372;82.0697674418605
56055;2023;49;34;15;69.3877551020408;30.6122448979592;331849.387755102;4189.97959183673;84.734693877551
56056;2023;5;5;0;100;0;125200;1196.2;102
56057;2023;56;53;3;94.6428571428571;5.35714285714286;141325.482142857;1733.98214285714;85.6785714285714
56058;2023;50;49;1;98;2;241908.54;2627.12;92.1
56060;2023;9;9;0;100;0;164844.222222222;1800.66666666667;90.6666666666667
56061;2023;48;48;0;100;0;162412.395833333;1719.1875;92.5416666666667
56062;2023;18;18;0;100;0;379794.222222222;4042.83333333333;95.3888888888889
56063;2023;22;20;2;90.9090909090909;9.09090909090909;305432.272727273;2930.86363636364;106.363636363636
56065;2023;9;9;0;100;0;170443.333333333;1893.33333333333;88.8888888888889
56066;2023;59;58;1;98.3050847457627;1.69491525423729;110950;1216.5593220339;92.5423728813559
56067;2023;50;47;3;94;6;280054.7;2918.1;97.94
56068;2023;4;4;0;100;0;140675;1502.25;85.75
56069;2023;43;42;1;97.6744186046512;2.32558139534884;401074.372093023;5181.20930232558;81.7674418604651
56070;2023;38;38;0;100;0;150781.710526316;1693.26315789474;90.1052631578947
56071;2023;5;4;1;80;20;170710;2672;82.2
56072;2023;6;6;0;100;0;150675;1539.83333333333;100
56073;2023;22;21;1;95.4545454545455;4.54545454545455;111500;1397.04545454545;79.9090909090909
56074;2023;19;19;0;100;0;198356.210526316;1880.84210526316;106.368421052632
56075;2023;64;55;9;85.9375;14.0625;167449.859375;1832.59375;92.5
56076;2023;26;25;1;96.1538461538462;3.84615384615385;132746.923076923;1447.11538461538;94.1538461538462
56077;2023;12;12;0;100;0;244914.25;2722.5;86.1666666666667
56078;2023;142;96;46;67.6056338028169;32.3943661971831;324207.676056338;4002.89436619718;86.6760563380282
56079;2023;26;26;0;100;0;180476.730769231;1770.38461538462;103.076923076923
56080;2023;27;27;0;100;0;121950.296296296;1415.2962962963;86.2592592592593
56081;2023;38;38;0;100;0;114486.526315789;1216.21052631579;95.5526315789474
56082;2023;8;8;0;100;0;151008.25;1621.875;94.75
56083;2023;226;139;87;61.5044247787611;38.4955752212389;210850.792035398;2546.04424778761;83.929203539823
56084;2023;15;15;0;100;0;359073.333333333;3981.86666666667;97.7333333333333
56085;2023;4;4;0;100;0;409237.5;6226.5;70.5
56086;2023;5;5;0;100;0;483138;9957.8;49.6
56087;2023;15;13;2;86.6666666666667;13.3333333333333;757059;6635.6;113.466666666667
56088;2023;16;16;0;100;0;466531.25;5998.125;81.75
56089;2023;29;29;0;100;0;163991.75862069;1764.72413793103;94.2068965517241
56090;2023;77;74;3;96.1038961038961;3.8961038961039;217526.779220779;2302.72727272727;99.5714285714286
56091;2023;40;33;7;82.5;17.5;158322.5;1762.075;95.375
56092;2023;13;13;0;100;0;167038.461538462;1509.23076923077;110.769230769231
56093;2023;10;10;0;100;0;157550;1674;95.2
56094;2023;59;49;10;83.0508474576271;16.9491525423729;283281.440677966;3015.67796610169;95.2542372881356
56096;2023;13;13;0;100;0;284286.153846154;2672.38461538462;111.384615384615
56097;2023;30;26;4;86.6666666666667;13.3333333333333;245972.166666667;2702.8;92.2
56098;2023;298;185;113;62.0805369127517;37.9194630872483;200914.117449664;2550.90939597315;82.3859060402685
56099;2023;12;12;0;100;0;124099.166666667;1856.66666666667;72.1666666666667
56100;2023;37;37;0;100;0;128361.27027027;1744.24324324324;81.2972972972973
56101;2023;88;81;7;92.0454545454545;7.95454545454545;217000.170454545;2341.73863636364;95.3181818181818
56102;2023;36;36;0;100;0;133514.527777778;1662.33333333333;81.2777777777778
56103;2023;6;6;0;100;0;103895.666666667;1382.66666666667;83.1666666666667
56104;2023;7;7;0;100;0;155777.428571429;1949.14285714286;74.8571428571429
56105;2023;21;20;1;95.2380952380952;4.76190476190476;126821;1514.28571428571;83.5238095238095
56106;2023;18;15;3;83.3333333333333;16.6666666666667;753588.166666667;7604.44444444444;95.8333333333333
56107;2023;127;76;51;59.8425196850394;40.1574803149606;479870.204724409;5027.33070866142;96.9212598425197
56108;2023;11;11;0;100;0;189325;2093.45454545455;88.9090909090909
56109;2023;9;9;0;100;0;275418.888888889;2919.66666666667;96.2222222222222
56110;2023;20;20;0;100;0;109958.2;1488.1;81.35
56111;2023;20;20;0;100;0;145003.85;1855.95;77.55
56112;2023;11;11;0;100;0;168177.545454545;1832.90909090909;94
56113;2023;11;11;0;100;0;113363.636363636;1558.72727272727;86.4545454545455
56114;2023;17;17;0;100;0;560687.058823529;6102.29411764706;93.9411764705882
56115;2023;16;16;0;100;0;336787.6875;2814.625;118.375
56116;2023;28;19;9;67.8571428571429;32.1428571428571;451285.357142857;6256.10714285714;74.5
56117;2023;64;44;20;68.75;31.25;164639.40625;2240.296875;78.671875
56118;2023;48;44;4;91.6666666666667;8.33333333333333;281721.25;3596.14583333333;80.2916666666667
56119;2023;25;25;0;100;0;367366.88;3768.04;100.56
56120;2023;16;14;2;87.5;12.5;290792;3129.8125;90.8125
56121;2023;920;257;663;27.9347826086957;72.0652173913043;196084.490217391;2787.67173913043;72.2630434782609
56122;2023;18;18;0;100;0;147011.555555556;1407.77777777778;100.777777777778
56123;2023;34;34;0;100;0;191170.147058824;1998.91176470588;102.882352941176
56124;2023;44;36;8;81.8181818181818;18.1818181818182;179533.863636364;2211.34090909091;82.8409090909091
56125;2023;23;23;0;100;0;168147.173913043;1672.95652173913;100.739130434783
56126;2023;36;36;0;100;0;217228.805555556;2625.91666666667;84.4722222222222
56127;2023;48;45;3;93.75;6.25;127154.375;1429.83333333333;89.6458333333333
56128;2023;29;29;0;100;0;150732.75862069;1904.31034482759;81.9310344827586
56129;2023;21;21;0;100;0;125898.571428571;1329.85714285714;100.333333333333
56130;2023;27;27;0;100;0;348525.37037037;3201.88888888889;119.407407407407
56131;2023;13;12;1;92.3076923076923;7.69230769230769;153549.692307692;1672.23076923077;91.1538461538462
56132;2023;29;23;6;79.3103448275862;20.6896551724138;300679.172413793;2813.31034482759;108.103448275862
56133;2023;5;5;0;100;0;162280;1632.2;109.8
56134;2023;16;16;0;100;0;114878.1875;1297.4375;87.9375
56135;2023;8;8;0;100;0;147040.625;1618.5;83.75
56136;2023;8;8;0;100;0;182111.25;1856.375;99.875
56137;2023;30;28;2;93.3333333333333;6.66666666666667;274414.2;2802.46666666667;101.4
56139;2023;6;6;0;100;0;193661.666666667;1999.83333333333;83.6666666666667
56140;2023;33;32;1;96.969696969697;3.03030303030303;173403.848484848;1842.72727272727;93.3030303030303
56141;2023;23;23;0;100;0;256543.043478261;2226.21739130435;115.739130434783
56143;2023;69;64;5;92.7536231884058;7.2463768115942;260074.420289855;2976.31884057971;90.3188405797101
56144;2023;59;59;0;100;0;141278.728813559;1437.4406779661;97.271186440678
56145;2023;24;24;0;100;0;146245.416666667;1519.95833333333;98.75
56146;2023;20;20;0;100;0;144926.65;1525;95.35
56147;2023;59;59;0;100;0;218182.593220339;2325.79661016949;94.593220338983
56148;2023;13;13;0;100;0;310353.153846154;2729.46153846154;121.307692307692
56149;2023;31;31;0;100;0;265328.774193548;2560.67741935484;104.903225806452
56151;2023;42;42;0;100;0;146265.142857143;1650.85714285714;93.3333333333333
56152;2023;49;30;19;61.2244897959184;38.7755102040816;359703.510204082;4932.57142857143;76.5102040816327
56153;2023;28;27;1;96.4285714285714;3.57142857142857;256583.678571429;2315.71428571429;114.928571428571
56154;2023;21;21;0;100;0;164844.476190476;1833.85714285714;91.5714285714286
56155;2023;66;60;6;90.9090909090909;9.09090909090909;268065.121212121;4065.48484848485;71.9545454545455
56156;2023;10;10;0;100;0;131402.8;1675.2;86.7
56157;2023;22;22;0;100;0;231315.954545455;2342.18181818182;101.909090909091
56158;2023;101;48;53;47.5247524752475;52.4752475247525;250906.386138614;3505.0198019802;74.0594059405941
56159;2023;15;14;1;93.3333333333333;6.66666666666667;142232.666666667;1755.66666666667;82.2666666666667
56160;2023;20;20;0;100;0;133625;1824.7;80.8
56161;2023;43;33;10;76.7441860465116;23.2558139534884;318864.511627907;3698.74418604651;88.9069767441861
56162;2023;214;153;61;71.4953271028037;28.5046728971963;367073.672897196;4085.28037383178;93.6775700934579
56163;2023;20;18;2;90;10;165721.75;1573.6;111.1
56164;2023;87;56;31;64.367816091954;35.632183908046;332500.954022989;3575.26436781609;91.2528735632184
56165;2023;132;98;34;74.2424242424242;25.7575757575758;181367.196969697;2120.84848484848;85.2651515151515
56166;2023;57;55;2;96.4912280701754;3.50877192982456;197321.087719298;2240;95.7543859649123
56167;2023;18;18;0;100;0;343688.388888889;3176.61111111111;107.166666666667
56168;2023;31;29;2;93.5483870967742;6.45161290322581;433397.806451613;4359.93548387097;99.9032258064516
56169;2023;74;65;9;87.8378378378378;12.1621621621622;370622.945945946;3510.14864864865;107.459459459459
56170;2023;25;25;0;100;0;107923.6;1141;101.12
56171;2023;30;30;0;100;0;193365.666666667;2122.3;94.9666666666667
56172;2023;37;37;0;100;0;191573.216216216;1968.86486486486;95.4324324324324
56173;2023;51;51;0;100;0;151536.941176471;1686.90196078431;91.4313725490196
56174;2023;31;31;0;100;0;199022.774193548;1942.58064516129;102.741935483871
56175;2023;43;41;2;95.3488372093023;4.65116279069767;330856.604651163;3244.48837209302;105.604651162791
56176;2023;70;59;11;84.2857142857143;15.7142857142857;279236.457142857;3087.94285714286;92.3142857142857
56177;2023;99;90;9;90.9090909090909;9.09090909090909;250893.191919192;2607.9494949495;97.2626262626263
56178;2023;208;129;79;62.0192307692308;37.9807692307692;142431.355769231;1887.03846153846;81.4182692307692
56179;2023;39;35;4;89.7435897435898;10.2564102564103;274705.564102564;2584.89743589744;106.615384615385
56180;2023;13;13;0;100;0;196483.076923077;1942.30769230769;100.846153846154
56181;2023;48;29;19;60.4166666666667;39.5833333333333;300850.5625;3720.14583333333;80.5416666666667
56182;2023;21;21;0;100;0;118092.761904762;1605.71428571429;77.6666666666667
56184;2023;101;94;7;93.0693069306931;6.93069306930693;239939.871287129;2438.07920792079;101.772277227723
56185;2023;86;74;12;86.046511627907;13.953488372093;270567.534883721;2737.16279069767;98.9302325581395
56186;2023;179;80;99;44.6927374301676;55.3072625698324;365718.312849162;5649.59776536313;68.8156424581006
56188;2023;23;23;0;100;0;151461.782608696;1672.04347826087;89.304347826087
56189;2023;20;20;0;100;0;117278.9;1352.7;84.75
56190;2023;20;20;0;100;0;166682.2;1504.4;109.95
56191;2023;14;14;0;100;0;132510.357142857;1536.14285714286;90.2857142857143
56193;2023;65;62;3;95.3846153846154;4.61538461538462;285980.323076923;3161.67692307692;96.3692307692308
56194;2023;35;35;0;100;0;169567.857142857;1829.6;95.4857142857143
56195;2023;27;14;13;51.8518518518518;48.1481481481481;177403.407407407;2410.81481481481;78.3333333333333
56196;2023;10;4;6;40;60;98190;1951.5;49.6
56197;2023;39;38;1;97.4358974358974;2.56410256410256;170516.794871795;1724.97435897436;100.538461538462
56198;2023;19;18;1;94.7368421052632;5.26315789473684;140658.684210526;1575.73684210526;101.105263157895
56199;2023;17;16;1;94.1176470588235;5.88235294117647;92091.1764705882;1106.52941176471;82.7647058823529
56200;2023;12;12;0;100;0;211708.333333333;1774.91666666667;121.75
56201;2023;8;8;0;100;0;98331.25;1257;84
56202;2023;7;7;0;100;0;176492.857142857;3395.71428571429;72.7142857142857
56203;2023;11;11;0;100;0;131780;1175.27272727273;110.454545454545
56204;2023;8;8;0;100;0;165296.125;1604.5;96.125
56205;2023;13;13;0;100;0;537403.076923077;4873.38461538462;109.538461538462
56206;2023;97;72;25;74.2268041237113;25.7731958762887;314036.670103093;3253.34020618557;96.659793814433
56207;2023;13;13;0;100;0;180760;1764.76923076923;98.6923076923077
56208;2023;4;4;0;100;0;192750;2168.25;101
56209;2023;3;3;0;100;0;170000;1367.66666666667;127
56210;2023;10;9;1;90;10;112800;1125.5;106.2
56211;2023;17;17;0;100;0;139136;1438.70588235294;99.5882352941177
56212;2023;31;31;0;100;0;177837.419354839;2077.51612903226;94.4193548387097
56213;2023;17;17;0;100;0;224317.647058824;1874.05882352941;130.705882352941
56214;2023;59;55;4;93.2203389830508;6.77966101694915;464349.576271186;4561.4406779661;104.932203389831
56215;2023;13;13;0;100;0;138414.615384615;1521.23076923077;92.6923076923077
56216;2023;4;4;0;100;0;193873.75;1972.5;99
56218;2023;8;8;0;100;0;146101.25;1680.375;92
56219;2023;17;17;0;100;0;230578.235294118;2585.70588235294;94.3529411764706
56220;2023;11;11;0;100;0;310663.636363636;2770.63636363636;113.727272727273
56221;2023;18;18;0;100;0;149802.555555556;1779.22222222222;89.6111111111111
56222;2023;40;37;3;92.5;7.5;200948;2135.25;97.85
56223;2023;17;17;0;100;0;187315.294117647;2001.82352941176;89.6470588235294
56224;2023;5;5;0;100;0;223654.2;2058.8;107.4
56225;2023;1;1;0;100;0;138000;1971;70
56226;2023;15;15;0;100;0;163366.666666667;1840.33333333333;90.0666666666667
56227;2023;8;8;0;100;0;96531.25;1108;95
56228;2023;9;9;0;100;0;233344.444444444;2370.66666666667;102.444444444444
56229;2023;24;24;0;100;0;151141.625;1500.91666666667;100.708333333333
56230;2023;14;14;0;100;0;136629.285714286;1653.21428571429;82.2857142857143
56231;2023;42;41;1;97.6190476190476;2.38095238095238;285545.5;2645.88095238095;109.261904761905
56232;2023;10;10;0;100;0;142500;1955.4;72.5
56233;2023;29;19;10;65.5172413793103;34.4827586206897;498947.586206897;5271.79310344828;91.9310344827586
56234;2023;52;44;8;84.6153846153846;15.3846153846154;380943.153846154;4957;87.8846153846154
56236;2023;14;14;0;100;0;128045.214285714;1414.21428571429;93.2142857142857
56237;2023;19;19;0;100;0;145705.736842105;1683.21052631579;92.7894736842105
56238;2023;8;8;0;100;0;234149.75;2007.125;136.625
56239;2023;22;22;0;100;0;150630.636363636;1675.40909090909;89
56240;2023;197;149;48;75.6345177664975;24.3654822335025;388927.162436548;4654.58375634518;89.6243654822335
56241;2023;15;12;3;80;20;457373.333333333;5283.06666666667;91.6666666666667
56242;2023;18;18;0;100;0;129653.333333333;1434.66666666667;89.6111111111111
56243;2023;139;71;68;51.0791366906475;48.9208633093525;305780.244604317;3777.18705035971;80.6762589928058
56244;2023;46;46;0;100;0;161213.217391304;2088.52173913043;83.1304347826087
56245;2023;6;6;0;100;0;109650;1344.83333333333;81.1666666666667
56246;2023;20;20;0;100;0;195045;1863.55;108.7
56247;2023;36;36;0;100;0;254842.5;2594.13888888889;100.833333333333
56248;2023;60;58;2;96.6666666666667;3.33333333333333;373503.95;3387.46666666667;111.883333333333
56249;2023;31;31;0;100;0;176971.451612903;1893.45161290323;97.5161290322581
56250;2023;11;11;0;100;0;179171.363636364;1740.90909090909;96.1818181818182
56251;2023;78;64;14;82.051282051282;17.9487179487179;349732.512820513;3620.11538461538;99.0512820512821
56252;2023;36;36;0;100;0;481483.305555556;3897.52777777778;125.777777777778
56253;2023;13;13;0;100;0;160654.692307692;1572.30769230769;108.769230769231
56254;2023;21;21;0;100;0;211217.142857143;2193.2380952381;97.4761904761905
56255;2023;22;18;4;81.8181818181818;18.1818181818182;251834.318181818;2678.86363636364;97.8636363636364
56256;2023;3;3;0;100;0;110000;1631.33333333333;69
56257;2023;18;18;0;100;0;108877.5;1104.22222222222;100.166666666667
56258;2023;44;23;21;52.2727272727273;47.7272727272727;500209.863636364;6737.29545454545;74.4318181818182
56259;2023;15;15;0;100;0;301228.866666667;3121.2;102.8
56260;2023;975;261;714;26.7692307692308;73.2307692307692;290931.447179487;4155.21538461538;69.1753846153846
56261;2023;12;12;0;100;0;201352.916666667;2802.66666666667;80.25
56262;2023;31;26;5;83.8709677419355;16.1290322580645;430719.903225806;4477.58064516129;97.1935483870968
56263;2023;21;17;4;80.9523809523809;19.047619047619;318799;3110.71428571429;103
56264;2023;10;10;0;100;0;131720;1247.7;106.5
58002;2023;13;13;0;100;0;99723.0769230769;1130.76923076923;88.9230769230769
58003;2023;10;10;0;100;0;158280;1873.6;85.1
58004;2023;11;11;0;100;0;103966.363636364;1179.81818181818;87.5454545454545
58005;2023;3;3;0;100;0;23666.6666666667;580.333333333333;40.3333333333333
58006;2023;3;3;0;100;0;117683.333333333;1443.66666666667;82.3333333333333
58007;2023;4;4;0;100;0;64000;674.75;101.5
58008;2023;2;2;0;100;0;94500;796;113.5
58009;2023;3;3;0;100;0;58000;761.333333333333;76
58010;2023;11;11;0;100;0;119616.363636364;978.545454545455;110.181818181818
58011;2023;5;4;1;80;20;74200;715.8;103.6
58012;2023;10;10;0;100;0;103500;804.9;113.8
58014;2023;1;1;0;100;0;95000;1118;85
58015;2023;3;3;0;100;0;56166.6666666667;771.333333333333;79.6666666666667
58016;2023;2;2;0;100;0;117500;926.5;134.5
58017;2023;3;3;0;100;0;48556.6666666667;703;69.3333333333333
58018;2023;3;3;0;100;0;89333.3333333333;837.666666666667;91.6666666666667
58019;2023;2;2;0;100;0;142500;1274.5;108.5
58020;2023;2;2;0;100;0;95000;611.5;150
58021;2023;2;2;0;100;0;46500;711;65
58023;2023;5;5;0;100;0;187040;1732.2;101.8
58024;2023;8;8;0;100;0;103642.5;796;129.125
58025;2023;1;1;0;100;0;121000;1512;80
58026;2023;1;1;0;100;0;49000;700;70
58027;2023;3;3;0;100;0;156666.666666667;1001.66666666667;160.666666666667
58028;2023;2;2;0;100;0;143500;1362.5;105
58029;2023;2;2;0;100;0;47750;840;62.5
58030;2023;7;7;0;100;0;100714.285714286;1286.57142857143;79.8571428571429
58031;2023;5;5;0;100;0;137804;2085.2;92
58032;2023;4;4;0;100;0;96500;1025.75;89
58033;2023;2;2;0;100;0;99500;1125.5;89
58034;2023;3;3;0;100;0;97500;624.666666666667;133.666666666667
58035;2023;5;5;0;100;0;126800;1358.8;93.8
58036;2023;9;9;0;100;0;124444.444444444;1096.77777777778;99.5555555555556
58037;2023;14;14;0;100;0;100157.142857143;1333.64285714286;76.9285714285714
58039;2023;4;4;0;100;0;70250;734.75;87
58040;2023;4;4;0;100;0;65637.5;973.75;68.25
58041;2023;4;4;0;100;0;130725;1333.25;104
58042;2023;1;1;0;100;0;67500;1125;60
58043;2023;1;1;0;100;0;195000;1560;125
58044;2023;12;12;0;100;0;112875;1125.08333333333;95.5833333333333
58045;2023;2;2;0;100;0;36500;465;78
58046;2023;20;20;0;100;0;90972.5;1193.75;75
58047;2023;16;16;0;100;0;82640.625;1018;84.125
58049;2023;4;4;0;100;0;120750;1186.5;98.75
58050;2023;1;1;0;100;0;110000;2200;50
58051;2023;9;9;0;100;0;154766.666666667;2136.66666666667;72.8888888888889
58053;2023;4;4;0;100;0;298237.5;1260.25;164.5
58054;2023;1;1;0;100;0;260000;1733;150
58055;2023;9;9;0;100;0;112709.111111111;1147;102.333333333333
58056;2023;1;1;0;100;0;130000;985;132
58057;2023;10;10;0;100;0;142864;1230.8;106.7
58058;2023;8;8;0;100;0;60000;855.375;76.625
58059;2023;74;62;12;83.7837837837838;16.2162162162162;98942.8378378378;1206.54054054054;81.3918918918919
58060;2023;7;7;0;100;0;121142.857142857;1247.71428571429;98.8571428571429
58061;2023;2;2;0;100;0;85500;956;88.5
58062;2023;23;19;4;82.6086956521739;17.3913043478261;78492.8260869565;844.260869565217;93.1739130434783
58063;2023;5;5;0;100;0;87980;1025.2;92
58064;2023;14;13;1;92.8571428571429;7.14285714285714;81709.2857142857;870.857142857143;92.2857142857143
58065;2023;13;13;0;100;0;74692.3076923077;976;79.9230769230769
58067;2023;20;20;0;100;0;122715;1306.65;97
58068;2023;8;8;0;100;0;117500;2226.375;61.125
58069;2023;1;1;0;100;0;85000;1809;47
58071;2023;2;2;0;100;0;260000;1636.5;189
58072;2023;8;8;0;100;0;130450;1463.375;88.75
58073;2023;2;2;0;100;0;96250;652.5;149.5
58074;2023;7;7;0;100;0;81439.2857142857;1035.71428571429;73.5714285714286
58075;2023;6;6;0;100;0;83666.6666666667;1004.16666666667;85.6666666666667
58076;2023;2;2;0;100;0;112150;1448.5;76.5
58077;2023;11;11;0;100;0;115804.545454545;1012.09090909091;119.727272727273
58079;2023;41;38;3;92.6829268292683;7.31707317073171;90780.1219512195;1033.56097560976;92.3170731707317
58080;2023;4;4;0;100;0;89881.25;1296.5;70.25
58081;2023;4;4;0;100;0;105875;1049.75;104
58082;2023;7;7;0;100;0;61857.1428571429;1120.71428571429;61.2857142857143
58083;2023;23;21;2;91.304347826087;8.69565217391304;96565.2173913044;1102.30434782609;86.3478260869565
58085;2023;8;8;0;100;0;100187.5;1110.5;103.375
58086;2023;142;122;20;85.9154929577465;14.0845070422535;105540.028169014;1291.76056338028;85.2042253521127
58087;2023;5;5;0;100;0;77800;827.2;93.2
58088;2023;57;46;11;80.7017543859649;19.2982456140351;140776.894736842;1684.98245614035;85.0350877192982
58089;2023;4;4;0;100;0;108750;933;103.25
58090;2023;3;3;0;100;0;56850;661.666666666667;95.3333333333333
58092;2023;6;6;0;100;0;115774.833333333;1061.33333333333;122
58093;2023;3;3;0;100;0;39000;872.666666666667;45
58094;2023;17;17;0;100;0;106700;994.764705882353;115.117647058824
58095;2023;62;48;14;77.4193548387097;22.5806451612903;99349.7580645161;1165.54838709677;85.4193548387097
58096;2023;4;4;0;100;0;79000;1004.25;93
58097;2023;3;3;0;100;0;137666.666666667;3675.66666666667;61.3333333333333
58098;2023;3;3;0;100;0;39666.6666666667;947.333333333333;44.3333333333333
58099;2023;3;3;0;100;0;128333.333333333;1276.33333333333;103
58101;2023;4;4;0;100;0;81750;854.75;90.25
58102;2023;12;12;0;100;0;95277.75;1143.5;82.5
58103;2023;12;12;0;100;0;57216.6666666667;749.75;75.0833333333333
58104;2023;15;15;0;100;0;107340;1120.6;90.4
58105;2023;4;4;0;100;0;182150;1663;106.5
58106;2023;9;9;0;100;0;127774.444444444;1440.55555555556;89.1111111111111
58107;2023;5;5;0;100;0;92000;998.2;91.2
58108;2023;2;2;0;100;0;167500;1437.5;138
58109;2023;18;18;0;100;0;71966.6666666667;881.111111111111;82.2222222222222
58110;2023;4;4;0;100;0;204500;2076.75;101.75
58111;2023;4;4;0;100;0;129312.5;2153.75;58.75
58112;2023;6;6;0;100;0;100250;1255;76.3333333333333
58113;2023;2;2;0;100;0;46000;819;58
58115;2023;1;1;0;100;0;73000;869;84
58116;2023;1;1;0;100;0;48000;667;72
58117;2023;48;34;14;70.8333333333333;29.1666666666667;103864.041666667;1295.02083333333;80.4583333333333
58118;2023;14;14;0;100;0;60132.1428571429;1002.5;68.2142857142857
58119;2023;1;1;0;100;0;50000;725;69
58120;2023;2;2;0;100;0;46500;1059.5;46
58121;2023;61;52;9;85.2459016393443;14.7540983606557;120240.508196721;1317.81967213115;87.6885245901639
58122;2023;5;5;0;100;0;73564;818.4;94.4
58123;2023;2;2;0;100;0;112500;1093.5;103.5
58124;2023;11;11;0;100;0;147134.090909091;1202.09090909091;117.727272727273
58125;2023;3;3;0;100;0;83666.6666666667;861.666666666667;94.3333333333333
58126;2023;3;3;0;100;0;350833.333333333;4448;91.6666666666667
58127;2023;1;1;0;100;0;16000;533;30
58128;2023;2;2;0;100;0;80062;1280.5;62.5
58129;2023;3;3;0;100;0;102016.666666667;1032.33333333333;95.3333333333333
58131;2023;29;28;1;96.551724137931;3.44827586206897;132737.275862069;1408.65517241379;94.2068965517241
58132;2023;5;5;0;100;0;101400;863.6;117.6
58134;2023;38;29;9;76.3157894736842;23.6842105263158;61453.4210526316;867.105263157895;71.2105263157895
58136;2023;1;1;0;100;0;20000;476;42
58138;2023;2;2;0;100;0;170000;1614;104.5
58139;2023;6;6;0;100;0;77366.6666666667;1069.16666666667;71
58140;2023;6;6;0;100;0;104558.333333333;1350.16666666667;82.5
58142;2023;7;7;0;100;0;88000;1002.71428571429;89.4285714285714
58143;2023;1;1;0;100;0;45000;763;59
58144;2023;12;12;0;100;0;90422.4166666667;907.666666666667;91.6666666666667
58145;2023;25;25;0;100;0;105620;1351.32;79.44
58146;2023;9;9;0;100;0;96222.2222222222;894.666666666667;107.777777777778
58147;2023;4;4;0;100;0;76375;950.5;81.25
58148;2023;5;5;0;100;0;151800;1500.2;99.8
58149;2023;32;28;4;87.5;12.5;104979.6875;1094.28125;91.75
58150;2023;2;2;0;100;0;84000;1161.5;76.5
58151;2023;57;55;2;96.4912280701754;3.50877192982456;61516.6666666667;939.456140350877;64.0526315789474
58152;2023;15;15;0;100;0;125826.666666667;1326.26666666667;92.8666666666667
58153;2023;1;1;0;100;0;23000;622;37
58154;2023;2;2;0;100;0;67000;1159;57.5
58155;2023;7;7;0;100;0;111871.428571429;1486.85714285714;99.5714285714286
58157;2023;3;3;0;100;0;66000;1210.33333333333;59.3333333333333
58158;2023;6;6;0;100;0;176125;1188.16666666667;136
58159;2023;2;2;0;100;0;89750;624.5;147
58160;2023;29;29;0;100;0;224439.655172414;2035.03448275862;109.827586206897
58161;2023;3;3;0;100;0;87333.3333333333;1052;76.3333333333333
58162;2023;3;3;0;100;0;158000;1692.33333333333;90
58163;2023;3;3;0;100;0;59000;669;85.3333333333333
58164;2023;12;12;0;100;0;158000;1805.16666666667;92.1666666666667
58165;2023;4;4;0;100;0;117000;1417.25;83.25
58166;2023;4;4;0;100;0;76657.5;1270.75;78.75
58168;2023;4;4;0;100;0;133553.75;1527.5;87
58170;2023;1;1;0;100;0;110000;1358;81
58171;2023;8;8;0;100;0;56468.75;785.625;78.875
58172;2023;3;3;0;100;0;67230;767.333333333333;86.6666666666667
58173;2023;5;5;0;100;0;41000;769.2;52.6
58174;2023;5;5;0;100;0;88700;843.2;103.6
58175;2023;4;4;0;100;0;215500;1113.25;157.75
58176;2023;3;3;0;100;0;197500;1573.66666666667;139.333333333333
58177;2023;9;9;0;100;0;65988.8888888889;1167.22222222222;59.4444444444444
58178;2023;4;4;0;100;0;48380;830.25;57.25
58179;2023;5;5;0;100;0;82970;1510.2;64.2
58180;2023;9;9;0;100;0;70888.8888888889;1096.11111111111;71
58181;2023;1;1;0;100;0;120000;1263;95
58182;2023;26;26;0;100;0;79538.4615384615;1005.53846153846;76.5384615384615
58183;2023;3;3;0;100;0;74666.6666666667;844.333333333333;91.6666666666667
58184;2023;6;6;0;100;0;95629.6666666667;1060.16666666667;89.1666666666667
58185;2023;10;10;0;100;0;102540;1182.6;82.4
58186;2023;2;2;0;100;0;147500;1091;136
58187;2023;4;4;0;100;0;128725;1248;104
58188;2023;4;4;0;100;0;56250;648.5;86.25
58189;2023;6;6;0;100;0;81216.6666666667;997.666666666667;88.5
58190;2023;5;5;0;100;0;86750;1387;72.8
58191;2023;4;4;0;100;0;108000;952;106.75
58192;2023;3;3;0;100;0;139000;1339.33333333333;95.3333333333333
58193;2023;24;22;2;91.6666666666667;8.33333333333333;95238.4166666667;986.291666666667;99.5833333333333
58194;2023;487;201;286;41.2731006160164;58.7268993839836;102157.486652977;1301.35112936345;76.8603696098563
58195;2023;4;4;0;100;0;90825;1097.25;86.25
58196;2023;7;7;0;100;0;140381.428571429;997.142857142857;140.285714285714
58197;2023;1;1;0;100;0;15600;433;36
58198;2023;5;5;0;100;0;63700;1107;63.8
58199;2023;5;5;0;100;0;124427;1365.2;81
58200;2023;2;2;0;100;0;59000;963;57
58201;2023;2;2;0;100;0;147000;1593.5;94.5
58203;2023;1;1;0;100;0;114000;877;130
58204;2023;6;6;0;100;0;120300;1409.33333333333;105.166666666667
58205;2023;14;14;0;100;0;81396.0714285714;1014.42857142857;79.1428571428571
58206;2023;1;1;0;100;0;15000;833;18
58207;2023;10;10;0;100;0;129773.7;1525;80.3
58208;2023;4;4;0;100;0;98625;1014;96
58209;2023;1;1;0;100;0;37000;411;90
58210;2023;15;15;0;100;0;117033.333333333;1446.06666666667;78.2666666666667
58211;2023;3;3;0;100;0;58033.3333333333;992.666666666667;65.6666666666667
58212;2023;6;6;0;100;0;99067.5;1056;96.6666666666667
58213;2023;5;5;0;100;0;125800;1403;94.2
58214;2023;29;27;2;93.1034482758621;6.89655172413793;136338.793103448;1629.48275862069;88.2068965517241
58215;2023;24;24;0;100;0;134541.666666667;1467.08333333333;85.625
58216;2023;6;6;0;100;0;72145.8333333333;1078.66666666667;68.3333333333333
58217;2023;4;4;0;100;0;111500;994.75;115.5
58218;2023;28;27;1;96.4285714285714;3.57142857142857;83760.7142857143;1097.96428571429;77.6785714285714
58219;2023;4;4;0;100;0;89750;959.75;91.5
58220;2023;10;10;0;100;0;125946;1367.4;98
58221;2023;3;3;0;100;0;58108.3333333333;1000.33333333333;72.3333333333333
58222;2023;5;5;0;100;0;209310;1211.4;156.4
58223;2023;13;13;0;100;0;96438.4615384615;1253.61538461538;86.6153846153846
58224;2023;2;2;0;100;0;124000;1413.5;88
58225;2023;3;3;0;100;0;104890.333333333;1078.66666666667;100.666666666667
58226;2023;5;5;0;100;0;164480;1378;118.6
58227;2023;20;20;0;100;0;108900.75;1184.65;94.3
58228;2023;7;6;1;85.7142857142857;14.2857142857143;160500;1599.71428571429;94.2857142857143
58229;2023;9;9;0;100;0;95444.4444444444;1157.11111111111;78.1111111111111
58230;2023;3;3;0;100;0;150000;2847;62
58231;2023;7;7;0;100;0;100004.142857143;958.428571428571;103.714285714286
58232;2023;14;13;1;92.8571428571429;7.14285714285714;95795.7142857143;1114.57142857143;87.1428571428571
58234;2023;1;1;0;100;0;284000;1434;198
58235;2023;7;7;0;100;0;50214.2857142857;987.142857142857;55.4285714285714
58236;2023;2;2;0;100;0;84500;932.5;80.5
58238;2023;19;19;0;100;0;117690;1282.26315789474;88.5789473684211
58239;2023;2;2;0;100;0;159500;1006;160
58240;2023;4;4;0;100;0;81415;923;85.75
58241;2023;4;4;0;100;0;144625;1373.25;113.25
58242;2023;1;1;0;100;0;36000;545;66
58243;2023;1;1;0;100;0;159000;1656;96
58244;2023;2;2;0;100;0;194000;1366.5;124.5
58245;2023;7;7;0;100;0;61042.1428571429;900.142857142857;70.2857142857143
58246;2023;21;21;0;100;0;78280.3333333333;980.809523809524;80.2380952380952
58247;2023;7;7;0;100;0;127162.857142857;1378.42857142857;100.142857142857
58248;2023;6;6;0;100;0;61000;775;83.8333333333333
58249;2023;4;4;0;100;0;117425;1231.75;96.25
58250;2023;22;17;5;77.2727272727273;22.7272727272727;83336.3636363636;1061.04545454545;75.1818181818182
58251;2023;7;7;0;100;0;85714.2857142857;958.285714285714;86.2857142857143
58252;2023;1;1;0;100;0;37245;418;89
58253;2023;4;4;0;100;0;111750;1170;91.5
58254;2023;7;7;0;100;0;191121.428571429;1838.71428571429;104.857142857143
58255;2023;1;1;0;100;0;38000;950;40
58256;2023;2;2;0;100;0;108500;1427;78.5
58257;2023;1;1;0;100;0;40000;714;56
58258;2023;6;6;0;100;0;131583.333333333;1218;100.333333333333
58259;2023;2;2;0;100;0;194500;2006;188
58260;2023;13;13;0;100;0;117076.923076923;1331.92307692308;89.7692307692308
58261;2023;15;14;1;93.3333333333333;6.66666666666667;128786.666666667;1323.53333333333;102.2
58262;2023;2;2;0;100;0;157157.5;1592;95
58263;2023;1;1;0;100;0;70000;1186;59
58264;2023;26;26;0;100;0;78753.8461538462;1064.11538461538;75.6923076923077
58265;2023;2;2;0;100;0;62950;1136.5;57.5
58266;2023;5;5;0;100;0;98700;1298.4;91.2
58267;2023;10;10;0;100;0;93990;897.8;105
58268;2023;5;5;0;100;0;65760;895.6;67.4
58269;2023;7;7;0;100;0;75342.8571428571;1190;76.4285714285714
58270;2023;6;6;0;100;0;80500;1230.83333333333;72.5
58271;2023;4;4;0;100;0;72500;972;74
58272;2023;3;3;0;100;0;69666.6666666667;865.333333333333;78
58273;2023;15;15;0;100;0;129066.666666667;1245.26666666667;103.6
58274;2023;2;2;0;100;0;90500;1666.5;52.5
58275;2023;4;4;0;100;0;96975;1377;68.25
58276;2023;6;6;0;100;0;88403.3333333333;1213.5;72.5
58277;2023;7;7;0;100;0;109035.714285714;1176.14285714286;90.7142857142857
58278;2023;15;14;1;93.3333333333333;6.66666666666667;129616.666666667;1548.86666666667;86
58279;2023;4;4;0;100;0;129162.5;1135.5;112.75
58280;2023;4;4;0;100;0;153475;1692.25;96.5
58281;2023;7;7;0;100;0;67185.7142857143;1077.42857142857;57.2857142857143
58282;2023;2;2;0;100;0;56500;686;83.5
58283;2023;2;2;0;100;0;108750;888.5;120.5
58284;2023;1;1;0;100;0;54000;900;60
58285;2023;4;4;0;100;0;106780;1224.75;98.5
58286;2023;7;7;0;100;0;106428.571428571;845.142857142857;119.857142857143
58287;2023;7;7;0;100;0;92257.1428571429;1144;80.2857142857143
58288;2023;1;1;0;100;0;57000;1000;57
58289;2023;6;6;0;100;0;88847.5;1159.83333333333;68.6666666666667
58291;2023;1;1;0;100;0;138800;731;190
58292;2023;4;4;0;100;0;83700;982.25;83.5
58293;2023;5;5;0;100;0;190000;1643.6;118.8
58295;2023;18;18;0;100;0;107305.555555556;1334.61111111111;89.5555555555556
58296;2023;4;4;0;100;0;129500;2053.25;58.25
58297;2023;2;2;0;100;0;42250;612;73.5
58298;2023;2;2;0;100;0;175500;1328.5;132
58299;2023;2;2;0;100;0;132525;1395;95
58300;2023;15;15;0;100;0;147244.066666667;1309.26666666667;118.666666666667
58301;2023;7;7;0;100;0;78785.7142857143;817.428571428571;93
58302;2023;6;6;0;100;0;72166.6666666667;1085.83333333333;71.8333333333333
58303;2023;102;84;18;82.3529411764706;17.6470588235294;132567.254901961;1683.51960784314;78.0588235294118
58304;2023;20;19;1;95;5;64050;993.2;73.95
58305;2023;3;3;0;100;0;71666.6666666667;1098;67
58306;2023;6;6;0;100;0;99125;1091.16666666667;91.1666666666667
58307;2023;2;2;0;100;0;147000;1242;103.5
58308;2023;2;2;0;100;0;137540;1003;133
58309;2023;14;14;0;100;0;128064.285714286;2041.92857142857;70.5
58310;2023;1;1;0;100;0;105000;750;140
58311;2023;3;3;0;100;0;42900;637;65.3333333333333
58312;2023;4;4;0;100;0;136000;1153.25;122.25
58313;2023;3;3;0;100;0;76666.6666666667;1025.33333333333;73.6666666666667
59001;2023;4;4;0;100;0;211825;1871.5;118.75
59002;2023;43;42;1;97.6744186046512;2.32558139534884;135349.953488372;1384.3488372093;98.7674418604651
59003;2023;5;5;0;100;0;158015;1486.2;110.4
59004;2023;11;11;0;100;0;272224;2028.63636363636;127.272727272727
59005;2023;27;27;0;100;0;231874.555555556;2242.03703703704;103.851851851852
59006;2023;1;1;0;100;0;240000;1529;157
59007;2023;8;8;0;100;0;185441.375;2081.625;91.375
59008;2023;87;87;0;100;0;118530.517241379;1270.96551724138;93.7471264367816
59009;2023;505;322;183;63.7623762376238;36.2376237623762;275901.594059406;3157.25742574257;87.1247524752475
59010;2023;2;2;0;100;0;259200;1620;160
59011;2023;93;86;7;92.4731182795699;7.52688172043011;250952.827956989;2451.36559139785;104.10752688172
59012;2023;16;16;0;100;0;127487.5;1127.6875;121.5625
59013;2023;15;14;1;93.3333333333333;6.66666666666667;320073.333333333;2840;112.933333333333
59014;2023;136;103;33;75.7352941176471;24.2647058823529;100726.404411765;1337.03676470588;79.4191176470588
59015;2023;31;31;0;100;0;148438.258064516;1653.58064516129;91.1290322580645
59016;2023;25;25;0;100;0;193736.24;2007.96;99.76
59017;2023;370;267;103;72.1621621621622;27.8378378378378;151733.875675676;1938.98378378378;79.8756756756757
59018;2023;10;10;0;100;0;174820;1827.5;95.3
59019;2023;7;7;0;100;0;189271.428571429;1657.28571428571;104.285714285714
59021;2023;13;13;0;100;0;159015.384615385;1690.30769230769;91.3076923076923
59022;2023;27;27;0;100;0;284523.333333333;2464.96296296296;113.037037037037
59023;2023;5;5;0;100;0;132462.4;1454.6;96.6
59024;2023;39;37;2;94.8717948717949;5.12820512820513;132909.923076923;1438.94871794872;96.2820512820513
59025;2023;31;31;0;100;0;319100.870967742;3208.45161290323;101.064516129032
59026;2023;12;12;0;100;0;144509.166666667;1772.83333333333;89.0833333333333
59027;2023;10;10;0;100;0;248276.5;2304;112.2
59028;2023;53;53;0;100;0;127275.886792453;1437.7358490566;86.8679245283019
59029;2023;24;24;0;100;0;282996.041666667;2448.875;114.875
59032;2023;67;59;8;88.0597014925373;11.9402985074627;132464;1754.20895522388;81.6865671641791
59033;2023;77;75;2;97.4025974025974;2.5974025974026;121064.519480519;1360.90909090909;87.948051948052
59034;2023;25;22;3;88;12;336567.4;3203.44;107.72
59035;2023;23;23;0;100;0;121956.52173913;1208.26086956522;96.3478260869565
59036;2023;35;33;2;94.2857142857143;5.71428571428571;109365.857142857;1098.65714285714;108
59037;2023;50;50;0;100;0;103925.24;1254.98;82.64
59038;2023;20;20;0;100;0;160908.05;1594.7;106.5
59039;2023;5;5;0;100;0;304770.8;1935.6;162.4
59041;2023;19;19;0;100;0;130250;1436.52631578947;95
59042;2023;8;7;1;87.5;12.5;279406.25;2794.375;99.375
59043;2023;169;117;52;69.2307692307692;30.7692307692308;210543.970414201;2513.82840236686;86.7100591715976
59044;2023;49;47;2;95.9183673469388;4.08163265306122;292268.591836735;2897.95918367347;101.551020408163
59045;2023;3;3;0;100;0;176333.333333333;1032;178.333333333333
59046;2023;6;6;0;100;0;163733.333333333;1725.83333333333;96.5
59047;2023;7;7;0;100;0;114638.285714286;1424.85714285714;86.4285714285714
59048;2023;5;5;0;100;0;181180;1709.4;111
59049;2023;3;3;0;100;0;119950;1170.33333333333;92.6666666666667
59050;2023;3;3;0;100;0;163833.333333333;1763.33333333333;90
59051;2023;60;53;7;88.3333333333333;11.6666666666667;165389.666666667;2003.65;84.8166666666667
59052;2023;53;52;1;98.1132075471698;1.88679245283019;188639.566037736;1959.32075471698;95.9245283018868
59053;2023;34;33;1;97.0588235294118;2.94117647058824;165839.411764706;1590.02941176471;101.882352941176
59054;2023;17;16;1;94.1176470588235;5.88235294117647;193020.588235294;2042.52941176471;97.6470588235294
59055;2023;6;6;0;100;0;112500;1316.66666666667;87
59056;2023;10;10;0;100;0;408574;3660.1;110.2
59057;2023;5;5;0;100;0;135550;1445;87.6
59058;2023;16;16;0;100;0;113043.75;1184.1875;95.625
59059;2023;4;4;0;100;0;109575;1170;96.25
59060;2023;4;4;0;100;0;150237.5;1353.25;107.75
59061;2023;2;2;0;100;0;184750;2241;95
59062;2023;2;2;0;100;0;185000;1685;108.5
59063;2023;31;31;0;100;0;124276.516129032;1116.29032258065;114.903225806452
59064;2023;11;11;0;100;0;157863.636363636;1713.36363636364;94.7272727272727
59065;2023;4;4;0;100;0;112267.5;1139.25;85.25
59067;2023;29;22;7;75.8620689655172;24.1379310344828;197954.724137931;2073.34482758621;95.9310344827586
59068;2023;25;25;0;100;0;133212.12;1271.56;108.64
59069;2023;7;7;0;100;0;172364.285714286;1850.85714285714;91.8571428571429
59070;2023;3;3;0;100;0;176333.333333333;1720.66666666667;101.333333333333
59071;2023;17;17;0;100;0;316551.764705882;2851.29411764706;113.294117647059
59072;2023;5;5;0;100;0;233000;2617;91.4
59073;2023;6;6;0;100;0;267358.333333333;2767.66666666667;107.5
59074;2023;23;23;0;100;0;108873.130434783;1101.60869565217;102.608695652174
59075;2023;3;3;0;100;0;104833.333333333;1119;91.6666666666667
59076;2023;3;3;0;100;0;206066.666666667;2562;86.6666666666667
59077;2023;4;4;0;100;0;177250;1361;136.25
59078;2023;5;5;0;100;0;169020;1450.6;112.8
59079;2023;41;37;4;90.2439024390244;9.75609756097561;143049.414634146;1595.31707317073;89.219512195122
59080;2023;21;21;0;100;0;250629.380952381;2259.28571428571;112.095238095238
59081;2023;1;1;0;100;0;140000;1474;95
59082;2023;22;22;0;100;0;254864.090909091;2225.27272727273;114.409090909091
59083;2023;3;3;0;100;0;338246.666666667;2294.33333333333;146.333333333333
59084;2023;14;14;0;100;0;175417.857142857;2026.71428571429;88.3571428571429
59085;2023;1;1;0;100;0;132000;1553;85
59086;2023;20;20;0;100;0;208523.05;2539.55;88.15
59087;2023;3;3;0;100;0;216233.333333333;1591.66666666667;133.333333333333
59088;2023;17;16;1;94.1176470588235;5.88235294117647;340123.529411765;3175.41176470588;110.235294117647
59089;2023;13;13;0;100;0;192927.692307692;1608.46153846154;124.846153846154
59090;2023;114;108;6;94.7368421052632;5.26315789473684;501392.780701754;4386.29824561404;113.517543859649
59091;2023;7;7;0;100;0;211892.857142857;1701;131.857142857143
59092;2023;42;42;0;100;0;140200.571428571;1539.42857142857;91
59093;2023;3;3;0;100;0;135000;1241;111
59094;2023;90;85;5;94.4444444444444;5.55555555555556;138134.433333333;1660.63333333333;85.5333333333333
59096;2023;14;14;0;100;0;344541.428571429;3173.07142857143;107.285714285714
59097;2023;3;3;0;100;0;142933.333333333;1642.66666666667;95.6666666666667
59098;2023;45;37;8;82.2222222222222;17.7777777777778;301277.777777778;2826.71111111111;109.688888888889
59099;2023;14;14;0;100;0;124425;1173.42857142857;105.928571428571
59100;2023;3;3;0;100;0;268110.333333333;2062.33333333333;131.666666666667
59101;2023;5;5;0;100;0;200800;1979;93.6
59102;2023;1;1;0;100;0;188000;2066;91
59103;2023;5;5;0;100;0;68000;1035.8;64.2
59104;2023;23;23;0;100;0;132391.304347826;1402.04347826087;96.2173913043478
59105;2023;8;8;0;100;0;247998.75;1853.875;125
59106;2023;5;5;0;100;0;407540;3457.8;119.2
59107;2023;142;55;87;38.7323943661972;61.2676056338028;189981.971830986;3191.44366197183;65.3661971830986
59108;2023;4;4;0;100;0;72325;815.75;91
59109;2023;8;8;0;100;0;248102.5;2159.75;119.875
59110;2023;14;14;0;100;0;243453.571428571;2162.14285714286;111.857142857143
59111;2023;6;6;0;100;0;199000;1727.5;113.5
59112;2023;96;96;0;100;0;137375.979166667;1532.69791666667;94.53125
59113;2023;13;13;0;100;0;131261.538461538;1680.23076923077;79.2307692307692
59114;2023;12;12;0;100;0;213885.166666667;2080.25;106.583333333333
59115;2023;6;6;0;100;0;108166.666666667;1182.5;91.1666666666667
59116;2023;7;7;0;100;0;322114.285714286;2899.71428571429;123.285714285714
59117;2023;8;8;0;100;0;185375;1621.875;115.25
59118;2023;21;21;0;100;0;107690.476190476;970;108.142857142857
59119;2023;3;3;0;100;0;222033.333333333;1900.33333333333;113.666666666667
59120;2023;16;16;0;100;0;248834.375;2107.25;116.6875
59121;2023;6;6;0;100;0;261916.666666667;2420.5;115.666666666667
59122;2023;380;261;119;68.6842105263158;31.3157894736842;135136.807894737;1595.33157894737;85.0342105263158
59123;2023;22;22;0;100;0;287535;2595.81818181818;113.181818181818
59124;2023;20;20;0;100;0;431940.5;3438.25;129.85
59125;2023;1;1;0;100;0;125000;1453;86
59126;2023;19;19;0;100;0;188567.315789474;1666.52631578947;115.473684210526
59128;2023;29;17;12;58.6206896551724;41.3793103448276;289549.206896552;3170.13793103448;90.5862068965517
59129;2023;19;19;0;100;0;333770.526315789;2701.36842105263;122.315789473684
59130;2023;11;11;0;100;0;205127.272727273;2035;99.5454545454545
59131;2023;63;63;0;100;0;182285.682539683;1942.66666666667;95.031746031746
59132;2023;14;14;0;100;0;119196.071428571;1118.64285714286;106.714285714286
59133;2023;14;10;4;71.4285714285714;28.5714285714286;217631.071428571;2608.07142857143;82.6428571428571
59134;2023;14;14;0;100;0;153550;1308.57142857143;113.357142857143
59135;2023;27;25;2;92.5925925925926;7.40740740740741;184844.444444444;1827.18518518519;103.407407407407
59136;2023;90;82;8;91.1111111111111;8.88888888888889;75377.8777777778;925.411111111111;80.4111111111111
59137;2023;10;10;0;100;0;106700;1514.3;89.7
59138;2023;11;11;0;100;0;136675.454545455;1304.18181818182;108.545454545455
59139;2023;186;153;33;82.258064516129;17.741935483871;90835.6451612903;1165.8064516129;79.7258064516129
59140;2023;4;4;0;100;0;151500;1275.75;121.25
59141;2023;4;4;0;100;0;176225;1558.5;109.75
59142;2023;9;9;0;100;0;186147.222222222;2085.55555555556;91.8888888888889
59143;2023;105;99;6;94.2857142857143;5.71428571428571;231992.00952381;2465.90476190476;93.1238095238095
59144;2023;6;6;0;100;0;157166.666666667;2015.16666666667;79.6666666666667
59145;2023;6;6;0;100;0;282343.333333333;2706.83333333333;103.666666666667
59146;2023;27;26;1;96.2962962962963;3.7037037037037;419090.740740741;3426.48148148148;117.333333333333
59148;2023;1;1;0;100;0;2,00E+05;1681;119
59149;2023;12;12;0;100;0;122041.666666667;1233.08333333333;97.8333333333333
59150;2023;4;4;0;100;0;434000;3552;122.5
59151;2023;21;21;0;100;0;183473.428571429;1662.71428571429;112.238095238095
59152;2023;118;106;12;89.8305084745763;10.1694915254237;240570.169491525;2510.54237288136;96.635593220339
59153;2023;79;67;12;84.8101265822785;15.1898734177215;122860.050632911;1420.03797468354;88.2151898734177
59155;2023;229;212;17;92.5764192139738;7.4235807860262;157960.537117904;1828.9519650655;88.7161572052402
59156;2023;21;16;5;76.1904761904762;23.8095238095238;158112.333333333;1768.2380952381;93.4761904761905
59157;2023;20;20;0;100;0;131046.8;1274.7;99.65
59158;2023;35;35;0;100;0;293258.514285714;2698.31428571429;110.2
59159;2023;4;4;0;100;0;273975;1821.5;156.75
59160;2023;39;39;0;100;0;113355.897435897;1289.20512820513;86.9230769230769
59161;2023;8;8;0;100;0;186262.5;1516.5;117.875
59162;2023;5;5;0;100;0;251540;2075.2;120
59163;2023;327;219;108;66.9724770642202;33.0275229357798;267651.510703364;2882.38226299694;88.2110091743119
59164;2023;1;1;0;100;0;85700;1339;64
59165;2023;59;59;0;100;0;159626.186440678;1895.38983050847;85.2542372881356
59166;2023;16;16;0;100;0;265335.4375;2221.125;119.4375
59168;2023;62;52;10;83.8709677419355;16.1290322580645;300462.903225806;3127.58064516129;94.258064516129
59169;2023;1;1;0;100;0;215000;2009;107
59170;2023;44;43;1;97.7272727272727;2.27272727272727;118637.818181818;1351.77272727273;88.1818181818182
59172;2023;178;170;8;95.5056179775281;4.49438202247191;80228.9831460674;1023.99438202247;78.8370786516854
59173;2023;18;16;2;88.8888888888889;11.1111111111111;424638.222222222;3220.55555555556;126.833333333333
59174;2023;5;5;0;100;0;129660;1424.8;91.8
59175;2023;5;5;0;100;0;131200;1357;103.8
59176;2023;1;1;0;100;0;169000;1331;127
59177;2023;8;8;0;100;0;129800;1377.875;95.75
59178;2023;421;238;183;56.5320665083135;43.4679334916865;136785.346793349;1676.63420427553;82.104513064133
59179;2023;62;62;0;100;0;126140.435483871;1357.35483870968;92.758064516129
59180;2023;9;9;0;100;0;273300;2318;129.666666666667
59181;2023;7;7;0;100;0;202845.714285714;1486.85714285714;133.857142857143
59182;2023;1;1;0;100;0;228000;2280;100
59183;2023;1001;599;402;59.8401598401598;40.1598401598402;179318.467532468;2157.12387612388;85.0789210789211
59184;2023;4;4;0;100;0;214225;1963.25;121.75
59185;2023;11;11;0;100;0;168813.181818182;1476.18181818182;116.272727272727
59186;2023;2;2;0;100;0;169000;1825;130
59187;2023;3;3;0;100;0;305810.666666667;1657.33333333333;187.666666666667
59188;2023;1;1;0;100;0;270000;1862;145
59189;2023;10;10;0;100;0;227562.8;2068.8;115.4
59190;2023;13;13;0;100;0;229153.846153846;1939.15384615385;120.153846153846
59191;2023;8;8;0;100;0;117422.5;1384.25;84.625
59192;2023;3;3;0;100;0;91666.6666666667;1142.66666666667;79.6666666666667
59193;2023;37;37;0;100;0;242893.054054054;2619.59459459459;91.972972972973
59194;2023;13;13;0;100;0;130910.230769231;1416.23076923077;99.8461538461538
59195;2023;12;12;0;100;0;341708.5;3494;97.25
59196;2023;19;17;2;89.4736842105263;10.5263157894737;392876.315789474;3844.10526315789;106.052631578947
59197;2023;24;24;0;100;0;361795.833333333;3186.95833333333;115.166666666667
59198;2023;3;2;1;66.6666666666667;33.3333333333333;125000;1351;87
59199;2023;4;4;0;100;0;191100;1540.25;129.5
59200;2023;7;7;0;100;0;226785.714285714;2328.42857142857;99.5714285714286
59201;2023;5;5;0;100;0;325240;3059.4;111
59202;2023;65;55;10;84.6153846153846;15.3846153846154;247012.876923077;2510.23076923077;92.9230769230769
59203;2023;17;16;1;94.1176470588235;5.88235294117647;148870.705882353;1714.29411764706;88.8235294117647
59204;2023;1;1;0;100;0;140000;1373;102
59205;2023;68;68;0;100;0;111065.529411765;1282.36764705882;87.3970588235294
59206;2023;35;34;1;97.1428571428571;2.85714285714286;124713.285714286;1327.54285714286;96.3428571428571
59207;2023;29;28;1;96.551724137931;3.44827586206897;138036.689655172;1361.51724137931;101
59208;2023;1;1;0;100;0;558000;5215;107
59209;2023;12;12;0;100;0;135883.333333333;1492.75;88.9166666666667
59210;2023;23;23;0;100;0;238324.782608696;2163.13043478261;110.521739130435
59211;2023;7;7;0;100;0;193140;1824.85714285714;100.714285714286
59212;2023;72;66;6;91.6666666666667;8.33333333333333;194610.861111111;1967.29166666667;101.236111111111
59213;2023;6;6;0;100;0;185825;1652.5;110.833333333333
59214;2023;15;15;0;100;0;209062.8;1979.26666666667;107.6
59215;2023;6;6;0;100;0;296937.333333333;2407.16666666667;122.5
59216;2023;1;1;0;100;0;70000;886;79
59218;2023;5;5;0;100;0;103826.6;1136.6;88.2
59219;2023;2;2;0;100;0;142110;1473.5;98
59220;2023;220;162;58;73.6363636363636;26.3636363636364;198534.190909091;2580.74545454545;78.0636363636364
59221;2023;23;15;8;65.2173913043478;34.7826086956522;150852.173913043;1919.5652173913;78.1739130434783
59222;2023;26;26;0;100;0;278005.038461538;2823;113.5
59223;2023;5;5;0;100;0;112780;1165.8;92.6
59224;2023;17;17;0;100;0;132353.529411765;1578.70588235294;77.9411764705882
59225;2023;70;68;2;97.1428571428571;2.85714285714286;161207.1;1592.08571428571;99.6714285714286
59226;2023;10;10;0;100;0;138370;945.4;136.7
59227;2023;50;50;0;100;0;152547.18;1725.88;88.44
59228;2023;9;8;1;88.8888888888889;11.1111111111111;188952.777777778;1790.66666666667;106.333333333333
59229;2023;5;5;0;100;0;193996;1873.4;102.2
59230;2023;61;52;9;85.2459016393443;14.7540983606557;148631;1767.81967213115;92.1967213114754
59231;2023;13;13;0;100;0;139757.692307692;1396.53846153846;99.2307692307692
59232;2023;2;2;0;100;0;181000;1540;117.5
59233;2023;5;5;0;100;0;113200;1403.2;79.6
59234;2023;40;40;0;100;0;143800.5;1696.425;85.075
59236;2023;7;7;0;100;0;147485.714285714;1289.57142857143;127.285714285714
59237;2023;10;10;0;100;0;259430;1900.9;134.7
59238;2023;10;10;0;100;0;200560;1884.6;107.4
59239;2023;51;51;0;100;0;246394.156862745;2095.47058823529;121.313725490196
59241;2023;6;6;0;100;0;168727.5;1918;102.166666666667
59242;2023;3;3;0;100;0;172346.666666667;1893;90.6666666666667
59243;2023;6;6;0;100;0;125703.333333333;1375.66666666667;95.8333333333333
59244;2023;13;13;0;100;0;231640.538461538;2034;112.307692307692
59246;2023;4;4;0;100;0;145557.5;1378.25;109
59247;2023;17;17;0;100;0;271943.823529412;3078.11764705882;93.6470588235294
59249;2023;100;98;2;98;2;109156.51;1211.9;95.42
59250;2023;27;27;0;100;0;365279.555555556;3182.14814814815;118.962962962963
59251;2023;5;5;0;100;0;306919;1710.6;186.8
59252;2023;25;25;0;100;0;290678.8;2882.32;106.52
59253;2023;59;58;1;98.3050847457627;1.69491525423729;103780.203389831;1143.61016949153;89.135593220339
59254;2023;11;11;0;100;0;194945;1831.90909090909;107.272727272727
59255;2023;3;3;0;100;0;137033.333333333;1245.33333333333;103.666666666667
59256;2023;36;36;0;100;0;250893.555555556;2721.05555555556;91.1666666666667
59257;2023;11;11;0;100;0;381214.545454545;2895.63636363636;129.090909090909
59258;2023;26;23;3;88.4615384615385;11.5384615384615;289508.076923077;2705.38461538462;106.423076923077
59259;2023;3;3;0;100;0;240466.666666667;3373;90.3333333333333
59260;2023;44;43;1;97.7272727272727;2.27272727272727;214324.431818182;2310.68181818182;94.1363636363636
59261;2023;24;24;0;100;0;104637.5;1132.625;90.8333333333333
59262;2023;27;27;0;100;0;235911.481481481;2137.11111111111;110.222222222222
59263;2023;11;11;0;100;0;195650;1777.54545454545;116.272727272727
59264;2023;9;9;0;100;0;141650;1326.55555555556;100.888888888889
59265;2023;19;19;0;100;0;201314.210526316;1852.52631578947;104.631578947368
59266;2023;32;32;0;100;0;287479.59375;2886.84375;103.3125
59267;2023;5;5;0;100;0;151800;1437.2;109.2
59268;2023;63;57;6;90.4761904761905;9.52380952380952;190481.301587302;1886.7619047619;99.7619047619048
59269;2023;22;22;0;100;0;134545.454545455;1267.59090909091;105.818181818182
59270;2023;2;2;0;100;0;110000;800;125.5
59271;2023;80;64;16;80;20;145668.9375;1598.8375;92.1375
59272;2023;48;48;0;100;0;149124.479166667;1768.66666666667;86.25
59273;2023;107;95;12;88.785046728972;11.214953271028;182969.682242991;2034.1214953271;90.7383177570093
59274;2023;10;10;0;100;0;152640;1235.6;127.9
59275;2023;16;15;1;93.75;6.25;414403.125;3522.5625;116.125
59276;2023;33;33;0;100;0;141261.212121212;1615.60606060606;87.2424242424242
59277;2023;6;6;0;100;0;195596.666666667;1698.83333333333;108.5
59278;2023;42;38;4;90.4761904761905;9.52380952380952;240439.166666667;2690.95238095238;91.8571428571429
59279;2023;208;184;24;88.4615384615385;11.5384615384615;194191.649038462;2190.49038461538;88.5144230769231
59280;2023;2;2;0;100;0;226000;1848;123
59281;2023;13;13;0;100;0;258823.846153846;2568.23076923077;97.7692307692308
59282;2023;4;4;0;100;0;120850;1682;83
59283;2023;6;6;0;100;0;217333.333333333;1896.33333333333;118.833333333333
59284;2023;49;46;3;93.8775510204082;6.12244897959184;167480.857142857;1795.02040816327;93.0204081632653
59285;2023;37;37;0;100;0;135763.540540541;1483.16216216216;88.4054054054054
59286;2023;183;118;65;64.4808743169399;35.5191256830601;198074.579234973;2474.86338797814;81.7377049180328
59287;2023;3;3;0;100;0;70666.6666666667;935.333333333333;72.6666666666667
59288;2023;26;26;0;100;0;134038.461538462;1450.57692307692;90.2692307692308
59289;2023;13;13;0;100;0;164250;1275.76923076923;125.923076923077
59290;2023;2;2;0;100;0;278915;1766.5;149
59291;2023;103;103;0;100;0;105043.553398058;1175.78640776699;91.5728155339806
59292;2023;30;30;0;100;0;116176;1381.9;82.1
59293;2023;12;12;0;100;0;188608.333333333;1784.16666666667;110.333333333333
59294;2023;1;1;0;100;0;70000;648;108
59295;2023;228;183;45;80.2631578947368;19.7368421052632;176048.140350877;1988.52631578947;88.9956140350877
59296;2023;4;4;0;100;0;203487.5;1803.25;111.75
59297;2023;19;19;0;100;0;173292.105263158;1614.57894736842;108.052631578947
59299;2023;180;176;4;97.7777777777778;2.22222222222222;317237.65;2953.97777777778;104.294444444444
59300;2023;6;6;0;100;0;132566.666666667;1275.66666666667;110.5
59301;2023;36;36;0;100;0;171741.111111111;1655.80555555556;107.611111111111
59302;2023;29;27;2;93.1034482758621;6.89655172413793;145419.793103448;1750.58620689655;82.551724137931
59303;2023;26;26;0;100;0;336287.423076923;2852.46153846154;117.807692307692
59304;2023;1;1;0;100;0;346000;3844;90
59305;2023;16;16;0;100;0;171047.25;1854.4375;89
59306;2023;1;1;0;100;0;69000;841;82
59307;2023;5;5;0;100;0;159860;1663.4;96.8
59308;2023;9;8;1;88.8888888888889;11.1111111111111;254935.555555556;3015.55555555556;86.3333333333333
59309;2023;33;32;1;96.969696969697;3.03030303030303;199420.151515152;1867.48484848485;106.636363636364
59310;2023;9;9;0;100;0;236405.555555556;2044.44444444444;131.333333333333
59311;2023;5;5;0;100;0;103204;1044.6;99.2
59312;2023;4;4;0;100;0;138500;1217.75;118.5
59313;2023;9;9;0;100;0;132055.555555556;1589.77777777778;81.2222222222222
59314;2023;24;24;0;100;0;158818.083333333;1588.41666666667;101.375
59315;2023;6;6;0;100;0;168166.666666667;2122.16666666667;78
59316;2023;32;32;0;100;0;272368.75;2605.59375;103.84375
59317;2023;78;78;0;100;0;181808.076923077;2125.76923076923;85.6153846153846
59318;2023;7;7;0;100;0;160871.428571429;1653;101.714285714286
59319;2023;22;22;0;100;0;260609.090909091;2356.59090909091;115.454545454545
59320;2023;17;17;0;100;0;272461.764705882;2498.52941176471;111.705882352941
59321;2023;7;7;0;100;0;141571.428571429;1350.71428571429;112
59322;2023;26;26;0;100;0;132853.846153846;1490;87.7692307692308
59323;2023;10;10;0;100;0;246221;2047.2;122.5
59324;2023;87;84;3;96.551724137931;3.44827586206897;110161.32183908;1206.40229885057;93.7471264367816
59325;2023;3;3;0;100;0;231800;1771.33333333333;139
59326;2023;12;12;0;100;0;142708.333333333;1536.25;95.25
59327;2023;53;51;2;96.2264150943396;3.77358490566038;152441.773584906;1617.33962264151;96.9622641509434
59328;2023;367;240;127;65.3950953678474;34.6049046321526;334525.400544959;3629.44141689373;89.5258855585831
59329;2023;47;42;5;89.3617021276596;10.6382978723404;158549.574468085;1948.21276595745;83.2340425531915
59330;2023;18;18;0;100;0;327554;2869;121.166666666667
59331;2023;29;29;0;100;0;98296.5517241379;1052.13793103448;92.9310344827586
59332;2023;22;11;11;50;50;146220.909090909;2055.09090909091;75.0909090909091
59334;2023;15;13;2;86.6666666666667;13.3333333333333;168208.133333333;1737.33333333333;95.8
59335;2023;20;20;0;100;0;268680;2250.5;120.15
59336;2023;14;14;0;100;0;90492.4285714286;1138.85714285714;79.7142857142857
59337;2023;3;3;0;100;0;181333.333333333;1824.66666666667;100
59338;2023;6;6;0;100;0;250586.666666667;2277.16666666667;111.833333333333
59339;2023;93;86;7;92.4731182795699;7.52688172043011;263254.516129032;2662.08602150538;100.344086021505
59340;2023;35;32;3;91.4285714285714;8.57142857142857;250372.085714286;2358.4;107.085714285714
59341;2023;5;5;0;100;0;81154;852.2;89
59342;2023;1;1;0;100;0;113200;1301;87
59343;2023;102;78;24;76.4705882352941;23.5294117647059;262280.970588235;3069.63725490196;86.7843137254902
59344;2023;16;16;0;100;0;98012.5;1214.125;82.8125
59345;2023;16;16;0;100;0;139332.625;1668.625;82.1875
59346;2023;22;21;1;95.4545454545455;4.54545454545455;260004.545454545;2693.95454545455;97.0454545454545
59347;2023;8;8;0;100;0;116533.75;1435;81.25
59348;2023;13;13;0;100;0;145196.153846154;1501.92307692308;93.6153846153846
59349;2023;23;22;1;95.6521739130435;4.34782608695652;149805.652173913;1215.78260869565;119.173913043478
59350;2023;3338;899;2439;26.9322947872978;73.0677052127022;215862.141402037;3748.65308568005;61.9874176153385
59351;2023;8;8;0;100;0;139375;1558.875;83.625
59352;2023;94;81;13;86.1702127659574;13.8297872340426;317856.095744681;3060.07446808511;103.010638297872
59353;2023;3;3;0;100;0;213333.333333333;1654;130
59354;2023;6;6;0;100;0;249036.666666667;2022.16666666667;128
59356;2023;18;17;1;94.4444444444444;5.55555555555556;489125.555555556;3620.16666666667;133.166666666667
59357;2023;18;18;0;100;0;164724.722222222;1526.88888888889;111.277777777778
59358;2023;8;8;0;100;0;186637.5;1703.75;112.125
59359;2023;47;47;0;100;0;191400.361702128;1961.3829787234;97.2553191489362
59360;2023;239;134;105;56.0669456066946;43.9330543933054;172624.485355649;2664.22175732218;69.1004184100418
59361;2023;32;32;0;100;0;87823.75;1091.3125;81.71875
59363;2023;6;6;0;100;0;182450;2028.16666666667;108
59364;2023;10;8;2;80;20;341441;3244.2;102.8
59365;2023;41;31;10;75.609756097561;24.390243902439;91463.8048780488;1168.29268292683;81.0975609756098
59366;2023;6;6;0;100;0;220533.333333333;1921;112
59367;2023;135;97;38;71.8518518518519;28.1481481481481;190265.014814815;2415.77037037037;80.2222222222222
59368;2023;395;139;256;35.1898734177215;64.8101265822785;281901.805063291;3545.04303797468;79.0405063291139
59369;2023;41;38;3;92.6829268292683;7.31707317073171;139988.43902439;1505.14634146341;90.6585365853659
59370;2023;5;5;0;100;0;170630;1639.6;98
59371;2023;5;5;0;100;0;310000;3736;87.6
59372;2023;2;2;0;100;0;131625;1128.5;123.5
59374;2023;5;5;0;100;0;119036;1141;118.4
59375;2023;38;38;0;100;0;238177.105263158;2206.47368421053;108.394736842105
59377;2023;28;28;0;100;0;132806.428571429;1407.25;97.1785714285714
59378;2023;506;303;203;59.8814229249012;40.1185770750988;377694.02173913;4050.31422924901;89.6818181818182
59379;2023;14;14;0;100;0;161068.214285714;1559.35714285714;97.0714285714286
59381;2023;9;9;0;100;0;183722.222222222;1654;114.666666666667
59382;2023;13;13;0;100;0;102571.538461538;935.307692307692;108.153846153846
59383;2023;147;123;24;83.6734693877551;16.3265306122449;140294.850340136;1704.28571428571;82.3741496598639
59384;2023;9;9;0;100;0;154687.777777778;1388.88888888889;116.555555555556
59385;2023;17;17;0;100;0;99610.5882352941;1106.05882352941;88.1764705882353
59386;2023;140;126;14;90;10;289245.621428571;3515.07142857143;85
59387;2023;30;30;0;100;0;145574.5;1303.6;106.766666666667
59388;2023;21;21;0;100;0;268040.476190476;2403.2380952381;110.952380952381
59389;2023;15;15;0;100;0;158403.333333333;1513.46666666667;102
59390;2023;27;27;0;100;0;165313.333333333;1652.66666666667;100.148148148148
59391;2023;8;8;0;100;0;157106.25;1870.5;85.875
59392;2023;256;174;82;67.96875;32.03125;100132.828125;1203.90625;84.90625
59393;2023;8;8;0;100;0;175903.75;1694.75;100.125
59394;2023;6;6;0;100;0;100566.666666667;892.333333333333;105
59395;2023;4;4;0;100;0;93000;1566.5;74.25
59396;2023;8;8;0;100;0;202256.25;1885.875;107.25
59397;2023;6;6;0;100;0;188650;1921.5;97.8333333333333
59398;2023;44;43;1;97.7272727272727;2.27272727272727;565272.636363636;3561.34090909091;156.863636363636
59399;2023;20;20;0;100;0;294940;2503.2;117.95
59400;2023;100;93;7;93;7;186742.8;1976.42;99.76
59401;2023;13;13;0;100;0;252084.615384615;2092.76923076923;120.538461538462
59402;2023;12;12;0;100;0;211604.25;2063.91666666667;102.333333333333
59403;2023;10;10;0;100;0;242180;2249.6;109.7
59405;2023;5;5;0;100;0;191103;1689.2;112
59406;2023;5;5;0;100;0;100770;1235.4;82.6
59407;2023;9;9;0;100;0;140077.777777778;1301.88888888889;109.222222222222
59408;2023;13;13;0;100;0;273471.769230769;2427.23076923077;106.307692307692
59409;2023;22;22;0;100;0;133642.5;1438.04545454545;91.1363636363636
59410;2023;231;120;111;51.9480519480519;48.0519480519481;194816.329004329;2539.4025974026;73.5844155844156
59411;2023;23;23;0;100;0;305829;2914.86956521739;105.391304347826
59412;2023;2;2;0;100;0;95000;994.5;87.5
59413;2023;7;7;0;100;0;124321.428571429;1293.42857142857;92.4285714285714
59414;2023;25;23;2;92;8;162679.56;1826.48;93.16
59415;2023;1;1;0;100;0;307250;2062;149
59416;2023;31;31;0;100;0;193374.838709677;1964.03225806452;105.290322580645
59418;2023;8;8;0;100;0;107383.75;1264;90.25
59419;2023;13;12;1;92.3076923076923;7.69230769230769;249107.692307692;2174.15384615385;114.692307692308
59421;2023;163;135;28;82.8220858895705;17.1779141104294;373959.030674847;3566.8527607362;100.141104294479
59422;2023;7;7;0;100;0;134785.714285714;1680.57142857143;82.1428571428571
59423;2023;13;13;0;100;0;272761.923076923;2633.46153846154;114.076923076923
59424;2023;15;14;1;93.3333333333333;6.66666666666667;139223.333333333;1343.86666666667;105.466666666667
59425;2023;2;2;0;100;0;155379.5;1287.5;122
59426;2023;93;85;8;91.3978494623656;8.60215053763441;269907.569892473;2676.52688172043;100.064516129032
59427;2023;9;9;0;100;0;371425;3887.33333333333;89.7777777777778
59428;2023;43;42;1;97.6744186046512;2.32558139534884;104098.139534884;1107.76744186047;93.5581395348837
59429;2023;23;23;0;100;0;128606.52173913;1537.69565217391;86.9130434782609
59430;2023;15;15;0;100;0;93326.6666666667;1095.4;84.3333333333333
59431;2023;85;80;5;94.1176470588235;5.88235294117647;238250.164705882;2492.91764705882;99.4
59432;2023;7;5;2;71.4285714285714;28.5714285714286;132392.857142857;1441.85714285714;95.2857142857143
59433;2023;4;4;0;100;0;158762.5;1963.25;88
59434;2023;18;18;0;100;0;272996.388888889;2375.38888888889;115.333333333333
59435;2023;32;31;1;96.875;3.125;296449.6875;2751.5625;111.78125
59436;2023;9;9;0;100;0;141224.444444444;1338.55555555556;97.6666666666667
59437;2023;9;9;0;100;0;278055.555555556;2594.55555555556;109.777777777778
59438;2023;4;4;0;100;0;153250;1579.5;104.75
59439;2023;2;2;0;100;0;148000;1590.5;94.5
59440;2023;11;11;0;100;0;116448.636363636;1363.63636363636;89.3636363636364
59441;2023;7;7;0;100;0;184696.428571429;1873.85714285714;113.857142857143
59442;2023;5;5;0;100;0;184760;1506.6;112.6
59443;2023;3;3;0;100;0;202820;2127.33333333333;100
59444;2023;4;4;0;100;0;205562.5;1696.5;110.5
59445;2023;9;9;0;100;0;139833.333333333;1403.33333333333;99.7777777777778
59446;2023;2;2;0;100;0;174000;1929.5;87
59447;2023;75;72;3;96;4;142303.64;1664.13333333333;87.4933333333333
59448;2023;5;5;0;100;0;150200;1349.6;106.4
59449;2023;93;79;14;84.9462365591398;15.0537634408602;186472.591397849;2248.79569892473;84.6559139784946
59450;2023;6;6;0;100;0;147283.333333333;1496.33333333333;103.5
59451;2023;3;3;0;100;0;207416.666666667;1809.66666666667;114
59452;2023;50;50;0;100;0;193743.34;2181.32;90.22
59453;2023;7;7;0;100;0;256921.428571429;1987.42857142857;136.857142857143
59454;2023;6;5;1;83.3333333333333;16.6666666666667;179250;1827.33333333333;95.3333333333333
59455;2023;6;6;0;100;0;188858.333333333;1995;95.3333333333333
59456;2023;49;45;4;91.8367346938776;8.16326530612245;148576.836734694;1666.12244897959;87.8775510204082
59457;2023;95;73;22;76.8421052631579;23.1578947368421;246776.210526316;2738.37894736842;91.1473684210526
59458;2023;13;13;0;100;0;407057.692307692;3435.92307692308;116.615384615385
59459;2023;62;55;7;88.7096774193548;11.2903225806452;168480.967741935;1764.82258064516;98.8064516129032
59462;2023;76;56;20;73.6842105263158;26.3157894736842;261705.960526316;2807.51315789474;92.8684210526316
59463;2023;8;8;0;100;0;205667;1886;105.875
59464;2023;22;22;0;100;0;122494.090909091;1344.68181818182;94.5
59465;2023;4;4;0;100;0;169625;1611.75;110.5
59466;2023;45;37;8;82.2222222222222;17.7777777777778;222551.777777778;2735.42222222222;87.7777777777778
59467;2023;19;19;0;100;0;141965.789473684;1423.94736842105;101.473684210526
59468;2023;3;3;0;100;0;234916.666666667;1974.33333333333;122.666666666667
59469;2023;4;4;0;100;0;283000;2360.5;121
59470;2023;14;14;0;100;0;324942.857142857;3156.42857142857;103.642857142857
59471;2023;24;24;0;100;0;202605.416666667;1943.54166666667;109.083333333333
59472;2023;6;6;0;100;0;174416.666666667;1766.33333333333;99.3333333333333
59473;2023;4;4;0;100;0;262500;2607.5;103.5
59474;2023;13;13;0;100;0;135608.153846154;1362.84615384615;104.769230769231
59475;2023;23;22;1;95.6521739130435;4.34782608695652;216666.956521739;2273.65217391304;96.9565217391304
59476;2023;28;25;3;89.2857142857143;10.7142857142857;195511.678571429;1778.89285714286;107.607142857143
59477;2023;45;44;1;97.7777777777778;2.22222222222222;196484.555555556;2326.66666666667;84.2222222222222
59478;2023;15;15;0;100;0;201186.666666667;1970.06666666667;100.666666666667
59479;2023;37;37;0;100;0;162918.918918919;1605.75675675676;102.756756756757
59480;2023;10;10;0;100;0;189470;1494;122.6
59481;2023;39;36;3;92.3076923076923;7.69230769230769;138959.230769231;1517.66666666667;90.9487179487179
59482;2023;63;60;3;95.2380952380952;4.76190476190476;317693.936507937;3116.42857142857;99.8730158730159
59484;2023;42;39;3;92.8571428571429;7.14285714285714;105517.023809524;1210.02380952381;92.7857142857143
59485;2023;27;27;0;100;0;133322.222222222;1200.11111111111;113.37037037037
59486;2023;25;25;0;100;0;156504.48;1632.44;95.32
59487;2023;12;12;0;100;0;500979.166666667;3775.75;133
59488;2023;29;27;2;93.1034482758621;6.89655172413793;144046.724137931;1494.55172413793;99.2758620689655
59489;2023;39;39;0;100;0;219636.538461538;1965.53846153846;112.615384615385
59491;2023;90;85;5;94.4444444444444;5.55555555555556;125867.688888889;1402.5;89.3222222222222
59492;2023;5;5;0;100;0;136591;1541.4;90.2
59493;2023;2;2;0;100;0;139800;913;177.5
59495;2023;26;25;1;96.1538461538462;3.84615384615385;120135.769230769;1316.26923076923;91.3461538461538
59496;2023;4;4;0;100;0;100250;1222;77.5
59497;2023;12;12;0;100;0;121312.5;1344.16666666667;102.083333333333
59498;2023;3;3;0;100;0;164000;1263;124
59499;2023;18;18;0;100;0;190065.555555556;1866.33333333333;105.944444444444
59500;2023;5;5;0;100;0;150370;1461.4;109.6
59501;2023;13;13;0;100;0;185790;1906.15384615385;98.9230769230769
59502;2023;6;6;0;100;0;111266.666666667;1296.16666666667;86.3333333333333
59503;2023;1;1;0;100;0;241000;2459;98
59504;2023;38;38;0;100;0;133250.763157895;1425.42105263158;92.4473684210526
59505;2023;5;5;0;100;0;287760;2326;123.4
59506;2023;4;4;0;100;0;134975;1028;129.5
59507;2023;178;134;44;75.2808988764045;24.7191011235955;206860.949438202;2439.57865168539;86.314606741573
59508;2023;135;122;13;90.3703703703704;9.62962962962963;281797.518518519;2774.7037037037;100.318518518519
59509;2023;59;57;2;96.6101694915254;3.38983050847458;165409.881355932;1658.01694915254;97.5762711864407
59511;2023;17;17;0;100;0;275977.235294118;2492.76470588235;112.058823529412
59512;2023;796;535;261;67.2110552763819;32.7889447236181;140059.888190955;1756.1243718593;82.3429648241206
59513;2023;2;2;0;100;0;261250;2924;89
59514;2023;51;41;10;80.3921568627451;19.6078431372549;127931.784313725;1348.78431372549;89.0392156862745
59515;2023;6;5;1;83.3333333333333;16.6666666666667;209759.166666667;3304.5;67
59516;2023;8;8;0;100;0;214312.5;1960.25;110.375
59517;2023;10;10;0;100;0;196300;1860.2;109.1
59518;2023;4;4;0;100;0;133795;1727;79.75
59519;2023;17;17;0;100;0;295634.705882353;2305.47058823529;133.823529411765
59520;2023;21;21;0;100;0;158208.571428571;1515.09523809524;103.857142857143
59521;2023;6;6;0;100;0;135000;1185.16666666667;109.333333333333
59522;2023;21;21;0;100;0;359337.142857143;3347.95238095238;109.238095238095
59523;2023;24;22;2;91.6666666666667;8.33333333333333;341306.375;3553;98.2083333333333
59524;2023;75;75;0;100;0;229696;2522.81333333333;92.5066666666667
59525;2023;29;29;0;100;0;101353.413793103;1104.1724137931;89.1034482758621
59526;2023;165;154;11;93.3333333333333;6.66666666666667;161560.83030303;1755.87272727273;91.7393939393939
59527;2023;188;104;84;55.3191489361702;44.6808510638298;251934.85106383;3354.65957446808;76.7340425531915
59528;2023;11;11;0;100;0;99318.1818181818;987.818181818182;108.454545454545
59529;2023;3;3;0;100;0;148670.333333333;1140.33333333333;127.666666666667
59530;2023;3;3;0;100;0;287666.666666667;2234;124.666666666667
59531;2023;3;3;0;100;0;94666.6666666667;1277;75
59532;2023;1;1;0;100;0;318700;2634;121
59533;2023;20;20;0;100;0;101706;1236.1;85
59534;2023;9;8;1;88.8888888888889;11.1111111111111;115688.888888889;1147.44444444444;103.111111111111
59535;2023;21;21;0;100;0;235995.238095238;2190.61904761905;107.52380952381
59536;2023;7;7;0;100;0;263563.571428571;1985.85714285714;125.571428571429
59537;2023;3;3;0;100;0;121766.666666667;1100.66666666667;102
59538;2023;1;1;0;100;0;90000;1216;74
59539;2023;7;7;0;100;0;188057.142857143;1854.85714285714;101.571428571429
59541;2023;9;9;0;100;0;72439;963.666666666667;87.3333333333333
59542;2023;4;4;0;100;0;117975;1038;102
59543;2023;6;6;0;100;0;130166.666666667;1440.16666666667;93.3333333333333
59544;2023;105;77;28;73.3333333333333;26.6666666666667;188401.066666667;1980.29523809524;94.647619047619
59545;2023;11;11;0;100;0;91309.0909090909;888.545454545455;107.272727272727
59546;2023;15;15;0;100;0;194765.333333333;1821.6;107.733333333333
59547;2023;11;11;0;100;0;121173.636363636;1399.27272727273;89.8181818181818
59548;2023;5;5;0;100;0;176684.4;1854.4;95.8
59549;2023;2;2;0;100;0;177500;1919;101.5
59550;2023;40;40;0;100;0;184108.875;2096.55;90.9
59551;2023;12;12;0;100;0;272112.5;2357.75;121.666666666667
59552;2023;8;8;0;100;0;183125;1678;108.5
59553;2023;47;44;3;93.6170212765958;6.38297872340426;262686.404255319;2644.23404255319;102.574468085106
59554;2023;6;6;0;100;0;349103.333333333;3133.66666666667;114.166666666667
59555;2023;10;9;1;90;10;85118.8;1044.6;83.4
59556;2023;4;4;0;100;0;125500;1173.5;106.75
59557;2023;29;19;10;65.5172413793103;34.4827586206897;138496.379310345;2018.31034482759;71.1379310344828
59558;2023;13;13;0;100;0;129396.153846154;1315.23076923077;97.6153846153846
59559;2023;21;21;0;100;0;237496.904761905;2133.42857142857;109.190476190476
59560;2023;159;119;40;74.8427672955975;25.1572327044025;203224.308176101;2678.86163522013;78.062893081761
59562;2023;4;4;0;100;0;96250;989.75;100.25
59563;2023;1;1;0;100;0;272000;1417;192
59564;2023;19;18;1;94.7368421052632;5.26315789473684;125415.789473684;1428.15789473684;88.8947368421053
59565;2023;5;5;0;100;0;235559.8;2015.6;115.2
59566;2023;29;27;2;93.1034482758621;6.89655172413793;254673.965517241;2843.10344827586;90
59567;2023;7;7;0;100;0;175226;1527;113.857142857143
59568;2023;7;7;0;100;0;207270.714285714;1777.57142857143;118.857142857143
59569;2023;148;118;30;79.7297297297297;20.2702702702703;116109.716216216;1356.06081081081;83.1283783783784
59570;2023;11;11;0;100;0;337452.727272727;2783.72727272727;123.727272727273
59571;2023;45;43;2;95.5555555555556;4.44444444444444;99125.7777777778;1011.35555555556;98.9111111111111
59572;2023;23;23;0;100;0;125395.652173913;1138;116.086956521739
59573;2023;3;3;0;100;0;111333.333333333;1196.66666666667;98.6666666666667
59574;2023;122;108;14;88.5245901639344;11.4754098360656;127492.401639344;1563.09836065574;83.2540983606557
59575;2023;2;2;0;100;0;248510;2211.5;108.5
59576;2023;13;13;0;100;0;240826.923076923;2317.07692307692;106.692307692308
59577;2023;4;4;0;100;0;140892.5;1420;96.5
59578;2023;16;16;0;100;0;196050.3125;1795.0625;107.625
59579;2023;12;12;0;100;0;228240;2022.25;111.166666666667
59580;2023;30;28;2;93.3333333333333;6.66666666666667;199529.333333333;1891.6;106.6
59581;2023;26;25;1;96.1538461538462;3.84615384615385;217117.307692308;2245.92307692308;96.2307692307692
59582;2023;9;9;0;100;0;230694.444444444;2419.88888888889;95.7777777777778
59583;2023;9;9;0;100;0;191600;1922.33333333333;103.222222222222
59584;2023;12;12;0;100;0;199872.833333333;1788.16666666667;110.416666666667
59585;2023;41;35;6;85.3658536585366;14.6341463414634;244974.243902439;2715.0243902439;92.1707317073171
59586;2023;64;54;10;84.375;15.625;308307.625;2979.5625;103.5
59587;2023;5;5;0;100;0;286540;2611.8;115
59588;2023;71;68;3;95.7746478873239;4.22535211267606;289306.845070423;2637.64788732394;110.845070422535
59589;2023;16;16;0;100;0;144287.5;1644.125;89.4375
59590;2023;7;7;0;100;0;137471.428571429;1505.42857142857;94.5714285714286
59591;2023;4;4;0;100;0;179260;1465.5;139
59592;2023;47;47;0;100;0;184209.14893617;2066.93617021277;90.8297872340426
59593;2023;7;7;0;100;0;147498.714285714;1321.85714285714;109.428571428571
59594;2023;5;5;0;100;0;169208.4;1713;101.2
59595;2023;8;8;0;100;0;157737.5;1581.125;101.5
59596;2023;7;7;0;100;0;221064.285714286;1995.42857142857;104.428571428571
59597;2023;9;9;0;100;0;213966.666666667;1841.55555555556;117.444444444444
59598;2023;37;37;0;100;0;278016.621621622;2847.48648648649;100.648648648649
59599;2023;1120;742;378;66.25;33.75;155852.927678571;1955.58303571429;80.9625
59600;2023;13;13;0;100;0;385697.692307692;3480.30769230769;111.153846153846
59601;2023;24;24;0;100;0;114169.875;1082.33333333333;102.208333333333
59602;2023;17;16;1;94.1176470588235;5.88235294117647;335591.764705882;3289.64705882353;100.882352941176
59603;2023;44;43;1;97.7272727272727;2.27272727272727;127571.25;1450.11363636364;88.7954545454545
59604;2023;10;10;0;100;0;118890;936.3;122.2
59605;2023;6;6;0;100;0;315815;2492;130.5
59606;2023;654;306;348;46.7889908256881;53.2110091743119;140013.555045872;1979.83027522936;74.5015290519878
59607;2023;8;8;0;100;0;174373.75;1702.25;112.25
59608;2023;6;6;0;100;0;154353.333333333;1751.16666666667;85.3333333333333
59609;2023;25;23;2;92;8;295433;2892.04;101.76
59610;2023;9;9;0;100;0;245913.888888889;1738.44444444444;138.333333333333
59611;2023;20;18;2;90;10;400501;3870.55;101.6
59612;2023;7;7;0;100;0;180892.857142857;1753.42857142857;111
59613;2023;11;11;0;100;0;217967.272727273;1850.09090909091;123.181818181818
59614;2023;15;15;0;100;0;116620;1345.73333333333;90.2
59615;2023;31;31;0;100;0;260083.161290323;2207.16129032258;123.032258064516
59616;2023;91;91;0;100;0;131754.725274725;1436.12087912088;94.032967032967
59617;2023;1;1;0;100;0;220000;1833;120
59618;2023;7;7;0;100;0;182459.428571429;1351.42857142857;131.571428571429
59619;2023;7;7;0;100;0;175928.571428571;1901.14285714286;92.4285714285714
59620;2023;7;7;0;100;0;215038.571428571;1898.42857142857;115
59622;2023;9;9;0;100;0;152238.888888889;1417.33333333333;99.5555555555556
59623;2023;1;1;0;100;0;187000;2033;92
59624;2023;21;21;0;100;0;100555.476190476;878.190476190476;110.904761904762
59625;2023;1;1;0;100;0;130000;756;172
59626;2023;15;15;0;100;0;213381.4;2108.6;104.6
59627;2023;6;6;0;100;0;182833.333333333;1727.33333333333;106.166666666667
59628;2023;7;7;0;100;0;247900;2198.71428571429;119.857142857143
59629;2023;12;12;0;100;0;179229.166666667;1844.91666666667;98.4166666666667
59630;2023;33;33;0;100;0;224740.303030303;2470.93939393939;93.1212121212121
59631;2023;21;21;0;100;0;113151.238095238;1033.80952380952;111.285714285714
59632;2023;39;39;0;100;0;154857.051282051;1749.53846153846;89.2564102564103
59633;2023;2;2;0;100;0;176000;1435.5;122
59634;2023;8;7;1;87.5;12.5;245400;2365.75;111.625
59635;2023;3;3;0;100;0;120733.333333333;1504.33333333333;96.6666666666667
59636;2023;147;103;44;70.0680272108844;29.9319727891156;331434.394557823;3608.19047619048;90.8027210884354
59637;2023;15;15;0;100;0;195914.666666667;1815.4;104.4
59638;2023;8;8;0;100;0;373631.25;2875.375;126.125
59639;2023;6;6;0;100;0;227830;2003.5;109
59640;2023;5;5;0;100;0;158040;1366.8;109.6
59641;2023;21;21;0;100;0;201873.476190476;2022.04761904762;102.904761904762
59642;2023;2;2;0;100;0;336250;2844;111
59643;2023;3;3;0;100;0;208803.333333333;2493.33333333333;93.3333333333333
59645;2023;5;5;0;100;0;116780;2235.8;72.2
59646;2023;252;193;59;76.5873015873016;23.4126984126984;308318.71031746;3335.6626984127;89.7301587301587
59647;2023;35;35;0;100;0;127643.142857143;1374.65714285714;92.6857142857143
59648;2023;166;90;76;54.2168674698795;45.7831325301205;207247.662650602;2463.78313253012;82.7650602409639
59649;2023;6;6;0;100;0;145500;1520.66666666667;95.3333333333333
59650;2023;382;322;60;84.2931937172775;15.7068062827225;159860.876963351;2025.69371727749;80.6361256544503
59651;2023;17;17;0;100;0;92837.9411764706;1111.35294117647;83.6470588235294
59652;2023;5;5;0;100;0;172304;1509;106
59653;2023;73;72;1;98.6301369863014;1.36986301369863;210564.260273973;2391.53424657534;87.3698630136986
59654;2023;49;48;1;97.9591836734694;2.04081632653061;122429.06122449;1343.55102040816;89.9387755102041
59655;2023;7;7;0;100;0;217464.285714286;2028.42857142857;110.285714285714
59656;2023;26;19;7;73.0769230769231;26.9230769230769;213730.692307692;2451.53846153846;89.5769230769231
59657;2023;5;5;0;100;0;179648;2291.4;82.4
59658;2023;4;4;0;100;0;342200;2484.5;127
59659;2023;28;28;0;100;0;96236.4285714286;992.25;97.1071428571429
59660;2023;34;33;1;97.0588235294118;2.94117647058824;293251.764705882;3114.29411764706;97.8529411764706
59661;2023;2;2;0;100;0;215197;1517;155
59662;2023;15;15;0;100;0;236060;2357.46666666667;100.266666666667
59663;2023;51;50;1;98.0392156862745;1.96078431372549;206574.098039216;2065.54901960784;102.117647058824
59665;2023;3;3;0;100;0;146613.333333333;1558.66666666667;84.6666666666667
59666;2023;12;12;0;100;0;202645.833333333;2034.75;105.833333333333
59667;2023;5;5;0;100;0;160700;1713.6;86
59668;2023;15;10;5;66.6666666666667;33.3333333333333;221610;2799.8;86.0666666666667
59669;2023;3;3;0;100;0;139800;1734;72.6666666666667
59670;2023;11;11;0;100;0;231529.272727273;2227.54545454545;100.818181818182
60001;2023;7;7;0;100;0;109714.285714286;1241.57142857143;84
60002;2023;8;8;0;100;0;246550;1803.75;135.125
60003;2023;2;2;0;100;0;257500;2419;107.5
60004;2023;4;4;0;100;0;125250;1541;79
60005;2023;10;9;1;90;10;194825;2078.3;105.4
60006;2023;14;14;0;100;0;195114.928571429;2270.07142857143;88.9285714285714
60007;2023;35;35;0;100;0;228970.457142857;2246.34285714286;104.942857142857
60008;2023;6;6;0;100;0;154603.333333333;1569.33333333333;97.5
60009;2023;17;17;0;100;0;232576.470588235;2482.94117647059;95.5882352941177
60010;2023;15;14;1;93.3333333333333;6.66666666666667;272440;2847.66666666667;99.8666666666667
60011;2023;7;7;0;100;0;109367.857142857;1637.85714285714;71.1428571428571
60012;2023;34;31;3;91.1764705882353;8.82352941176471;227822;2717.67647058824;86.7058823529412
60013;2023;15;14;1;93.3333333333333;6.66666666666667;250433.333333333;2819.6;92.7333333333333
60014;2023;5;5;0;100;0;191400;1887.4;99.4
60015;2023;3;3;0;100;0;211716.666666667;2185.33333333333;102
60016;2023;3;3;0;100;0;184166.666666667;2365.33333333333;88
60017;2023;7;7;0;100;0;163617.857142857;1621.71428571429;103
60019;2023;4;4;0;100;0;255875;1643.5;165.5
60020;2023;6;6;0;100;0;217668.333333333;2431;90
60021;2023;7;7;0;100;0;139357.142857143;1398.71428571429;110
60022;2023;15;15;0;100;0;518514.333333333;4572.93333333333;110.733333333333
60023;2023;4;4;0;100;0;205550;2480.5;85.75
60024;2023;5;5;0;100;0;208530;2021;104.6
60025;2023;17;17;0;100;0;167923.529411765;2037;83.4705882352941
60026;2023;4;4;0;100;0;183750;1823;101.75
60027;2023;8;8;0;100;0;256412.5;2843.25;103.625
60028;2023;3;3;0;100;0;367895;2743;127.666666666667
60029;2023;27;27;0;100;0;175076.111111111;2019;88.6296296296296
60030;2023;6;6;0;100;0;234483.333333333;2186.66666666667;107.833333333333
60032;2023;6;6;0;100;0;176766.666666667;1867.16666666667;99
60033;2023;12;11;1;91.6666666666667;8.33333333333333;575668.333333333;3832.16666666667;140.333333333333
60034;2023;9;9;0;100;0;206111.111111111;2021.33333333333;100.111111111111
60035;2023;7;7;0;100;0;139214.285714286;1292.85714285714;100
60036;2023;6;6;0;100;0;269102;2443.83333333333;117
60037;2023;3;3;0;100;0;176116.666666667;1436;122.666666666667
60039;2023;4;4;0;100;0;151875;1342.75;101.5
60040;2023;5;5;0;100;0;162680;1518.6;101.2
60041;2023;12;12;0;100;0;227485;2726.41666666667;100.833333333333
60042;2023;9;9;0;100;0;210971.222222222;2432.88888888889;88
60043;2023;5;5;0;100;0;120716;1208.6;99
60044;2023;19;19;0;100;0;159228.315789474;1892;89
60045;2023;7;7;0;100;0;280611.285714286;3422.85714285714;85.1428571428571
60046;2023;1;1;0;100;0;209000;3029;69
60047;2023;5;4;1;80;20;263200;2892.2;87.2
60048;2023;4;4;0;100;0;259392.5;3018.5;103
60049;2023;1;1;0;100;0;279000;3488;80
60050;2023;5;5;0;100;0;222600;2419;96
60051;2023;2;2;0;100;0;102500;1737;61.5
60053;2023;4;4;0;100;0;157025;1481.75;110.75
60054;2023;10;10;0;100;0;254693.5;2221.6;126.6
60055;2023;3;3;0;100;0;176666.666666667;1380.66666666667;129.666666666667
60057;2023;604;245;359;40.5629139072848;59.4370860927152;144380.870860927;2061.21357615894;71.6208609271523
60059;2023;2;2;0;100;0;130000;1479;87.5
60060;2023;7;6;1;85.7142857142857;14.2857142857143;373928.571428571;3211.42857142857;115.285714285714
60062;2023;1;1;0;100;0;106000;1071;99
60063;2023;10;10;0;100;0;247100;2481.2;104.2
60064;2023;9;9;0;100;0;214233.333333333;2021.77777777778;103.111111111111
60065;2023;10;10;0;100;0;211400;2242.9;94.3
60066;2023;7;7;0;100;0;161138.428571429;1939.71428571429;94.2857142857143
60067;2023;10;10;0;100;0;156610;1786.9;92.1
60068;2023;26;20;6;76.9230769230769;23.0769230769231;157065.769230769;1936.23076923077;82.9230769230769
60069;2023;9;8;1;88.8888888888889;11.1111111111111;247983.333333333;2798.11111111111;91.5555555555556
60070;2023;4;4;0;100;0;353250;3041.75;112.75
60071;2023;3;3;0;100;0;113316.666666667;1579.66666666667;68.3333333333333
60072;2023;5;5;0;100;0;229160;2232.6;105.4
60073;2023;1;1;0;100;0;239000;2078;115
60074;2023;6;6;0;100;0;282916.666666667;3066;94.3333333333333
60076;2023;8;8;0;100;0;102195;1309.25;78.75
60077;2023;1;1;0;100;0;150000;2055;73
60079;2023;10;10;0;100;0;253290;2810.7;92.9
60081;2023;4;4;0;100;0;247787.5;2765.5;92.5
60082;2023;8;8;0;100;0;132109.875;1567.75;83.25
60083;2023;12;12;0;100;0;231548.75;2051.08333333333;122.75
60084;2023;2;2;0;100;0;222500;1624;137
60085;2023;4;4;0;100;0;162500;1264.25;129.25
60086;2023;14;9;5;64.2857142857143;35.7142857142857;258311.357142857;3100.35714285714;88.6428571428571
60087;2023;3;3;0;100;0;398333.333333333;4026;125.666666666667
60088;2023;52;41;11;78.8461538461538;21.1538461538462;265857.326923077;3108.36538461538;88.0384615384615
60089;2023;7;7;0;100;0;257185.714285714;2247;111.428571428571
60090;2023;3;3;0;100;0;151784.333333333;2592;71.3333333333333
60091;2023;4;4;0;100;0;240656.25;3262.75;75.5
60092;2023;4;4;0;100;0;199500;1857.75;110.5
60093;2023;4;4;0;100;0;185500;1348;142.75
60094;2023;3;3;0;100;0;193200;1664.66666666667;111.333333333333
60095;2023;2;2;0;100;0;203650;2423.5;87
60097;2023;4;4;0;100;0;183000;2058;91.25
60098;2023;1;1;0;100;0;183000;2316;79
60100;2023;1;1;0;100;0;2,00E+05;1667;120
60101;2023;4;4;0;100;0;283450;2999.25;114
60102;2023;23;23;0;100;0;237833.913043478;2281.5652173913;104.739130434783
60103;2023;43;43;0;100;0;176727.162790698;2224.88372093023;85.8604651162791
60104;2023;45;44;1;97.7777777777778;2.22222222222222;149392.222222222;1720.11111111111;87.5333333333333
60105;2023;5;5;0;100;0;159740;1759.6;92.4
60106;2023;32;30;2;93.75;6.25;212560.46875;2389.875;91.875
60107;2023;33;31;2;93.9393939393939;6.06060606060606;219155.090909091;2526.78787878788;90.4242424242424
60108;2023;1;1;0;100;0;96000;857;112
60109;2023;4;4;0;100;0;102500;1550.25;62.5
60110;2023;1;1;0;100;0;178750;715;250
60111;2023;1;1;0;100;0;197950;1650;120
60112;2023;4;4;0;100;0;193738.5;1671.5;116.75
60113;2023;2;2;0;100;0;146250;1341.5;106.5
60114;2023;1;1;0;100;0;122000;1356;90
60115;2023;10;10;0;100;0;148331.7;2034.3;83.2
60116;2023;38;37;1;97.3684210526316;2.63157894736842;159521.289473684;1987.60526315789;85.7368421052632
60117;2023;1;1;0;100;0;114000;1443;79
60118;2023;4;4;0;100;0;129750;1416.75;91
60119;2023;21;21;0;100;0;145621.428571429;1697.52380952381;85.6666666666667
60120;2023;10;10;0;100;0;216500;2180.9;103.6
60122;2023;8;8;0;100;0;93687.5;1079.625;87.125
60123;2023;8;8;0;100;0;154125;1902.625;83.75
60124;2023;5;5;0;100;0;131170;1233.2;117.8
60125;2023;7;7;0;100;0;278881;2070.85714285714;145
60126;2023;5;5;0;100;0;207200;1780;116.2
60127;2023;6;6;0;100;0;146616.666666667;2006.5;80.1666666666667
60128;2023;3;3;0;100;0;82666.6666666667;1299.66666666667;77
60129;2023;17;17;0;100;0;195203;2019.94117647059;108.588235294118
60130;2023;8;8;0;100;0;247437.5;2245;120.125
60133;2023;6;6;0;100;0;132666.666666667;1870.33333333333;71.1666666666667
60134;2023;20;20;0;100;0;231872.5;2291.75;105.9
60135;2023;18;17;1;94.4444444444444;5.55555555555556;218176.666666667;2494.72222222222;90.4444444444444
60136;2023;3;3;0;100;0;214273.333333333;1987.33333333333;113.666666666667
60137;2023;3;3;0;100;0;125666.666666667;1681;74.6666666666667
60138;2023;9;7;2;77.7777777777778;22.2222222222222;361316.444444444;3895.77777777778;88.2222222222222
60139;2023;112;60;52;53.5714285714286;46.4285714285714;221002.098214286;3329.86607142857;67.8482142857143
60140;2023;4;4;0;100;0;296075;4435.5;73.25
60141;2023;170;24;146;14.1176470588235;85.8823529411765;290977.941176471;4152.67647058824;69.6176470588235
60142;2023;31;13;18;41.9354838709677;58.0645161290323;222987.516129032;3535.22580645161;65.8064516129032
60143;2023;31;24;7;77.4193548387097;22.5806451612903;193845.419354839;2597.70967741935;74.0322580645161
60145;2023;5;5;0;100;0;208200;1786.6;105.6
60146;2023;3;3;0;100;0;107000;1390;75
60147;2023;7;7;0;100;0;198757;2284;87.2857142857143
60148;2023;6;6;0;100;0;323741.666666667;2504.5;164
60149;2023;18;17;1;94.4444444444444;5.55555555555556;219672.666666667;2668.77777777778;85.2222222222222
60150;2023;9;9;0;100;0;179476.111111111;2046.88888888889;96.8888888888889
60151;2023;45;43;2;95.5555555555556;4.44444444444444;266132.933333333;2525.6;106.644444444444
60154;2023;18;18;0;100;0;252255.555555556;2715.61111111111;94.3888888888889
60155;2023;29;26;3;89.6551724137931;10.3448275862069;220175.517241379;2655.51724137931;86.551724137931
60156;2023;24;21;3;87.5;12.5;284962.5;2549.16666666667;102.833333333333
60157;2023;114;56;58;49.1228070175439;50.8771929824561;145456.070175439;2219.72807017544;67.3421052631579
60158;2023;2;2;0;100;0;117500;1872;62.5
60159;2023;491;125;366;25.4582484725051;74.5417515274949;196091.069246436;2605.55804480652;75.0346232179226
60160;2023;7;7;0;100;0;175467.428571429;1879.42857142857;103.285714285714
60162;2023;2;2;0;100;0;199750;2108.5;95.5
60163;2023;3;3;0;100;0;97077;1238.66666666667;87.3333333333333
60164;2023;7;7;0;100;0;170714.285714286;2115.85714285714;82.4285714285714
60165;2023;5;5;0;100;0;178880;2129.2;88.4
60166;2023;20;20;0;100;0;202135;2276.5;91
60167;2023;10;10;0;100;0;141525;1425.3;95
60168;2023;4;4;0;100;0;140875;1816.75;86.5
60169;2023;8;8;0;100;0;253897.625;2838.875;90.75
60170;2023;8;7;1;87.5;12.5;309681.25;3028.625;101.375
60171;2023;1;1;0;100;0;249000;1754;142
60172;2023;48;30;18;62.5;37.5;333730.791666667;3780.1875;90.5208333333333
60173;2023;12;5;7;41.6666666666667;58.3333333333333;133430.833333333;1845.83333333333;72.4166666666667
60174;2023;1;1;0;100;0;251000;1451;173
60175;2023;180;58;122;32.2222222222222;67.7777777777778;135456.416666667;2034.54444444444;66.4444444444444
60176;2023;153;83;70;54.2483660130719;45.7516339869281;208800.934640523;2794.60784313725;78.7058823529412
60177;2023;5;5;0;100;0;257012;1991.2;128.4
60178;2023;26;25;1;96.1538461538462;3.84615384615385;153550.653846154;1711.23076923077;92.5
60179;2023;1;1;0;100;0;197500;2380;83
60180;2023;6;6;0;100;0;167000;1699.5;101.833333333333
60181;2023;11;11;0;100;0;140967.272727273;1546.45454545455;103.818181818182
60182;2023;3;3;0;100;0;117166.666666667;1687.33333333333;72.6666666666667
60183;2023;2;2;0;100;0;117500;1860.5;72
60184;2023;1;1;0;100;0;165000;1774;93
60185;2023;11;11;0;100;0;260909.909090909;3000.90909090909;88.6363636363636
60186;2023;2;2;0;100;0;93000;1319;68.5
60187;2023;8;8;0;100;0;161875;1855.625;96.75
60188;2023;17;17;0;100;0;214229.411764706;2185.11764705882;103.294117647059
60189;2023;9;9;0;100;0;190155.555555556;1781.33333333333;113.333333333333
60191;2023;3;3;0;100;0;196333.333333333;2514;73.6666666666667
60193;2023;1;1;0;100;0;147500;1993;74
60194;2023;3;3;0;100;0;153333.333333333;1715;90.3333333333333
60195;2023;2;2;0;100;0;272070;2901;95
60196;2023;11;11;0;100;0;225494.181818182;2439.36363636364;98.4545454545455
60197;2023;8;8;0;100;0;220562.5;2095;108.875
60198;2023;4;4;0;100;0;162800;1472;116
60199;2023;2;2;0;100;0;156250;1642;95
60200;2023;1;1;0;100;0;168000;2333;72
60201;2023;5;5;0;100;0;129980;1322;100.6
60203;2023;6;5;1;83.3333333333333;16.6666666666667;141416.666666667;2031.66666666667;69
60204;2023;8;8;0;100;0;145762.5;1705.25;91.25
60205;2023;1;1;0;100;0;1,00E+05;1042;96
60206;2023;10;10;0;100;0;212250;2019.5;109.3
60207;2023;3;3;0;100;0;283583.333333333;2291.33333333333;121.666666666667
60208;2023;1;1;0;100;0;320000;2909;110
60209;2023;3;3;0;100;0;241666.666666667;2366;104
60210;2023;3;3;0;100;0;269000;2278;134
60211;2023;7;7;0;100;0;223742.857142857;2177.85714285714;109.714285714286
60212;2023;11;10;1;90.9090909090909;9.09090909090909;237030.909090909;2572.27272727273;94.4545454545455
60213;2023;11;6;5;54.5454545454545;45.4545454545455;229940.909090909;3325.63636363636;75.4545454545455
60214;2023;2;2;0;100;0;170000;1387;123
60215;2023;6;6;0;100;0;210916.666666667;2335;90
60216;2023;2;2;0;100;0;275000;2202;128
60217;2023;1;1;0;100;0;125000;1420;88
60218;2023;11;10;1;90.9090909090909;9.09090909090909;303428.181818182;2721.45454545455;116.636363636364
60219;2023;1;1;0;100;0;149000;2224;67
60220;2023;4;4;0;100;0;207900;1891.5;114.75
60221;2023;8;8;0;100;0;129500;1303.25;119.625
60222;2023;1;1;0;100;0;185000;2312;80
60223;2023;26;25;1;96.1538461538462;3.84615384615385;218552.307692308;2260.96153846154;100.346153846154
60224;2023;1;1;0;100;0;402000;3045;132
60225;2023;4;4;0;100;0;218402.75;1951.25;110.25
60226;2023;5;4;1;80;20;289822.6;3595.2;82.4
60227;2023;3;3;0;100;0;204966.666666667;1829.66666666667;112.666666666667
60228;2023;6;6;0;100;0;278066.666666667;2297.5;118.833333333333
60230;2023;1;1;0;100;0;241300;2742;88
60231;2023;3;2;1;66.6666666666667;33.3333333333333;246833.333333333;3438.66666666667;87.3333333333333
60232;2023;4;4;0;100;0;158030;1571.25;104
60233;2023;13;13;0;100;0;110496.538461538;1536.92307692308;76.2307692307692
60234;2023;24;20;4;83.3333333333333;16.6666666666667;157700;2020.75;78.5833333333333
60235;2023;10;10;0;100;0;173665;1972.1;98.4
60236;2023;1;1;0;100;0;120400;1672;72
60237;2023;1;1;0;100;0;168000;1732;97
60238;2023;33;28;5;84.8484848484848;15.1515151515152;324965.515151515;3090.33333333333;105.363636363636
60239;2023;7;7;0;100;0;237018.571428571;3022.57142857143;80.1428571428571
60240;2023;2;2;0;100;0;140000;1753;92
60241;2023;3;3;0;100;0;351352.333333333;3334.33333333333;132
60242;2023;5;5;0;100;0;154100;1291.8;124.2
60243;2023;1;1;0;100;0;179000;2131;84
60244;2023;2;2;0;100;0;127895;1369;91
60245;2023;20;20;0;100;0;118257.4;1558.4;79.55
60247;2023;1;1;0;100;0;270000;1262;214
60248;2023;3;3;0;100;0;150000;3470.66666666667;65.6666666666667
60250;2023;5;5;0;100;0;163000;2053.8;79.6
60252;2023;5;5;0;100;0;211200;1944.8;110.6
60253;2023;3;3;0;100;0;186566.666666667;1937.33333333333;103.666666666667
60254;2023;5;5;0;100;0;153080;1552.6;102
60255;2023;7;7;0;100;0;110285.714285714;1125.28571428571;88.4285714285714
60256;2023;12;12;0;100;0;277786;2326.75;132.916666666667
60257;2023;3;3;0;100;0;197996.666666667;2395.66666666667;95.3333333333333
60258;2023;7;7;0;100;0;127964.285714286;1620.85714285714;81.4285714285714
60259;2023;5;5;0;100;0;295300;3051.6;106
60260;2023;7;7;0;100;0;214882.285714286;1840.71428571429;121.571428571429
60261;2023;10;9;1;90;10;292520;2375.9;134.4
60262;2023;3;3;0;100;0;119166.666666667;1578.66666666667;80.3333333333333
60263;2023;1;1;0;100;0;1,00E+05;1333;75
60264;2023;3;3;0;100;0;173500;1849;95
60265;2023;6;6;0;100;0;182222.166666667;1506.66666666667;116.833333333333
60267;2023;2;2;0;100;0;122000;1925.5;60
60268;2023;6;6;0;100;0;186550.833333333;1895.16666666667;102.166666666667
60269;2023;6;6;0;100;0;113333.333333333;1936.16666666667;66.5
60270;2023;3;3;0;100;0;173333.333333333;1586;109.333333333333
60272;2023;6;6;0;100;0;248316.666666667;2510.33333333333;105
60273;2023;6;6;0;100;0;216216.666666667;2307.83333333333;96
60274;2023;4;4;0;100;0;375912.5;2472.5;152.25
60275;2023;4;4;0;100;0;164375;2139.75;77.25
60276;2023;4;4;0;100;0;137291.25;1986;65.25
60277;2023;15;15;0;100;0;193346.666666667;2017.13333333333;99.6
60278;2023;4;4;0;100;0;92000;981.5;92.75
60279;2023;2;2;0;100;0;162000;1686.5;95
60280;2023;1;1;0;100;0;55000;1100;50
60281;2023;7;7;0;100;0;199778.571428571;1777.71428571429;110.142857142857
60282;2023;104;63;41;60.5769230769231;39.4230769230769;374838.173076923;4090.125;90.6730769230769
60284;2023;22;22;0;100;0;214744.181818182;2243.54545454545;97.9090909090909
60285;2023;4;4;0;100;0;189750;2385;83.5
60286;2023;23;23;0;100;0;173206.695652174;2074.95652173913;90.8695652173913
60287;2023;2;2;0;100;0;115000;1131;76
60288;2023;3;3;0;100;0;119000;2069.33333333333;84
60289;2023;1;1;0;100;0;1,00E+05;1220;82
60290;2023;6;6;0;100;0;246525;1982;125.833333333333
60291;2023;22;22;0;100;0;119979.545454545;1439.77272727273;88.8636363636364
60292;2023;2;2;0;100;0;224367.5;1981.5;110.5
60293;2023;1;1;0;100;0;262000;2620;100
60294;2023;2;2;0;100;0;155000;2283;67.5
60295;2023;8;8;0;100;0;120782.375;1460;85.5
60297;2023;1;1;0;100;0;111500;1062;105
60298;2023;10;10;0;100;0;190100;2004.8;99.8
60299;2023;7;7;0;100;0;150379.285714286;1742;90
60301;2023;2;2;0;100;0;170000;1437;117.5
60302;2023;4;4;0;100;0;149000;1784.75;83.25
60303;2023;1;1;0;100;0;95000;1759;54
60304;2023;3;3;0;100;0;160333.333333333;1540;106.333333333333
60305;2023;7;7;0;100;0;199307.142857143;1979.71428571429;105
60306;2023;1;1;0;100;0;174000;2677;65
60307;2023;9;9;0;100;0;229543.333333333;2171.44444444444;107.333333333333
60308;2023;4;3;1;75;25;197750;2156;93
60309;2023;18;18;0;100;0;264441.111111111;2720;107.555555555556
60310;2023;4;4;0;100;0;193000;2034.75;99
60311;2023;5;5;0;100;0;139100;1708.6;86.2
60312;2023;1;1;0;100;0;153000;1628;94
60313;2023;24;24;0;100;0;199520.833333333;2283.83333333333;92.125
60314;2023;3;3;0;100;0;110750;887.666666666667;129
60315;2023;6;6;0;100;0;216333.333333333;1826.16666666667;123.833333333333
60316;2023;5;5;0;100;0;276792;2551.4;108.8
60317;2023;4;4;0;100;0;205012.5;2335.25;85.25
60318;2023;6;6;0;100;0;233083.333333333;2275.16666666667;104
60319;2023;6;6;0;100;0;163666.666666667;1955.5;89.1666666666667
60320;2023;2;2;0;100;0;320250;2933.5;108
60321;2023;12;12;0;100;0;226801.833333333;2361;101.083333333333
60322;2023;4;4;0;100;0;251550;2484.25;103.25
60323;2023;7;7;0;100;0;171928.571428571;2100.85714285714;84.7142857142857
60324;2023;4;4;0;100;0;143250;1567.5;100.75
60325;2023;19;15;4;78.9473684210526;21.0526315789474;210444.736842105;2482.78947368421;87.0526315789474
60326;2023;2;2;0;100;0;154750;3106;48.5
60327;2023;10;10;0;100;0;263175.7;2456.5;121.3
60328;2023;2;2;0;100;0;163000;2403.5;75
60329;2023;2;2;0;100;0;177875;1329.5;132.5
60330;2023;11;10;1;90.9090909090909;9.09090909090909;275267.272727273;2825.54545454545;104
60331;2023;4;4;0;100;0;187125;2045.75;85
60332;2023;5;5;0;100;0;303270;2509.8;135.6
60333;2023;12;11;1;91.6666666666667;8.33333333333333;270894.666666667;2008.16666666667;124.75
60334;2023;15;15;0;100;0;242286.666666667;2182.8;122.333333333333
60335;2023;1;1;0;100;0;139000;1168;119
60336;2023;2;2;0;100;0;117500;1321.5;98
60337;2023;1;1;0;100;0;190000;2000;95
60338;2023;60;43;17;71.6666666666667;28.3333333333333;235266.033333333;2650.66666666667;90.6833333333333
60339;2023;1;1;0;100;0;127500;1700;75
60340;2023;6;6;0;100;0;147298.333333333;1368.5;99
60341;2023;17;16;1;94.1176470588235;5.88235294117647;296288.235294118;3200.70588235294;95.4705882352941
60342;2023;52;34;18;65.3846153846154;34.6153846153846;165543.653846154;2378.98076923077;72.1538461538462
60343;2023;4;4;0;100;0;117750;2112.75;60.75
60344;2023;2;2;0;100;0;155000;1512.5;127
60345;2023;2;2;0;100;0;174500;1721.5;101.5
60346;2023;132;74;58;56.0606060606061;43.9393939393939;441318.522727273;4419.75;102.893939393939
60347;2023;3;3;0;100;0;192900;1828.66666666667;111
60348;2023;4;4;0;100;0;160507.5;1860.25;88.75
60350;2023;11;11;0;100;0;170113.636363636;1633.36363636364;121
60351;2023;1;1;0;100;0;224100;2075;108
60353;2023;2;2;0;100;0;167600;1320.5;127
60355;2023;10;10;0;100;0;246190;2729.5;96.9
60356;2023;4;4;0;100;0;314857.5;3388.25;119
60357;2023;3;3;0;100;0;160000;2006;81.3333333333333
60358;2023;11;9;2;81.8181818181818;18.1818181818182;294909.090909091;2806.63636363636;107.727272727273
60359;2023;2;2;0;100;0;225250;2952.5;76
60360;2023;59;38;21;64.4067796610169;35.5932203389831;135106.186440678;2029.96610169492;69.0677966101695
60361;2023;7;7;0;100;0;241585;2346.85714285714;107.857142857143
60362;2023;2;2;0;100;0;185000;1028;173
60363;2023;1;1;0;100;0;270000;3462;78
60364;2023;11;11;0;100;0;175514.545454545;2183.81818181818;87.1818181818182
60365;2023;2;2;0;100;0;182000;2774.5;75
60366;2023;3;3;0;100;0;184166.666666667;1744.66666666667;107.333333333333
60367;2023;2;2;0;100;0;231000;1677;137.5
60368;2023;32;31;1;96.875;3.125;182748.3125;2399.59375;84.125
60369;2023;18;18;0;100;0;213555.555555556;2468.16666666667;85.1111111111111
60370;2023;12;12;0;100;0;243065;2384.58333333333;106.5
60371;2023;2;2;0;100;0;137500;1069;118
60372;2023;7;7;0;100;0;161857.142857143;2327.85714285714;70.8571428571429
60373;2023;7;7;0;100;0;168957.142857143;1790.71428571429;98
60374;2023;16;16;0;100;0;170631.25;1827.4375;98.0625
60375;2023;3;3;0;100;0;183333.333333333;1658.66666666667;112.333333333333
60376;2023;1;1;0;100;0;99000;1414;70
60377;2023;4;4;0;100;0;109375;1639.75;68.75
60378;2023;7;7;0;100;0;180292.857142857;1971.57142857143;92.1428571428571
60379;2023;2;2;0;100;0;146250;1405.5;113
60380;2023;21;19;2;90.4761904761905;9.52380952380952;192181.761904762;2294.28571428571;89.9523809523809
60381;2023;3;3;0;100;0;193666.666666667;1484.66666666667;131.333333333333
60382;2023;108;61;47;56.4814814814815;43.5185185185185;191338.851851852;2653.0462962963;74.1296296296296
60383;2023;3;3;0;100;0;215266.666666667;2144.66666666667;100
60385;2023;7;7;0;100;0;235285.714285714;1979.42857142857;132
60386;2023;7;7;0;100;0;201257.142857143;1945;105.428571428571
60387;2023;8;8;0;100;0;186562.5;2029.875;93.25
60388;2023;1;1;0;100;0;117000;2167;54
60389;2023;1;1;0;100;0;137500;1562;88
60390;2023;5;5;0;100;0;163000.2;1667.4;94.6
60391;2023;2;2;0;100;0;106750;1414;64.5
60392;2023;4;4;0;100;0;188250;1923.25;99.75
60393;2023;11;10;1;90.9090909090909;9.09090909090909;181822.727272727;2245.63636363636;79.7272727272727
60395;2023;127;84;43;66.1417322834646;33.8582677165354;173693.480314961;2381.62992125984;74.9133858267717
60396;2023;3;3;0;100;0;177833.333333333;1466.66666666667;131.333333333333
60398;2023;25;21;4;84;16;311250.6;3109.48;105.24
60399;2023;2;2;0;100;0;133925;1594.5;83
60400;2023;5;5;0;100;0;213580;1907.6;118.4
60401;2023;8;8;0;100;0;221606.125;3146.875;73.25
60402;2023;26;23;3;88.4615384615385;11.5384615384615;203480.769230769;2282.61538461538;95.3461538461538
60403;2023;20;19;1;95;5;125525;1729.1;69.85
60404;2023;16;16;0;100;0;234269.375;2500.0625;96.6875
60405;2023;10;10;0;100;0;133550;1376.4;110.2
60406;2023;5;5;0;100;0;225400;2640.4;93.2
60408;2023;13;11;2;84.6153846153846;15.3846153846154;201482.461538462;2279.30769230769;98.6923076923077
60409;2023;15;15;0;100;0;203612.8;2290.2;92.4666666666667
60410;2023;1;1;0;100;0;112000;1120;100
60411;2023;12;12;0;100;0;262754.833333333;2438.33333333333;109.166666666667
60412;2023;4;4;0;100;0;267920;2455;108
60413;2023;7;7;0;100;0;200428.571428571;2425.71428571429;110
60414;2023;85;52;33;61.1764705882353;38.8235294117647;158043.611764706;2246.83529411765;74.9529411764706
60415;2023;1;1;0;100;0;315000;2480;127
60418;2023;5;5;0;100;0;205400;1531.2;143.8
60420;2023;9;9;0;100;0;274444.444444444;3500.22222222222;93.2222222222222
60421;2023;2;2;0;100;0;291830;2864;103
60422;2023;1;1;0;100;0;203000;3076;66
60423;2023;9;9;0;100;0;161965;2001;84
60424;2023;2;2;0;100;0;294100;2852;116.5
60425;2023;7;7;0;100;0;139857.142857143;1656.14285714286;87.8571428571429
60426;2023;3;3;0;100;0;260481.666666667;2440.33333333333;110
60427;2023;3;3;0;100;0;203540;2298;92
60428;2023;5;5;0;100;0;229600;2325.6;99.6
60429;2023;4;3;1;75;25;264349.5;2864.5;91.5
60430;2023;2;2;0;100;0;249600;2089;119.5
60431;2023;9;9;0;100;0;163562.222222222;1834.11111111111;87.4444444444444
60432;2023;4;3;1;75;25;467000;3005.5;142.25
60433;2023;17;17;0;100;0;258010.588235294;2839.64705882353;95.5294117647059
60434;2023;2;2;0;100;0;164500;2334;71.5
60435;2023;3;3;0;100;0;110333.333333333;1295.33333333333;97.3333333333333
60436;2023;1;1;0;100;0;43000;860;50
60438;2023;3;3;0;100;0;136080;2056.33333333333;77.3333333333333
60439;2023;50;33;17;66;34;158242.6;2306.94;76.86
60440;2023;8;8;0;100;0;150000;2291.25;66.125
60441;2023;4;4;0;100;0;298550;2254;132.75
60443;2023;5;5;0;100;0;131999.8;1736.4;77.6
60444;2023;3;3;0;100;0;186666.666666667;1674;111.333333333333
60445;2023;5;5;0;100;0;126020;1259.4;100
60446;2023;60;28;32;46.6666666666667;53.3333333333333;247201.5;3246.65;78.5666666666667
60447;2023;6;6;0;100;0;302368.333333333;2799.66666666667;100.5
60448;2023;7;7;0;100;0;224428.571428571;2317;99.8571428571429
60449;2023;2;2;0;100;0;111500;1186.5;96
60450;2023;46;40;6;86.9565217391304;13.0434782608696;230720.47826087;2653.52173913043;89.5
60451;2023;13;11;2;84.6153846153846;15.3846153846154;223253.846153846;2375.30769230769;102.461538461538
60452;2023;4;4;0;100;0;291700;1927.25;152
60454;2023;11;11;0;100;0;178272.727272727;2220.27272727273;83.0909090909091
60456;2023;13;13;0;100;0;195669.230769231;1869.84615384615;106
60458;2023;1;1;0;100;0;78500;2066;38
60459;2023;2;2;0;100;0;216000;2608;83.5
60460;2023;1;1;0;100;0;237000;2236;106
60461;2023;2;2;0;100;0;471725;2300.5;207
60462;2023;25;17;8;68;32;213189.08;2283.72;96.8
60463;2023;146;79;67;54.1095890410959;45.8904109589041;145050.863013699;2009.49315068493;73.1095890410959
60464;2023;8;8;0;100;0;217125;2253.125;96.875
60466;2023;4;4;0;100;0;167750;2066;85
60468;2023;3;3;0;100;0;166833.333333333;1508.33333333333;113.333333333333
60469;2023;2;2;0;100;0;282450;2354;120
60470;2023;7;7;0;100;0;177500;1972.42857142857;89.8571428571429
60471;2023;129;79;50;61.2403100775194;38.7596899224806;119371.627906977;1445.1007751938;81.4883720930233
60473;2023;2;2;0;100;0;263675;3014.5;97.5
60474;2023;5;5;0;100;0;128280;1191.6;108.4
60476;2023;1;1;0;100;0;190000;1188;160
60477;2023;7;7;0;100;0;207471.428571429;2047.28571428571;107.428571428571
60479;2023;4;4;0;100;0;196500;2208.25;93.5
60480;2023;3;3;0;100;0;167666.666666667;1613;100.333333333333
60481;2023;7;7;0;100;0;144857.142857143;1648.42857142857;87.5714285714286
60482;2023;41;39;2;95.1219512195122;4.8780487804878;332938.073170732;3627.17073170732;94.8048780487805
60483;2023;9;9;0;100;0;204533.333333333;2082.11111111111;101
60484;2023;3;3;0;100;0;175500;1986;113.333333333333
60485;2023;3;3;0;100;0;106166.666666667;1480.66666666667;77
60486;2023;5;5;0;100;0;105800;1651.6;66.6
60487;2023;4;4;0;100;0;333914;3324.75;100.5
60488;2023;2;2;0;100;0;133000;1250;113.5
60489;2023;4;4;0;100;0;237750;2010.25;142.5
60490;2023;6;6;0;100;0;201860;2068.66666666667;97.3333333333333
60491;2023;21;19;2;90.4761904761905;9.52380952380952;254741.761904762;2457.7619047619;100.142857142857
60492;2023;5;5;0;100;0;243871;2050.4;119.4
60493;2023;4;4;0;100;0;198000;2246.5;100
60494;2023;16;15;1;93.75;6.25;331964.0625;3307.5;99.9375
60495;2023;3;3;0;100;0;161600;2124.33333333333;80.6666666666667
60496;2023;1;1;0;100;0;140000;1842;76
60497;2023;4;4;0;100;0;157250;1696;100.5
60498;2023;7;7;0;100;0;109142.857142857;1794.85714285714;67.7142857142857
60500;2023;41;19;22;46.3414634146341;53.6585365853659;221011.024390244;3433.85365853659;65.1463414634146
60501;2023;21;21;0;100;0;171004.761904762;2161.80952380952;84.4761904761905
60503;2023;1;1;0;100;0;190700;2724;70
60504;2023;12;12;0;100;0;223708.333333333;2375.83333333333;97.8333333333333
60505;2023;8;7;1;87.5;12.5;248977.5;3284.125;75.625
60506;2023;6;6;0;100;0;144333.333333333;1847.33333333333;78.8333333333333
60507;2023;6;6;0;100;0;109166.666666667;1322.5;77.1666666666667
60508;2023;40;35;5;87.5;12.5;240531.45;2755.175;89.25
60509;2023;109;60;49;55.045871559633;44.954128440367;162205.504587156;2315.98165137615;70.5045871559633
60510;2023;6;6;0;100;0;241500;2902;88.3333333333333
60511;2023;2;2;0;100;0;174500;1382.5;121.5
60512;2023;3;3;0;100;0;250856;2763.66666666667;86.6666666666667
60513;2023;37;31;6;83.7837837837838;16.2162162162162;282510.810810811;3474.75675675676;82.3513513513514
60514;2023;2;2;0;100;0;135000;953;141.5
60515;2023;4;4;0;100;0;134000;1861.25;77.5
60516;2023;6;6;0;100;0;226533.333333333;1902.66666666667;134.166666666667
60517;2023;10;10;0;100;0;263390.5;2963;95.5
60518;2023;4;4;0;100;0;195750;1612.75;123.75
60519;2023;2;2;0;100;0;119430;1367.5;89
60520;2023;5;5;0;100;0;150886;1924;84.2
60521;2023;7;7;0;100;0;108071.428571429;1339.28571428571;77
60522;2023;2;2;0;100;0;124000;1663;74
60523;2023;10;10;0;100;0;170400;1817;96.8
60524;2023;35;20;15;57.1428571428571;42.8571428571429;177137.714285714;2426.11428571429;78.8571428571429
60526;2023;9;7;2;77.7777777777778;22.2222222222222;142574;1631.77777777778;87.4444444444444
60528;2023;1;1;0;100;0;235000;1880;125
60530;2023;1;1;0;100;0;330165;2090;158
60531;2023;15;15;0;100;0;198896;2521.06666666667;84.6
60533;2023;15;15;0;100;0;175993;1806.46666666667;101.6
60534;2023;5;5;0;100;0;158934;1648.6;108
60535;2023;3;3;0;100;0;142166.666666667;1689.33333333333;76.3333333333333
60536;2023;2;2;0;100;0;299500;2855.5;104
60537;2023;30;28;2;93.3333333333333;6.66666666666667;156459.7;1874.06666666667;84.0333333333333
60538;2023;3;3;0;100;0;251133.333333333;2231;128
60539;2023;14;14;0;100;0;218370;2338.21428571429;98.5
60540;2023;4;4;0;100;0;181800;2137;84
60541;2023;4;4;0;100;0;277131.25;2245.5;126.75
60542;2023;6;6;0;100;0;212433.333333333;2748.5;81.3333333333333
60543;2023;1;1;0;100;0;650000;4037;161
60545;2023;5;5;0;100;0;110984.8;1544.4;71
60546;2023;2;2;0;100;0;457675;4457.5;102
60547;2023;5;5;0;100;0;238700;3015.2;90.2
60548;2023;3;3;0;100;0;353333.333333333;2207.66666666667;147.666666666667
60549;2023;3;3;0;100;0;195000;2117.66666666667;88.6666666666667
60550;2023;1;1;0;100;0;140000;2800;50
60551;2023;4;4;0;100;0;217500;2489.5;89.5
60552;2023;2;2;0;100;0;205570.5;2165.5;93.5
60553;2023;1;1;0;100;0;2,00E+05;2083;96
60554;2023;8;8;0;100;0;234062.5;2326.875;106.5
60555;2023;1;1;0;100;0;150500;1601;94
60556;2023;2;2;0;100;0;113500;1228.5;114.5
60557;2023;4;4;0;100;0;150000;1272.5;116.5
60558;2023;2;1;1;50;50;179000;2365;75.5
60559;2023;1;1;0;100;0;322000;2147;150
60560;2023;3;3;0;100;0;299666.666666667;3496.33333333333;87
60561;2023;2;2;0;100;0;187000;2676;74.5
60562;2023;14;14;0;100;0;192135.714285714;2358.21428571429;84.8571428571429
60563;2023;6;6;0;100;0;208533.333333333;2635.16666666667;80.1666666666667
60564;2023;4;4;0;100;0;130125;1331.25;99.25
60565;2023;2;2;0;100;0;195000;1687;113.5
60566;2023;2;2;0;100;0;105000;1197.5;88.5
60567;2023;10;10;0;100;0;189505;1952.7;96.5
60568;2023;1;1;0;100;0;248000;2696;92
60570;2023;13;13;0;100;0;262011.461538462;2173.15384615385;125
60572;2023;2;2;0;100;0;186410;1725;108
60573;2023;5;5;0;100;0;188200;1807.2;104.2
60574;2023;11;11;0;100;0;217906.090909091;2510.72727272727;93.8181818181818
60575;2023;45;39;6;86.6666666666667;13.3333333333333;250109.866666667;2408.88888888889;110
60576;2023;3;3;0;100;0;207833.333333333;1610.66666666667;124.666666666667
60577;2023;21;21;0;100;0;165476.19047619;1873.57142857143;95.7619047619048
60578;2023;6;6;0;100;0;185375;2305.83333333333;79.3333333333333
60579;2023;3;3;0;100;0;395000;3400.66666666667;111.666666666667
60581;2023;50;40;10;80;20;147403.7;1808.9;82.32
60582;2023;8;8;0;100;0;191948.75;1715.5;110.375
60583;2023;2;2;0;100;0;296375;2329;127
60584;2023;32;24;8;75;25;229026.5625;2934.15625;82.78125
60585;2023;7;7;0;100;0;166632.857142857;1946.71428571429;86.8571428571429
60586;2023;8;8;0;100;0;168250;2115.5;83.375
60587;2023;16;15;1;93.75;6.25;215797.1875;2614.0625;84.1875
60588;2023;4;4;0;100;0;109625;1620.75;63.25
60589;2023;28;14;14;50;50;198379.357142857;2956.75;69.25
60590;2023;2;2;0;100;0;280000;2755.5;117.5
60591;2023;12;12;0;100;0;325791.666666667;2550.41666666667;124.916666666667
60592;2023;14;14;0;100;0;170710.357142857;1845.21428571429;99.0714285714286
60593;2023;2;2;0;100;0;175000;1987;88.5
60594;2023;2;2;0;100;0;2,00E+05;1473;147.5
60595;2023;3;3;0;100;0;176666.666666667;1978.66666666667;88.6666666666667
60596;2023;3;3;0;100;0;120360;1363.66666666667;79.6666666666667
60597;2023;18;18;0;100;0;233622.222222222;2289.11111111111;105.666666666667
60598;2023;11;11;0;100;0;247797.272727273;2409.27272727273;107.272727272727
60599;2023;1;1;0;100;0;130000;929;140
60600;2023;4;4;0;100;0;323874.75;2819.25;128.25
60601;2023;13;11;2;84.6153846153846;15.3846153846154;204609.230769231;2615.23076923077;85.0769230769231
60603;2023;8;8;0;100;0;140177;1622;82.75
60604;2023;2;2;0;100;0;124250;1366.5;87.5
60605;2023;2;2;0;100;0;65000;874.5;74
60608;2023;2;2;0;100;0;225000;1972.5;110.5
60609;2023;8;8;0;100;0;190793.75;1986.875;98.875
60610;2023;8;8;0;100;0;137554.25;1535.5;92.125
60611;2023;6;6;0;100;0;192522.5;2083.83333333333;109.833333333333
60612;2023;193;82;111;42.4870466321244;57.5129533678757;331867.150259067;3511.83419689119;90.0051813471503
60614;2023;2;2;0;100;0;251500;2522.5;102
60615;2023;2;2;0;100;0;106519;1421;72.5
60616;2023;34;34;0;100;0;179866.176470588;2038.97058823529;89.8823529411765
60617;2023;5;5;0;100;0;170560;2009.4;90.8
60618;2023;2;2;0;100;0;173547.5;1709;101.5
60619;2023;10;8;2;80;20;319372.5;3430.2;98.3
60620;2023;6;6;0;100;0;326833.333333333;3309.83333333333;111
60621;2023;2;0;2;0;100;108500;1276.5;85
60622;2023;2;2;0;100;0;142500;915;145
60623;2023;10;10;0;100;0;95195;1475.9;73.2
60624;2023;4;4;0;100;0;208750;1651.75;118.25
60625;2023;4;4;0;100;0;169412.5;1635;104
60626;2023;10;10;0;100;0;199490;2338;94.1
60627;2023;3;3;0;100;0;124333.333333333;1233;95
60628;2023;13;11;2;84.6153846153846;15.3846153846154;160458.846153846;1797.15384615385;95.3076923076923
60630;2023;4;4;0;100;0;273550;2722.75;94.25
60631;2023;14;11;3;78.5714285714286;21.4285714285714;322522.5;3233.42857142857;109.357142857143
60632;2023;8;8;0;100;0;158775.5;2047.75;76.25
60633;2023;2;2;0;100;0;99000;1411.5;72
60634;2023;4;4;0;100;0;152375;1625.25;95
60635;2023;12;11;1;91.6666666666667;8.33333333333333;183708.333333333;2320.33333333333;92.25
60636;2023;37;36;1;97.2972972972973;2.7027027027027;169029.72972973;2034.75675675676;87.4324324324324
60637;2023;8;8;0;100;0;238717.75;2265.5;108.75
60638;2023;10;10;0;100;0;222480;2213.8;103.7
60639;2023;10;10;0;100;0;177026.7;2329.4;78.6
60641;2023;27;24;3;88.8888888888889;11.1111111111111;159959.444444444;1696.2962962963;97.1851851851852
60642;2023;14;14;0;100;0;245071.428571429;2266.21428571429;110.785714285714
60643;2023;13;13;0;100;0;188914.615384615;1857.84615384615;101.692307692308
60644;2023;19;18;1;94.7368421052632;5.26315789473684;229205.263157895;2454.89473684211;98.2631578947368
60646;2023;8;8;0;100;0;211700;3017.25;86.25
60647;2023;20;18;2;90;10;152245;1919.4;87.35
60648;2023;4;4;0;100;0;104918.25;1691.25;66.5
60650;2023;5;5;0;100;0;285127;2528.2;108.4
60651;2023;16;16;0;100;0;240337.5;2242.625;106.5
60652;2023;15;15;0;100;0;192842;2263.46666666667;90.3333333333333
60653;2023;5;5;0;100;0;156400;1958;80.4
60654;2023;5;5;0;100;0;183790;2149.8;87.2
60655;2023;8;8;0;100;0;136002.5;1564.625;90.875
60656;2023;3;3;0;100;0;270666.666666667;2672.33333333333;117.666666666667
60657;2023;8;8;0;100;0;174805;1645.25;107.875
60658;2023;11;11;0;100;0;209045.454545455;2422.36363636364;89.3636363636364
60659;2023;1;1;0;100;0;199000;1990;100
60660;2023;1;1;0;100;0;415000;2441;170
60661;2023;12;8;4;66.6666666666667;33.3333333333333;266805.833333333;3321.83333333333;84.9166666666667
60662;2023;4;4;0;100;0;189298.5;1755.75;100.25
60663;2023;3;3;0;100;0;209166.666666667;2669;88
60664;2023;6;6;0;100;0;159241.666666667;1724.5;94
60665;2023;31;20;11;64.5161290322581;35.4838709677419;173418.387096774;2444;71
60666;2023;13;13;0;100;0;291692.307692308;3256.07692307692;94.6153846153846
60667;2023;56;42;14;75;25;184214.696428571;2215.91071428571;85.375
60668;2023;6;6;0;100;0;241996.666666667;2247.33333333333;106.166666666667
60669;2023;3;2;1;66.6666666666667;33.3333333333333;248733.333333333;2648;94.3333333333333
60670;2023;55;49;6;89.0909090909091;10.9090909090909;256251.218181818;2772.6;96.2909090909091
60671;2023;1;1;0;100;0;235000;2701;87
60672;2023;1;1;0;100;0;50000;658;76
60673;2023;2;2;0;100;0;105500;1500;75.5
60674;2023;5;5;0;100;0;253360;2374.6;112.6
60675;2023;5;5;0;100;0;153825;1749.4;94.8
60676;2023;6;6;0;100;0;205058.333333333;2191.33333333333;103.166666666667
60677;2023;5;5;0;100;0;225577;1738.8;154.4
60678;2023;15;13;2;86.6666666666667;13.3333333333333;262871.333333333;2817.26666666667;101.333333333333
60679;2023;3;3;0;100;0;150666.666666667;2281.66666666667;70.3333333333333
60680;2023;11;9;2;81.8181818181818;18.1818181818182;229871.818181818;2727.81818181818;85.1818181818182
60681;2023;7;7;0;100;0;188500;1662.14285714286;125.142857142857
60682;2023;4;3;1;75;25;183700;2587;76.25
60683;2023;1;1;0;100;0;275000;3929;70
60684;2023;42;33;9;78.5714285714286;21.4285714285714;197494.166666667;2662.66666666667;76.2142857142857
60685;2023;8;8;0;100;0;236456.25;2682.25;88.75
60686;2023;23;16;7;69.5652173913043;30.4347826086957;239951.52173913;2865.30434782609;83.7826086956522
60687;2023;2;2;0;100;0;162000;1062;152
60688;2023;1;1;0;100;0;184000;2272;81
60689;2023;10;10;0;100;0;293390;2182.7;134.6
60691;2023;2;2;0;100;0;281500;2215;131
60692;2023;4;4;0;100;0;123750;1134.25;116.5
60693;2023;7;7;0;100;0;135428.571428571;1688;89.2857142857143
60695;2023;20;11;9;55;45;374361.25;4017.15;92.7
60697;2023;1;1;0;100;0;575000;3194;180
60698;2023;2;2;0;100;0;101250;1347.5;69
60699;2023;3;3;0;100;0;160833.333333333;993.666666666667;145.666666666667
60700;2023;13;13;0;100;0;286547.153846154;2459;117.923076923077
60701;2023;12;12;0;100;0;145541.333333333;1753.25;83.3333333333333
60702;2023;3;3;0;100;0;80116.6666666667;1779;45
60703;2023;4;4;0;100;0;178750;2173.75;84
61001;2023;320;176;144;55;45;123767.921875;1486.3875;80.396875
61002;2023;16;15;1;93.75;6.25;110800.625;1288.3125;89.3125
61005;2023;3;3;0;100;0;183500;1542.33333333333;117.333333333333
61006;2023;110;81;29;73.6363636363636;26.3636363636364;135151;1636.48181818182;83.9818181818182
61007;2023;43;42;1;97.6744186046512;2.32558139534884;130616.325581395;1419.09302325581;93.8139534883721
61008;2023;24;24;0;100;0;110354.166666667;1619.25;73.1666666666667
61010;2023;3;3;0;100;0;139333.333333333;1479;98.3333333333333
61011;2023;6;6;0;100;0;163398.333333333;1542.5;102
61012;2023;2;2;0;100;0;67500;847.5;67
61013;2023;3;3;0;100;0;180500;1214.66666666667;146.333333333333
61014;2023;1;1;0;100;0;170000;1382;123
61015;2023;2;2;0;100;0;130000;1015;119.5
61018;2023;2;2;0;100;0;159000;1576;99
61020;2023;1;1;0;100;0;128000;557;230
61023;2023;5;5;0;100;0;157000;1339.4;118.8
61024;2023;5;5;0;100;0;104572;1379.2;76
61026;2023;1;1;0;100;0;90000;1324;68
61028;2023;9;9;0;100;0;252765.555555556;2495.66666666667;92.6666666666667
61029;2023;14;14;0;100;0;164392.857142857;1624.85714285714;96.2857142857143
61032;2023;5;5;0;100;0;91120;1460.8;69.6
61034;2023;4;4;0;100;0;127500;1381;92.25
61035;2023;4;4;0;100;0;192412.5;1094.5;170
61036;2023;1;1;0;100;0;2,00E+05;1212;165
61037;2023;2;2;0;100;0;516183;6511;88.5
61038;2023;18;17;1;94.4444444444444;5.55555555555556;226244.444444444;2493;99.4444444444444
61040;2023;11;11;0;100;0;129386.363636364;1094.18181818182;101.818181818182
61041;2023;6;6;0;100;0;131695;1474.66666666667;78.6666666666667
61043;2023;10;10;0;100;0;169405;1889;89.7
61044;2023;5;5;0;100;0;120398;1484;81.4
61046;2023;2;2;0;100;0;226250;1602;143.5
61048;2023;1;1;0;100;0;170000;1954;87
61049;2023;1;1;0;100;0;306300;1298;236
61050;2023;8;8;0;100;0;270061.25;2140.875;130.75
61051;2023;9;9;0;100;0;117643.333333333;1384.11111111111;90.2222222222222
61052;2023;4;4;0;100;0;154000;1257.5;118.5
61053;2023;3;3;0;100;0;169233.333333333;2350.66666666667;73
61054;2023;6;6;0;100;0;169097.5;1437.33333333333;120.666666666667
61055;2023;6;6;0;100;0;83975;1025.5;77.8333333333333
61056;2023;2;2;0;100;0;195600;1856;105.5
61061;2023;13;13;0;100;0;113626.923076923;1412.92307692308;80.0769230769231
61062;2023;2;2;0;100;0;174994.5;1447;121
61063;2023;20;19;1;95;5;91986.4;1088.6;86.35
61064;2023;3;3;0;100;0;103333.333333333;1223.66666666667;67.3333333333333
61066;2023;1;1;0;100;0;85000;773;110
61067;2023;4;4;0;100;0;203222.5;2070.75;102
61068;2023;1;1;0;100;0;170780;1265;135
61069;2023;2;2;0;100;0;126000;1676.5;72
61070;2023;5;5;0;100;0;120670;1297.2;91.2
61071;2023;4;4;0;100;0;103250;1107;103.5
61072;2023;2;2;0;100;0;1,00E+05;1322.5;76.5
61074;2023;7;7;0;100;0;91352.4285714286;860.285714285714;104.571428571429
61075;2023;19;19;0;100;0;94668.4210526316;1118;81.6315789473684
61076;2023;1;1;0;100;0;195000;907;215
61077;2023;8;8;0;100;0;138625;1690;85
61078;2023;3;3;0;100;0;143333.333333333;1343.33333333333;118.666666666667
61079;2023;20;20;0;100;0;153059.1;1575.65;83.85
61080;2023;1;1;0;100;0;15000;600;25
61081;2023;7;7;0;100;0;169428.571428571;1564.85714285714;110
61085;2023;2;2;0;100;0;115995;1160;100
61087;2023;5;5;0;100;0;155905;1361.6;128.4
61088;2023;1;1;0;100;0;190000;1827;104
61089;2023;4;4;0;100;0;190250;2078.75;89.25
61091;2023;17;17;0;100;0;93871.9411764706;997.941176470588;99.9411764705882
61092;2023;4;4;0;100;0;180250;1616.5;103.5
61093;2023;17;16;1;94.1176470588235;5.88235294117647;100622.647058824;997.705882352941;99.2941176470588
61094;2023;9;9;0;100;0;136805.555555556;1508.44444444444;89.4444444444444
61095;2023;2;2;0;100;0;170700;1244.5;138.5
61096;2023;40;39;1;97.5;2.5;101804.625;1099.675;88.825
61097;2023;7;7;0;100;0;113659.571428571;1099.42857142857;87.5714285714286
61098;2023;2;2;0;100;0;156500;2059.5;81
61099;2023;7;7;0;100;0;142357.142857143;1592;86.7142857142857
61100;2023;2;2;0;100;0;183000;1984.5;92
61101;2023;1;1;0;100;0;108000;1317;82
61102;2023;8;8;0;100;0;130287.5;1267.375;107.625
61103;2023;1;1;0;100;0;136000;1600;85
61105;2023;3;3;0;100;0;150000;1952.66666666667;81
61107;2023;5;5;0;100;0;114005;1106.4;104.8
61108;2023;2;2;0;100;0;122500;1358.5;87
61111;2023;2;2;0;100;0;169150;1401.5;122
61113;2023;4;4;0;100;0;238841.5;2159.75;123.5
61114;2023;1;1;0;100;0;396000;3046;130
61116;2023;26;25;1;96.1538461538462;3.84615384615385;151845.346153846;1576.15384615385;99.1538461538462
61117;2023;22;18;4;81.8181818181818;18.1818181818182;177278.772727273;2129.5;86.4545454545455
61120;2023;4;4;0;100;0;274511.75;2227;103.75
61121;2023;2;2;0;100;0;139750;1909;72.5
61122;2023;1;1;0;100;0;70000;1750;40
61123;2023;3;3;0;100;0;178143.333333333;2096.66666666667;90.6666666666667
61124;2023;3;3;0;100;0;168333.333333333;1771.66666666667;89.6666666666667
61126;2023;12;12;0;100;0;153625;1826.33333333333;82.9166666666667
61129;2023;5;5;0;100;0;215350;1758;111.6
61130;2023;3;3;0;100;0;256846.666666667;2606.66666666667;97.6666666666667
61133;2023;11;11;0;100;0;136045.454545455;1516.72727272727;89.3636363636364
61138;2023;2;2;0;100;0;435000;3819.5;105
61139;2023;4;4;0;100;0;103950;1155.75;99.25
61140;2023;14;14;0;100;0;96964.2857142857;1444.64285714286;71.8571428571429
61142;2023;2;2;0;100;0;50245;658.5;76
61143;2023;29;28;1;96.551724137931;3.44827586206897;173318.965517241;1858.44827586207;90.4137931034483
61145;2023;47;42;5;89.3617021276596;10.6382978723404;132024.574468085;1477.59574468085;89.3829787234042
61146;2023;4;4;0;100;0;88600;1150;72.5
61148;2023;2;2;0;100;0;92500;1397.5;63.5
61149;2023;3;3;0;100;0;69633.3333333333;879;87.6666666666667
61150;2023;6;6;0;100;0;164166.666666667;1474.16666666667;108.833333333333
61151;2023;3;3;0;100;0;70566.6666666667;1186.33333333333;65.6666666666667
61153;2023;38;35;3;92.1052631578947;7.89473684210526;123130.657894737;1298.78947368421;96.4473684210526
61156;2023;7;7;0;100;0;155142.857142857;1244;109.857142857143
61158;2023;4;4;0;100;0;71988;894.5;89.5
61160;2023;3;3;0;100;0;207666.666666667;1716;127.333333333333
61162;2023;2;2;0;100;0;70000;905.5;79
61163;2023;23;23;0;100;0;88698.2608695652;1097.08695652174;82.695652173913
61164;2023;4;4;0;100;0;177250;1627.75;102.5
61165;2023;3;3;0;100;0;87000;858.666666666667;111.333333333333
61166;2023;4;4;0;100;0;218000;2040.25;98
61167;2023;51;51;0;100;0;134156.607843137;1592.96078431373;86.7450980392157
61168;2023;49;45;4;91.8367346938776;8.16326530612245;100837.755102041;1122.65306122449;91.8979591836735
61169;2023;174;111;63;63.7931034482759;36.2068965517241;117915.931034483;1383.42528735632;85.2356321839081
61170;2023;1;1;0;100;0;205000;1694;121
61176;2023;4;4;0;100;0;114600;1365.25;83.5
61181;2023;16;15;1;93.75;6.25;105530.625;1298.25;83.125
61182;2023;6;6;0;100;0;183416.666666667;1554;120
61183;2023;2;2;0;100;0;123250;1428;103.5
61187;2023;4;4;0;100;0;194780;1826.25;101.75
61188;2023;5;5;0;100;0;159400;1876;91.4
61189;2023;3;3;0;100;0;75833.3333333333;919.333333333333;85.3333333333333
61190;2023;1;1;0;100;0;103000;1241;83
61192;2023;2;2;0;100;0;277500;2403.5;116.5
61193;2023;6;6;0;100;0;197833.333333333;1729.83333333333;111.166666666667
61194;2023;3;3;0;100;0;140795;1435.33333333333;108.666666666667
61195;2023;5;5;0;100;0;163910;1515.4;131.8
61196;2023;23;23;0;100;0;197152.173913043;1893.60869565217;106.260869565217
61198;2023;1;1;0;100;0;364200;1849;197
61199;2023;5;5;0;100;0;108228;1083.6;101.6
61202;2023;8;8;0;100;0;203750;1576.875;123.375
61203;2023;12;12;0;100;0;157791.666666667;1608.75;93.75
61206;2023;5;5;0;100;0;144300;1984;69.8
61207;2023;9;9;0;100;0;355666.666666667;2437;106.555555555556
61208;2023;4;4;0;100;0;165750;1852.75;98.75
61209;2023;6;6;0;100;0;140625;1645.66666666667;97
61210;2023;5;5;0;100;0;79590;1164.8;68.2
61211;2023;37;36;1;97.2972972972973;2.7027027027027;123836.216216216;1318;101.594594594595
61213;2023;5;5;0;100;0;151472;1508.6;102.2
61214;2023;98;81;17;82.6530612244898;17.3469387755102;126988.673469388;1558.54081632653;85.9387755102041
61215;2023;5;5;0;100;0;139800;1862.6;79.2
61216;2023;4;4;0;100;0;148000;1416.75;104.75
61218;2023;22;22;0;100;0;117024.772727273;1203.81818181818;93.5909090909091
61219;2023;3;3;0;100;0;127963.333333333;1567.33333333333;94.6666666666667
61221;2023;3;3;0;100;0;136833.333333333;1384.66666666667;98.6666666666667
61222;2023;9;9;0;100;0;104887.555555556;1191.66666666667;88.3333333333333
61224;2023;2;2;0;100;0;176150;1778;98.5
61227;2023;2;2;0;100;0;120000;1178;109.5
61228;2023;12;12;0;100;0;129745;1363.16666666667;97.5833333333333
61229;2023;2;1;1;50;50;132250;1459;90
61230;2023;47;47;0;100;0;158693.29787234;1805.8085106383;95.1914893617021
61232;2023;15;15;0;100;0;117662.4;1357.53333333333;90.5333333333333
61233;2023;3;3;0;100;0;109333.333333333;1132.33333333333;92.6666666666667
61234;2023;8;8;0;100;0;134575.125;1303.875;104.75
61237;2023;9;9;0;100;0;105420;1011.44444444444;99.4444444444444
61238;2023;1;1;0;100;0;149900;1363;110
61240;2023;8;8;0;100;0;162968.75;1296.125;129.25
61241;2023;4;4;0;100;0;116000;1310.75;85.75
61242;2023;2;2;0;100;0;107000;1406.5;63.5
61243;2023;9;9;0;100;0;193872.222222222;1781.22222222222;109.111111111111
61244;2023;1;1;0;100;0;305000;2773;110
61248;2023;23;22;1;95.6521739130435;4.34782608695652;97758.6086956522;1115.65217391304;95.0434782608696
61251;2023;1;1;0;100;0;129200;2153;60
61252;2023;3;3;0;100;0;218900;2174.66666666667;99.3333333333333
61255;2023;13;13;0;100;0;129104.230769231;1151.61538461538;105.230769230769
61256;2023;5;5;0;100;0;120200;1305.4;94.4
61257;2023;2;2;0;100;0;107100;1212.5;86.5
61258;2023;8;8;0;100;0;89047.25;1138.625;80.375
61260;2023;6;6;0;100;0;81465;1067.83333333333;76.3333333333333
61261;2023;2;2;0;100;0;220000;1129;194.5
61262;2023;1;1;0;100;0;170000;2125;80
61263;2023;1;1;0;100;0;40000;656;61
61264;2023;2;2;0;100;0;28000;687;49.5
61265;2023;1;1;0;100;0;180000;2250;80
61266;2023;2;2;0;100;0;268340;1786.5;159.5
61267;2023;4;4;0;100;0;89000;1149.25;75.5
61268;2023;3;3;0;100;0;324000;2387;143.333333333333
61269;2023;8;8;0;100;0;161425;1141;120.5
61271;2023;2;2;0;100;0;29000;617.5;44.5
61274;2023;1;1;0;100;0;270000;1475;183
61275;2023;15;15;0;100;0;96408.3333333333;1169.13333333333;82.6666666666667
61276;2023;3;3;0;100;0;84000;893;92.3333333333333
61277;2023;4;4;0;100;0;152250;1543.5;91.5
61278;2023;19;18;1;94.7368421052632;5.26315789473684;104225.789473684;1334.26315789474;78.5263157894737
61279;2023;7;7;0;100;0;186964.285714286;1471.57142857143;125.428571428571
61281;2023;3;3;0;100;0;129080;1966.66666666667;70
61283;2023;1;1;0;100;0;110000;1019;108
61284;2023;3;3;0;100;0;152500;1587;128.666666666667
61286;2023;1;1;0;100;0;155000;1348;115
61287;2023;8;8;0;100;0;110687.875;1136.75;94.25
61288;2023;9;9;0;100;0;173722.222222222;1564.22222222222;116.666666666667
61290;2023;2;2;0;100;0;139500;1453;96
61291;2023;1;1;0;100;0;107400;1342;80
61292;2023;6;6;0;100;0;100827.5;1271.16666666667;80.6666666666667
61293;2023;48;39;9;81.25;18.75;163901.854166667;1756.70833333333;91.1458333333333
61294;2023;14;14;0;100;0;121461.785714286;1206.92857142857;99.7142857142857
61295;2023;2;2;0;100;0;59873.5;514;117
61297;2023;6;6;0;100;0;89250;1077.66666666667;81.3333333333333
61298;2023;4;4;0;100;0;93250;1180.25;77.25
61300;2023;3;3;0;100;0;141333.333333333;2876.33333333333;65.6666666666667
61301;2023;1;1;0;100;0;150000;1807;83
61303;2023;7;7;0;100;0;120142.857142857;1296.28571428571;91
61307;2023;3;3;0;100;0;82333.3333333333;1424;50
61308;2023;2;2;0;100;0;96875;1146.5;79.5
61309;2023;31;31;0;100;0;246201.612903226;2147.70967741935;109.161290322581
61310;2023;8;8;0;100;0;79425;1049.625;69.875
61314;2023;5;5;0;100;0;162360;1705.8;95.2
61316;2023;1;1;0;100;0;120000;1143;105
61319;2023;4;4;0;100;0;161375;1565;103.75
61321;2023;2;2;0;100;0;139000;858.5;173.5
61322;2023;3;3;0;100;0;115333.333333333;1732.66666666667;74.3333333333333
61323;2023;1;1;0;100;0;120000;2553;47
61324;2023;23;23;0;100;0;83167.0434782609;1061.39130434783;79.7391304347826
61326;2023;3;3;0;100;0;56000;666.666666666667;78
61327;2023;5;5;0;100;0;455700;2610.8;141.4
61328;2023;3;3;0;100;0;97133.3333333333;1058.66666666667;86.6666666666667
61329;2023;6;5;1;83.3333333333333;16.6666666666667;151666.666666667;1139.83333333333;117.5
61330;2023;3;3;0;100;0;123644;934.333333333333;154.666666666667
61331;2023;2;2;0;100;0;175000;2348.5;85
61333;2023;2;2;0;100;0;54000;1285.5;52
61336;2023;1;1;0;100;0;540000;6429;84
61339;2023;33;33;0;100;0;107140.606060606;1552.78787878788;78
61341;2023;13;13;0;100;0;210784.615384615;1771.76923076923;114.538461538462
61342;2023;16;16;0;100;0;173813.9375;1479.5;114.25
61344;2023;11;11;0;100;0;161027.272727273;1508.90909090909;109.454545454545
61345;2023;26;26;0;100;0;142423.076923077;1569.23076923077;94.1153846153846
61346;2023;4;4;0;100;0;173909.5;1807.25;109
61347;2023;3;3;0;100;0;100666.666666667;1038;105
61348;2023;6;6;0;100;0;207333.333333333;2894;101
61349;2023;1;1;0;100;0;156600;1386;113
61350;2023;2;2;0;100;0;147500;1884.5;78.5
61351;2023;1;1;0;100;0;250000;1667;150
61352;2023;1;1;0;100;0;105500;1172;90
61357;2023;3;3;0;100;0;144183.333333333;1548;90.3333333333333
61358;2023;4;4;0;100;0;80750;1012;82.5
61362;2023;4;4;0;100;0;151113.75;1392.5;106.75
61365;2023;3;3;0;100;0;285833.333333333;1857.33333333333;139.666666666667
61366;2023;4;4;0;100;0;91250;1057;87.5
61367;2023;2;2;0;100;0;109650;1183;90
61369;2023;11;11;0;100;0;166482.727272727;1293.09090909091;117.363636363636
61370;2023;2;2;0;100;0;52500;785;72
61371;2023;2;2;0;100;0;225500;1432;157.5
61372;2023;2;2;0;100;0;101500;1530.5;74.5
61373;2023;6;6;0;100;0;116450;1110.33333333333;100.5
61374;2023;5;5;0;100;0;149630;1491.2;95
61375;2023;8;8;0;100;0;173400;1552.375;117.125
61376;2023;16;16;0;100;0;101083.125;1211.9375;81.375
61379;2023;6;6;0;100;0;407658.333333333;2564.5;173.333333333333
61381;2023;3;3;0;100;0;288334.333333333;3266.33333333333;112.333333333333
61382;2023;9;8;1;88.8888888888889;11.1111111111111;123198.666666667;1212.77777777778;102.555555555556
61384;2023;3;3;0;100;0;95000;1285.66666666667;75
61385;2023;6;6;0;100;0;100138;1229.33333333333;84.5
61386;2023;6;6;0;100;0;178166.666666667;1433.83333333333;113.833333333333
61387;2023;15;15;0;100;0;90694.8;1094.13333333333;83.8
61388;2023;4;4;0;100;0;78500;1090.75;71.5
61389;2023;18;17;1;94.4444444444444;5.55555555555556;112394.444444444;1375.5;84.1111111111111
61390;2023;2;2;0;100;0;165450;1651.5;126
61391;2023;50;41;9;82;18;113082.9;1379.34;85.86
61392;2023;2;2;0;100;0;72500;1284.5;56
61393;2023;3;3;0;100;0;118666.666666667;999.333333333333;119
61394;2023;12;12;0;100;0;138128.333333333;1572.25;91.3333333333333
61395;2023;3;3;0;100;0;458333.333333333;2781.66666666667;154.666666666667
61397;2023;34;33;1;97.0588235294118;2.94117647058824;178313.823529412;1751.70588235294;101.205882352941
61400;2023;3;3;0;100;0;110000;1056.33333333333;125.333333333333
61401;2023;1;1;0;100;0;150000;1376;109
61402;2023;2;2;0;100;0;129370;1848.5;85.5
61404;2023;6;6;0;100;0;84000;1049.5;85.1666666666667
61405;2023;9;9;0;100;0;155111.111111111;1392.22222222222;105.111111111111
61406;2023;2;2;0;100;0;216500;2207;95
61407;2023;7;7;0;100;0;124542.857142857;1132.71428571429;111.714285714286
61408;2023;3;3;0;100;0;80000;1943.66666666667;42.6666666666667
61411;2023;4;4;0;100;0;189363.25;1565.25;126
61412;2023;8;8;0;100;0;140025;1714.875;83.25
61413;2023;1;1;0;100;0;222500;1184;188
61414;2023;11;11;0;100;0;148000;1630.18181818182;90.0909090909091
61415;2023;3;3;0;100;0;151096;1682.33333333333;92.6666666666667
61416;2023;1;1;0;100;0;177000;1718;103
61418;2023;5;5;0;100;0;106400;1521.4;84.8
61419;2023;4;4;0;100;0;89075;1115.5;77.75
61420;2023;1;1;0;100;0;130000;1287;101
61421;2023;7;7;0;100;0;82257.5714285714;1278.71428571429;69.8571428571429
61422;2023;7;7;0;100;0;130142.857142857;1603;86.8571428571429
61423;2023;9;9;0;100;0;103733.333333333;1325.33333333333;89.2222222222222
61424;2023;5;5;0;100;0;89445.4;1351.2;92
61425;2023;3;3;0;100;0;317726.666666667;2382.33333333333;142.333333333333
61426;2023;16;16;0;100;0;144903.75;1359.5;107.125
61427;2023;6;6;0;100;0;190583.333333333;1856.5;98.5
61429;2023;17;17;0;100;0;122789.470588235;1410.35294117647;89.3529411764706
61432;2023;5;5;0;100;0;128100;1475.8;98.2
61433;2023;3;3;0;100;0;198300;1690.66666666667;113
61435;2023;3;3;0;100;0;89166.6666666667;843;96.6666666666667
61436;2023;3;3;0;100;0;110333.333333333;1214;78
61438;2023;1;1;0;100;0;66000;660;100
61439;2023;1;1;0;100;0;140000;1667;84
61440;2023;12;12;0;100;0;157900;1820.16666666667;90.8333333333333
61442;2023;2;2;0;100;0;259250;5244.5;58.5
61443;2023;6;6;0;100;0;111731.666666667;1097;112.166666666667
61445;2023;7;7;0;100;0;99643.8571428571;1131.57142857143;91.2857142857143
61446;2023;2;2;0;100;0;240914;2472;98
61447;2023;11;11;0;100;0;92178.1818181818;1090.63636363636;82.6363636363636
61448;2023;3;3;0;100;0;113081.666666667;1300.66666666667;86
61451;2023;4;4;0;100;0;129347.5;1281.5;94.75
61452;2023;1;1;0;100;0;130000;1313;99
61453;2023;2;2;0;100;0;101000;790;127
61454;2023;9;9;0;100;0;151425.888888889;1690.77777777778;91.7777777777778
61456;2023;18;18;0;100;0;134250.055555556;1487.11111111111;85.9444444444444
61457;2023;5;5;0;100;0;165800;1427.8;123.4
61459;2023;2;2;0;100;0;117500;1355;88
61460;2023;21;20;1;95.2380952380952;4.76190476190476;100290.761904762;1071.19047619048;89.9523809523809
61462;2023;16;16;0;100;0;176468.75;1585;107.375
61463;2023;12;12;0;100;0;166917.833333333;1617.66666666667;101
61464;2023;44;32;12;72.7272727272727;27.2727272727273;107230.954545455;1196.93181818182;88.9090909090909
61466;2023;13;13;0;100;0;149121.153846154;1381.61538461538;103.846153846154
61467;2023;1;1;0;100;0;271690;2744;99
61472;2023;2;2;0;100;0;165950;1942;88
61473;2023;3;3;0;100;0;188066.666666667;1660;95.3333333333333
61474;2023;46;45;1;97.8260869565217;2.17391304347826;147260.434782609;1371.21739130435;103.521739130435
61475;2023;14;14;0;100;0;95938.2142857143;1438.14285714286;67.0714285714286
61476;2023;5;5;0;100;0;208900;2171;115
61479;2023;1;1;0;100;0;225000;2045;110
61480;2023;3;3;0;100;0;130600;1535;85.3333333333333
61481;2023;1;1;0;100;0;280000;3500;80
61482;2023;3;3;0;100;0;73090.6666666667;926.666666666667;78
61483;2023;105;32;73;30.4761904761905;69.5238095238095;98484.8857142857;1865.21904761905;54.1047619047619
61484;2023;38;37;1;97.3684210526316;2.63157894736842;110707.263157895;1293.18421052632;82.8421052631579
61485;2023;6;6;0;100;0;116333.333333333;1061.33333333333;109.333333333333
61486;2023;60;59;1;98.3333333333333;1.66666666666667;110789.816666667;1181.75;96.6666666666667
61487;2023;1;1;0;100;0;60500;738;82
61490;2023;2;2;0;100;0;219800;2271.5;95.5
61491;2023;54;54;0;100;0;118338.444444444;1384.55555555556;88.4814814814815
61492;2023;1;1;0;100;0;85000;5667;15
61493;2023;2;2;0;100;0;72000;738.5;100.5
61494;2023;15;14;1;93.3333333333333;6.66666666666667;121062.666666667;1490.13333333333;85.6666666666667
61497;2023;8;7;1;87.5;12.5;167712.5;1671.5;103.625
61498;2023;1;1;0;100;0;179000;1085;165
61499;2023;3;3;0;100;0;187333.333333333;1260.66666666667;148.666666666667
61500;2023;2;2;0;100;0;62005;974.5;62
61501;2023;5;5;0;100;0;164500;1873.8;91
61502;2023;1;1;0;100;0;60000;968;62
61503;2023;4;4;0;100;0;121750;1168;107.75
61505;2023;3;3;0;100;0;45666.6666666667;565;77.6666666666667
61507;2023;3;3;0;100;0;150000;1548;106
61508;2023;40;32;8;80;20;114581.2;1328.5;85.875
61510;2023;2;2;0;100;0;139000;1723;95.5
61512;2023;1;1;0;100;0;120000;553;217
62001;2023;18;18;0;100;0;200169.444444444;1960.05555555556;98.6666666666667
62002;2023;1;1;0;100;0;58700;554;106
62003;2023;8;7;1;87.5;12.5;211113.75;1593.125;132
62004;2023;76;58;18;76.3157894736842;23.6842105263158;161078.605263158;2162.51315789474;78.5394736842105
62005;2023;11;11;0;100;0;154922.727272727;1541.90909090909;103.818181818182
62006;2023;4;4;0;100;0;133705;987.5;127.25
62007;2023;10;10;0;100;0;284930;2259;133.7
62008;2023;4;4;0;100;0;153750;1472.75;104.75
62009;2023;4;4;0;100;0;163862.5;1477;122
62010;2023;2;2;0;100;0;195100;2061.5;95
62011;2023;3;3;0;100;0;386666.666666667;1981.33333333333;193
62012;2023;4;4;0;100;0;240560;1768.25;133.5
62013;2023;12;12;0;100;0;234592.5;1921.16666666667;122.083333333333
62014;2023;92;84;8;91.304347826087;8.69565217391304;136267.826086957;1452.20652173913;94.5326086956522
62015;2023;3;3;0;100;0;186833.333333333;1802;96.6666666666667
62016;2023;2;2;0;100;0;143571.5;1386;138.5
62017;2023;1;1;0;100;0;90000;1184;76
62018;2023;4;4;0;100;0;161441;1751.25;91.75
62019;2023;35;33;2;94.2857142857143;5.71428571428571;170759.371428571;1942.31428571429;89
62020;2023;7;7;0;100;0;164445.142857143;2126.71428571429;82.7142857142857
62021;2023;7;7;0;100;0;250671.428571429;1774.42857142857;143.571428571429
62022;2023;3;3;0;100;0;197966.666666667;1668.33333333333;115.666666666667
62023;2023;31;31;0;100;0;144339;1468.32258064516;98
62024;2023;6;6;0;100;0;154718.333333333;1429;110.666666666667
62025;2023;35;30;5;85.7142857142857;14.2857142857143;290684.342857143;4112.4;78.8285714285714
62028;2023;2;2;0;100;0;184275;1729.5;105.5
62029;2023;4;4;0;100;0;136500;1033;138
62030;2023;3;3;0;100;0;144333.333333333;811;158.333333333333
62031;2023;26;26;0;100;0;209756.384615385;1941.53846153846;110
62032;2023;29;29;0;100;0;218603.103448276;1951.55172413793;117.068965517241
62033;2023;31;31;0;100;0;150061.709677419;1661.70967741935;92.1290322580645
62034;2023;18;18;0;100;0;162789.444444444;1763.5;92.5555555555556
62035;2023;78;78;0;100;0;145441.41025641;1560.38461538462;92.8076923076923
62036;2023;12;12;0;100;0;109899.583333333;1122.83333333333;104.083333333333
62037;2023;30;24;6;80;20;231757.166666667;2402.63333333333;99.7666666666667
62038;2023;46;46;0;100;0;195924.565217391;1840.78260869565;102.847826086957
62039;2023;8;8;0;100;0;281143.75;2089.125;139.75
62040;2023;92;89;3;96.7391304347826;3.26086956521739;147978.880434783;1710.72826086957;88.1413043478261
62041;2023;500;210;290;42;58;171097.842;2420.326;73.826
62042;2023;10;10;0;100;0;207465;1844.8;111.9
62043;2023;24;24;0;100;0;201960.416666667;2216.91666666667;94.2083333333333
62044;2023;3;3;0;100;0;150494;2147;73.3333333333333
62045;2023;14;14;0;100;0;162810.714285714;1506.14285714286;112.571428571429
62046;2023;8;8;0;100;0;125712.5;1335;89.25
62048;2023;103;95;8;92.2330097087379;7.76699029126214;115553.941747573;1381.52427184466;91.5339805825243
62049;2023;5;5;0;100;0;150895.6;1795.4;84.8
62050;2023;13;13;0;100;0;100904.769230769;1103.30769230769;93.7692307692308
62051;2023;46;45;1;97.8260869565217;2.17391304347826;184645.717391304;2029.19565217391;89.5217391304348
62052;2023;3;3;0;100;0;416983.333333333;3111.33333333333;134.666666666667
62053;2023;6;6;0;100;0;123525;1080.33333333333;110.5
62054;2023;11;11;0;100;0;305993.909090909;3710.63636363636;87.2727272727273
62055;2023;9;9;0;100;0;211233.333333333;1916.44444444444;114.777777777778
62056;2023;9;7;2;77.7777777777778;22.2222222222222;320925.222222222;4278.66666666667;80.7777777777778
62057;2023;48;43;5;89.5833333333333;10.4166666666667;192196.875;2038.75;97.6875
62058;2023;2;2;0;100;0;125000;1310.5;102.5
62059;2023;1;1;0;100;0;180000;1091;165
62060;2023;23;23;0;100;0;92293.4782608696;1081.30434782609;89.4782608695652
62061;2023;5;5;0;100;0;192220;6829.2;81.6
62062;2023;1;1;0;100;0;139000;1738;80
62063;2023;18;17;1;94.4444444444444;5.55555555555556;149472.777777778;1753.11111111111;86.5
62064;2023;4;4;0;100;0;142000;1527.25;88.75
62065;2023;148;103;45;69.5945945945946;30.4054054054054;113604.209459459;1516.65540540541;75.3648648648649
62067;2023;5;5;0;100;0;205168;1957.6;109.6
62068;2023;7;7;0;100;0;193739.428571429;1826;114.714285714286
62069;2023;6;5;1;83.3333333333333;16.6666666666667;168083.333333333;1525.5;113.5
62070;2023;1;1;0;100;0;140000;1077;130
62071;2023;7;7;0;100;0;175928.571428571;1574.71428571429;119.142857142857
62072;2023;3;3;0;100;0;207333.333333333;2187;93
62073;2023;14;14;0;100;0;223985.785714286;2043.14285714286;110.5
62074;2023;1;1;0;100;0;255500;3006;85
62075;2023;11;11;0;100;0;256730;2249.27272727273;113.363636363636
62077;2023;3;3;0;100;0;204283.333333333;1904.33333333333;107.666666666667
62078;2023;12;12;0;100;0;212858.333333333;2111.58333333333;106
62080;2023;32;28;4;87.5;12.5;121368.125;1323.71875;92.5
62081;2023;3;3;0;100;0;172383.333333333;1233.66666666667;133.333333333333
62082;2023;3;3;0;100;0;233400;1298;188.666666666667
62083;2023;49;49;0;100;0;143765.571428571;1568.95918367347;94.7755102040816
62085;2023;3;3;0;100;0;157110;1380;111
62086;2023;2;2;0;100;0;135000;1259;106.5
62087;2023;7;7;0;100;0;242457.142857143;1874.28571428571;133
62089;2023;5;5;0;100;0;266710;2612.2;93.4
62090;2023;4;4;0;100;0;122000;1149.75;112.5
62092;2023;2;2;0;100;0;187500;1956.5;95.5
62093;2023;2;2;0;100;0;133500;1139;116
62094;2023;3;3;0;100;0;230069.333333333;2030;112.333333333333
62095;2023;4;4;0;100;0;90500;809.75;119
62096;2023;3;3;0;100;0;163300;1356.33333333333;114
62097;2023;6;6;0;100;0;203716.666666667;1994.5;101.833333333333
62099;2023;52;42;10;80.7692307692308;19.2307692307692;184387.903846154;2111.01923076923;88.5961538461538
62100;2023;23;23;0;100;0;140919.652173913;1588.91304347826;87.4347826086957
62101;2023;2;2;0;100;0;113060;1300.5;95.5
62103;2023;2;2;0;100;0;135075;945.5;140.5
62104;2023;4;4;0;100;0;230580;1659;140.5
62105;2023;5;5;0;100;0;368708.2;2284.2;162.6
62106;2023;3;3;0;100;0;221200;2173;103.333333333333
62107;2023;3;3;0;100;0;295833.333333333;1935.33333333333;152.333333333333
62108;2023;351;146;205;41.5954415954416;58.4045584045584;165143.914529915;2964.95156695157;59.3960113960114
62109;2023;2;2;0;100;0;119000;1188.5;100
62111;2023;4;4;0;100;0;89125;1051.25;111.25
62112;2023;5;5;0;100;0;146940;1767.8;82.2
62113;2023;3;3;0;100;0;162000;1103;153.333333333333
62114;2023;1;1;0;100;0;280000;956;293
62115;2023;7;7;0;100;0;171680.714285714;1617.71428571429;104
62116;2023;1;1;0;100;0;270000;1617;167
62117;2023;11;10;1;90.9090909090909;9.09090909090909;125895.454545455;1337.09090909091;96.0909090909091
62118;2023;1;1;0;100;0;143000;1788;80
62119;2023;327;217;110;66.3608562691132;33.6391437308869;133286.981651376;1635.67584097859;83.0214067278287
62120;2023;4;4;0;100;0;185629.25;1432.25;126
62121;2023;1;1;0;100;0;83000;1407;59
62122;2023;3;3;0;100;0;167998.666666667;980.333333333333;147
62123;2023;10;10;0;100;0;206500;2478.7;106.7
62124;2023;1;1;0;100;0;295000;2360;125
62125;2023;5;5;0;100;0;287070;2553.6;115.6
62126;2023;83;68;15;81.9277108433735;18.0722891566265;137273.253012048;1630.25301204819;84.1084337349398
62127;2023;2;2;0;100;0;152500;1248.5;118
62128;2023;41;41;0;100;0;150683.170731707;1645.73170731707;94.3414634146341
62129;2023;1;1;0;100;0;165900;3318;50
62130;2023;3;3;0;100;0;129000;1274.33333333333;95.3333333333333
62131;2023;4;4;0;100;0;148675;1386;106.25
62132;2023;58;58;0;100;0;175579.568965517;1995.44827586207;90.2241379310345
62133;2023;45;42;3;93.3333333333333;6.66666666666667;111390.444444444;1309.22222222222;84.5333333333333
62135;2023;2;2;0;100;0;178250;2167.5;82
62137;2023;1;1;0;100;0;127500;1238;103
62138;2023;3;3;0;100;0;173983.333333333;975.333333333333;190.333333333333
62139;2023;47;47;0;100;0;162151.957446809;1700.82978723404;97.9787234042553
62140;2023;3;3;0;100;0;131998.333333333;1496.66666666667;88.3333333333333
62141;2023;11;11;0;100;0;174342.727272727;1675.09090909091;106.636363636364
62143;2023;2;2;0;100;0;152000;1431.5;103
62144;2023;4;4;0;100;0;211425;1675.75;120.5
62145;2023;6;6;0;100;0;158733.333333333;1784.5;89
62146;2023;3;3;0;100;0;225633.333333333;1547.66666666667;152.666666666667
62147;2023;4;4;0;100;0;131100;1384.25;96
62148;2023;6;6;0;100;0;199138.333333333;2154.16666666667;95.1666666666667
62149;2023;2;2;0;100;0;162500;1771.5;92
62151;2023;4;4;0;100;0;255750;2226;112
62153;2023;4;4;0;100;0;103375;1063.75;98.25
62154;2023;10;10;0;100;0;108930;1111.2;98.5
62155;2023;3;3;0;100;0;244333.333333333;1542;162.333333333333
62156;2023;11;11;0;100;0;323958.454545455;2442.27272727273;123.636363636364
62158;2023;8;8;0;100;0;87643.75;1040.25;95.5
62160;2023;457;210;247;45.9518599562363;54.0481400437637;128461.741794311;1758.50328227571;75.9693654266958
62161;2023;12;12;0;100;0;139552.083333333;1537;88.3333333333333
62162;2023;11;11;0;100;0;124863.636363636;1303.36363636364;95.5454545454545
62163;2023;4;4;0;100;0;96875;1419;71
62164;2023;7;6;1;85.7142857142857;14.2857142857143;116771.428571429;1109.57142857143;103.285714285714
62165;2023;1;1;0;100;0;180000;1800;100
62166;2023;3;3;0;100;0;229609.333333333;1579;145.333333333333
62167;2023;2;2;0;100;0;311400;2294;137.5
62168;2023;6;6;0;100;0;194866.666666667;1556.5;122.833333333333
62169;2023;3;3;0;100;0;229266.666666667;1825;126
62170;2023;14;14;0;100;0;199418.571428571;1736.85714285714;111.285714285714
62171;2023;3;3;0;100;0;160266.666666667;1573;103.666666666667
62172;2023;5;5;0;100;0;208815;2262;93.8
62173;2023;64;63;1;98.4375;1.5625;170430.703125;1918.515625;89.59375
62174;2023;10;10;0;100;0;171610;1913;91.6
62175;2023;1;1;0;100;0;85000;659;129
62176;2023;8;8;0;100;0;266538.75;2188.625;119.75
62177;2023;10;10;0;100;0;79447.8;1328.2;59
62178;2023;140;128;12;91.4285714285714;8.57142857142857;129803.15;1448.69285714286;91.5071428571429
62179;2023;3;3;0;100;0;254596.666666667;2567.33333333333;102
62181;2023;11;11;0;100;0;148514.545454545;1668.81818181818;95.3636363636364
62182;2023;3;3;0;100;0;106333.333333333;1244.33333333333;82.3333333333333
62183;2023;5;5;0;100;0;114170;1232.6;96.8
62184;2023;3;3;0;100;0;230316.666666667;1977.33333333333;118
62185;2023;3;3;0;100;0;111500;1053;95.6666666666667
62186;2023;98;94;4;95.9183673469388;4.08163265306122;137951.37755102;1586.97959183673;89.3877551020408
62187;2023;2;2;0;100;0;140500;1524.5;94
62188;2023;30;30;0;100;0;117067.133333333;1290.26666666667;87.5333333333333
62189;2023;2;2;0;100;0;202000;1576.5;131
62190;2023;12;12;0;100;0;124014.166666667;1259.08333333333;96.4166666666667
62191;2023;5;5;0;100;0;129206;1381.4;89.4
62192;2023;6;6;0;100;0;113666.666666667;1186;91.1666666666667
62193;2023;826;613;213;74.2130750605327;25.7869249394673;132157.346246973;1725.80508474576;80.9019370460048
62194;2023;32;32;0;100;0;137128.28125;1444.53125;95.96875
62195;2023;14;14;0;100;0;238314.285714286;1985.57142857143;121.142857142857
62196;2023;11;11;0;100;0;216518.181818182;2297.63636363636;98.9090909090909
62197;2023;7;7;0;100;0;128626.428571429;1329.85714285714;98.2857142857143
62198;2023;4;4;0;100;0;249000;2648;99.75
62199;2023;6;6;0;100;0;227650.666666667;2410.16666666667;100.666666666667
62200;2023;5;5;0;100;0;184600;1727.2;99.6
62201;2023;115;69;46;60;40;171622.956521739;3535.87826086957;52.5826086956522
62202;2023;4;4;0;100;0;167737.5;1433.75;118
62203;2023;9;9;0;100;0;168647.444444444;1421.44444444444;117.333333333333
62204;2023;10;10;0;100;0;205410;1748.7;127.4
62205;2023;10;10;0;100;0;254040;1965.6;134.3
62206;2023;3;3;0;100;0;319966.666666667;3022.66666666667;106.666666666667
62207;2023;5;5;0;100;0;181600;1914;93
62209;2023;2;2;0;100;0;87000;1870;60
62211;2023;3;3;0;100;0;275179.333333333;2155;128
62212;2023;8;8;0;100;0;134779;1434;97.625
62213;2023;6;6;0;100;0;283835;2275.33333333333;127
62214;2023;2;2;0;100;0;257500;2306;112.5
62215;2023;161;157;4;97.5155279503106;2.48447204968944;168487.02484472;1811.92546583851;92.2857142857143
62216;2023;2;2;0;100;0;137375;1330.5;103
62217;2023;25;25;0;100;0;107082.48;1120.68;92.16
62218;2023;2;2;0;100;0;203000;2268;92.5
62219;2023;1;1;0;100;0;82500;897;92
62220;2023;6;6;0;100;0;142666.666666667;1628;87.8333333333333
62221;2023;3;3;0;100;0;104333.333333333;1213.33333333333;87.6666666666667
62222;2023;1;1;0;100;0;210000;1409;149
62223;2023;2;2;0;100;0;319125;2916.5;110
62224;2023;30;30;0;100;0;122756.6;1328.56666666667;97.2333333333333
62225;2023;4;4;0;100;0;167862.5;1620.75;101.5
62227;2023;6;6;0;100;0;147333.333333333;1849.16666666667;85.1666666666667
62228;2023;1;1;0;100;0;159000;994;160
62229;2023;6;6;0;100;0;171333.333333333;1622.83333333333;113.166666666667
62230;2023;9;9;0;100;0;257822.222222222;2230.11111111111;116.777777777778
62231;2023;2;2;0;100;0;94462.5;1467;66
62232;2023;6;6;0;100;0;99500;1157.5;89.6666666666667
62233;2023;6;6;0;100;0;281035.833333333;2441;115.666666666667
62234;2023;4;4;0;100;0;115250;1050;95.5
62235;2023;35;35;0;100;0;463917.714285714;3252.88571428571;144.657142857143
62236;2023;11;11;0;100;0;122504.545454545;1596;80.9090909090909
62237;2023;4;4;0;100;0;271625;1615.75;172
62238;2023;2;2;0;100;0;160500;1701;94.5
62239;2023;26;16;10;61.5384615384615;38.4615384615385;183175.769230769;2437.5;76.0769230769231
62240;2023;22;22;0;100;0;159290.909090909;1835.54545454545;81.5909090909091
62241;2023;2;2;0;100;0;191000;1784.5;105.5
62242;2023;1;1;0;100;0;60000;1000;60
62243;2023;1;1;0;100;0;175750;1910;92
62244;2023;60;56;4;93.3333333333333;6.66666666666667;173282.733333333;1996.7;91.7833333333333
62245;2023;5;5;0;100;0;240540;2260.8;112.8
62246;2023;5;5;0;100;0;96600;1235.2;79.8
62247;2023;7;7;0;100;0;154535.714285714;1654.85714285714;94.7142857142857
62248;2023;7;7;0;100;0;177960;1589.71428571429;112.857142857143
62249;2023;55;54;1;98.1818181818182;1.81818181818182;158853;1815.81818181818;91.3636363636364
62250;2023;89;87;2;97.752808988764;2.24719101123596;162928.404494382;1738.26966292135;94.9325842696629
62251;2023;4;4;0;100;0;184782.5;1698.75;111.75
62252;2023;21;21;0;100;0;232343.333333333;1883.33333333333;124.809523809524
62254;2023;4;4;0;100;0;108287.5;1330.75;86.75
62255;2023;3;3;0;100;0;404666.666666667;2581.66666666667;161.666666666667
62256;2023;2;2;0;100;0;130000;1283;107
62257;2023;6;6;0;100;0;145916.666666667;1241.83333333333;124.166666666667
62259;2023;7;7;0;100;0;201115.714285714;1848.57142857143;109.571428571429
62260;2023;7;7;0;100;0;181158.285714286;1481;123
62261;2023;179;97;82;54.1899441340782;45.8100558659218;304014.245810056;4386.61452513966;70.0055865921788
62262;2023;13;13;0;100;0;166071;1858.92307692308;90.3846153846154
62263;2023;42;42;0;100;0;207672.619047619;2116.78571428571;97.6666666666667
62264;2023;11;11;0;100;0;166880.818181818;2033;80.2727272727273
62265;2023;11;11;0;100;0;166209.090909091;1565.09090909091;105.909090909091
62266;2023;1;1;0;100;0;202900;1549;131
62267;2023;4;4;0;100;0;93631.25;1199.25;78.25
62268;2023;60;60;0;100;0;113968.333333333;1412.31666666667;83.3166666666667
62269;2023;5;5;0;100;0;147950;1553.2;99.4
62270;2023;48;43;5;89.5833333333333;10.4166666666667;126099.6875;1392.04166666667;90.0208333333333
62271;2023;6;6;0;100;0;176515.666666667;1496.16666666667;125.833333333333
62272;2023;3;3;0;100;0;151583.333333333;1408.66666666667;110.333333333333
62273;2023;5;5;0;100;0;174409;1647.6;105.2
62274;2023;51;51;0;100;0;180099.960784314;1793.96078431373;104.058823529412
62275;2023;3;3;0;100;0;127333.333333333;1601;93.3333333333333
62276;2023;71;70;1;98.5915492957747;1.40845070422535;189887.169014085;2003.25352112676;95.8028169014084
62277;2023;21;20;1;95.2380952380952;4.76190476190476;136740.571428571;1545.95238095238;88.6190476190476
62278;2023;2;2;0;100;0;91500;1459.5;62.5
62279;2023;10;10;0;100;0;324890;2321.1;133.9
62280;2023;2;2;0;100;0;119650;1348.5;89.5
62281;2023;2;2;0;100;0;345100;2301.5;152
62282;2023;2;2;0;100;0;90000;1003;97.5
62283;2023;1;1;0;100;0;201000;1169;172
62284;2023;17;17;0;100;0;145139.529411765;1605.17647058824;92.5882352941177
62285;2023;5;5;0;100;0;188551;1552.4;129.8
62286;2023;4;4;0;100;0;141125;1441;93.75
62288;2023;24;24;0;100;0;202329.75;1901.66666666667;113.958333333333
62289;2023;3;3;0;100;0;166666.666666667;2487;67.3333333333333
62290;2023;2;2;0;100;0;390000;2450;156
62291;2023;24;23;1;95.8333333333333;4.16666666666667;136827.916666667;1539.91666666667;86.0833333333333
62292;2023;13;13;0;100;0;113807.538461538;1316.76923076923;88.0769230769231
62293;2023;5;5;0;100;0;105800;1172;90
62295;2023;8;8;0;100;0;139109.375;1336.5;106.25
62296;2023;1;1;0;100;0;247000;3431;72
62297;2023;28;28;0;100;0;184252.5;1820.07142857143;102.928571428571
62298;2023;7;7;0;100;0;161364.285714286;1532.71428571429;116.285714285714
62299;2023;4;4;0;100;0;177662.5;2056.5;88.75
62300;2023;25;22;3;88;12;193703.8;2467;84.24
62301;2023;2;2;0;100;0;132500;1442;98.5
62302;2023;3;3;0;100;0;175233.333333333;1709.66666666667;103.666666666667
62303;2023;5;5;0;100;0;132900;1310;104.2
62304;2023;7;7;0;100;0;119350;1184;105.571428571429
62306;2023;5;5;0;100;0;120800;1251.2;106.2
62307;2023;3;3;0;100;0;353083.333333333;3662.33333333333;111
62308;2023;3;3;0;100;0;165000;1942;89.6666666666667
62309;2023;17;17;0;100;0;157202.941176471;1806.17647058824;91.8823529411765
62310;2023;10;10;0;100;0;242275.1;1915.2;118.5
62311;2023;17;17;0;100;0;206834.352941176;1836.76470588235;108.235294117647
62312;2023;2;2;0;100;0;160000;1554.5;125.5
62313;2023;13;13;0;100;0;97211.5384615385;1140.38461538462;88.0769230769231
62314;2023;6;6;0;100;0;137075;1453;100.5
62315;2023;3;3;0;100;0;275600;2227.66666666667;124
62316;2023;2;2;0;100;0;80783;1142;70
62317;2023;5;5;0;100;0;188630;1498;119.2
62318;2023;133;104;29;78.1954887218045;21.8045112781955;210137.308270677;2809.59398496241;79.1503759398496
62319;2023;1;1;0;100;0;318000;2356;135
62320;2023;3;3;0;100;0;141666.666666667;1373;110
62321;2023;37;37;0;100;0;179956.837837838;1822.10810810811;100.459459459459
62322;2023;1;1;0;100;0;1,00E+05;980;102
62323;2023;12;12;0;100;0;256659.833333333;2573.16666666667;95.1666666666667
62324;2023;12;12;0;100;0;271190.833333333;2214.25;122.916666666667
62325;2023;7;7;0;100;0;100089.285714286;1150.85714285714;91.5714285714286
62327;2023;5;5;0;100;0;116950;1006.8;120.2
62328;2023;11;11;0;100;0;118086.363636364;1247.27272727273;92.6363636363636
62329;2023;16;16;0;100;0;177287.5;1632;106
62330;2023;17;17;0;100;0;331229.941176471;2352;132.764705882353
62331;2023;14;14;0;100;0;128285.714285714;1410;90.0714285714286
62332;2023;4;4;0;100;0;165875;1997;84
62333;2023;2;2;0;100;0;121250;1193;100.5
62334;2023;8;8;0;100;0;223162.5;1892.375;119
62335;2023;12;12;0;100;0;129431.25;1221.66666666667;103.166666666667
62336;2023;2;2;0;100;0;234950;1701.5;127
62338;2023;36;36;0;100;0;416432;3114.58333333333;137.055555555556
62339;2023;1;1;0;100;0;2,00E+05;1695;118
62340;2023;7;7;0;100;0;89497.1428571429;1014.57142857143;81.2857142857143
62341;2023;2;2;0;100;0;341437.5;1683;180
62342;2023;1;1;0;100;0;35000;673;52
62343;2023;1;1;0;100;0;127000;1530;83
62344;2023;1;1;0;100;0;90000;692;130
62346;2023;3;3;0;100;0;111333.333333333;1055;107
62349;2023;10;10;0;100;0;123950;1416.6;89.5
62350;2023;8;8;0;100;0;177875;1832.125;97.5
62351;2023;40;39;1;97.5;2.5;158575.875;1624.65;101.9
62352;2023;2;2;0;100;0;145000;914.5;147.5
62353;2023;4;4;0;100;0;124250;1204;101.5
62354;2023;13;13;0;100;0;223946.153846154;2141.53846153846;107.230769230769
62355;2023;4;4;0;100;0;159275;1544.25;103.75
62356;2023;7;7;0;100;0;161821.428571429;1874.57142857143;88
62357;2023;1;1;0;100;0;98000;1077;91
62358;2023;2;2;0;100;0;116500;1322;92.5
62359;2023;10;9;1;90;10;174598.5;1857.1;99.7
62360;2023;8;8;0;100;0;175717;1635.75;110.125
62361;2023;29;29;0;100;0;91802.4482758621;1152.37931034483;82.3103448275862
62362;2023;1;1;0;100;0;2,00E+05;1852;108
62363;2023;6;6;0;100;0;217100;1822.83333333333;123.666666666667
62364;2023;29;29;0;100;0;95723.9655172414;889.034482758621;107.620689655172
62365;2023;3;3;0;100;0;97833.3333333333;1073.66666666667;110.333333333333
62366;2023;3;3;0;100;0;182395;1915.66666666667;97
62367;2023;5;5;0;100;0;115660;1037.4;103
62368;2023;4;4;0;100;0;163535;1599;104.25
62369;2023;3;3;0;100;0;220333.333333333;1960.33333333333;127
62371;2023;27;27;0;100;0;181987.740740741;1867.62962962963;100.333333333333
62373;2023;8;8;0;100;0;204381.25;1868.5;107.5
62374;2023;1;1;0;100;0;115000;1855;62
62376;2023;22;22;0;100;0;217772.272727273;2207.63636363636;98.9545454545455
62377;2023;8;8;0;100;0;176856.875;1699.5;102.625
62378;2023;1;1;0;100;0;305000;1556;196
62379;2023;2;2;0;100;0;134750;1721;81.5
62380;2023;2;2;0;100;0;193575;2169;106.5
62381;2023;1;1;0;100;0;108000;991;109
62382;2023;5;5;0;100;0;125200;1107.8;103.2
62383;2023;12;12;0;100;0;200795.833333333;1786.75;109.916666666667
62384;2023;5;5;0;100;0;111200;970.8;118.8
62385;2023;1;1;0;100;0;250000;1515;165
62386;2023;30;27;3;90;10;134680.233333333;1429.8;94.2
62387;2023;2;2;0;100;0;207500;2310.5;91.5
62388;2023;4;4;0;100;0;136112.5;1422.25;94.5
62390;2023;18;18;0;100;0;301318.888888889;2544.27777777778;120.5
62391;2023;13;13;0;100;0;159635.461538462;1932.15384615385;86.5384615384615
62392;2023;1;1;0;100;0;170000;1441;118
62393;2023;11;11;0;100;0;154295.454545455;1807.27272727273;83.1818181818182
62395;2023;2;2;0;100;0;180000;1926;95.5
62397;2023;55;55;0;100;0;146024.872727273;1611.94545454545;89.6
62398;2023;2;2;0;100;0;149500;1623.5;92.5
62399;2023;5;5;0;100;0;134300;1522.8;96
62400;2023;20;20;0;100;0;167295.5;1819.6;91.05
62401;2023;41;41;0;100;0;169252.926829268;1784;94.8536585365854
62403;2023;15;15;0;100;0;135056.666666667;1597.73333333333;88.0666666666667
62404;2023;5;5;0;100;0;125681.6;1336.2;91.6
62405;2023;2;2;0;100;0;232245;1738;139
62406;2023;3;3;0;100;0;209270;1635.33333333333;130.333333333333
62407;2023;7;7;0;100;0;142900;1319.85714285714;100.714285714286
62408;2023;13;13;0;100;0;204638.461538462;1792.76923076923;114.538461538462
62409;2023;1;1;0;100;0;210000;1981;106
62410;2023;5;5;0;100;0;157040;1332.8;111.8
62411;2023;1;1;0;100;0;120000;1071;112
62412;2023;16;16;0;100;0;209081.25;1829.6875;116.375
62413;2023;98;96;2;97.9591836734694;2.04081632653061;141452.581632653;1623.26530612245;87.7551020408163
62414;2023;2;2;0;100;0;254500;2274.5;111
62415;2023;2;2;0;100;0;292500;2489.5;117.5
62416;2023;1;1;0;100;0;1,00E+05;833;120
62418;2023;1;1;0;100;0;230010;2255;102
62419;2023;1;1;0;100;0;235000;1391;169
62421;2023;6;6;0;100;0;121466.666666667;983;122.166666666667
62422;2023;4;4;0;100;0;132650;1356.75;97
62423;2023;11;11;0;100;0;166831.454545455;1900.36363636364;87.7272727272727
62424;2023;3;3;0;100;0;145609.333333333;1872.33333333333;80.6666666666667
62425;2023;2;2;0;100;0;88750;1231;82
62426;2023;3;3;0;100;0;174033.333333333;1577.66666666667;108.666666666667
62427;2023;268;242;26;90.2985074626866;9.70149253731343;137633.205223881;1571.50373134328;87.0373134328358
62428;2023;5;5;0;100;0;193846;1663;112.6
62429;2023;2;2;0;100;0;177300;1701;98
62432;2023;2;2;0;100;0;212500;2147;99
62434;2023;3;3;0;100;0;167333.333333333;1128.66666666667;150.666666666667
62435;2023;1;1;0;100;0;223000;2624;85
62436;2023;2;2;0;100;0;117500;926.5;127
62437;2023;5;5;0;100;0;145800;1928.6;78.2
62438;2023;4;4;0;100;0;311625;1966.25;153.5
62439;2023;2;2;0;100;0;102065;1109;85
62440;2023;18;18;0;100;0;100494.444444444;1111.66666666667;92.2222222222222
62442;2023;6;6;0;100;0;117413.333333333;1336.33333333333;85.3333333333333
62443;2023;50;49;1;98;2;148788.2;1609.86;94.58
62444;2023;3;3;0;100;0;360950;2981.33333333333;124.333333333333
62445;2023;15;14;1;93.3333333333333;6.66666666666667;215276.666666667;1796.2;115.066666666667
62446;2023;11;10;1;90.9090909090909;9.09090909090909;193416.727272727;2196.63636363636;89.0909090909091
62447;2023;24;22;2;91.6666666666667;8.33333333333333;119237.083333333;1346.08333333333;86.5416666666667
62448;2023;16;16;0;100;0;230955.875;2402.3125;96.4375
62449;2023;2;2;0;100;0;130500;1586.5;79
62450;2023;1;1;0;100;0;140000;1000;140
62451;2023;8;8;0;100;0;98856.25;1040.875;96.5
62452;2023;13;13;0;100;0;220902.692307692;2043.84615384615;107.384615384615
62453;2023;4;4;0;100;0;177162.5;1657.5;103
62454;2023;15;15;0;100;0;214421;2185.53333333333;96.1333333333333
62456;2023;8;8;0;100;0;219937.5;2066.625;116.5
62457;2023;44;43;1;97.7272727272727;2.27272727272727;151487.045454545;1525.59090909091;99.7954545454545
62458;2023;8;8;0;100;0;165668.75;1767.5;100.375
62459;2023;4;4;0;100;0;115500;1008.25;132.25
62460;2023;2;2;0;100;0;302500;2046.5;141
62461;2023;12;12;0;100;0;145708.333333333;1630.83333333333;91.5
62462;2023;1;1;0;100;0;160000;1260;127
62464;2023;25;25;0;100;0;205333.88;2100.2;98.72
62465;2023;4;4;0;100;0;156287.5;2173.25;77.25
62466;2023;3;3;0;100;0;169666.666666667;1259.33333333333;128
62467;2023;5;5;0;100;0;168222;1880.8;113.8
62468;2023;3;3;0;100;0;156666.666666667;1681.66666666667;85.6666666666667
62469;2023;11;11;0;100;0;156130;1495;105.363636363636
62470;2023;1;1;0;100;0;50000;510;98
62471;2023;8;8;0;100;0;174276.875;1771.25;100.625
62472;2023;3;3;0;100;0;175000;1716.66666666667;93
62473;2023;103;99;4;96.1165048543689;3.88349514563107;120648.427184466;1331.93203883495;90.2038834951456
62474;2023;10;10;0;100;0;149470;1680.8;83.7
62475;2023;3;3;0;100;0;174670;1481.66666666667;116.333333333333
62476;2023;7;7;0;100;0;224685.714285714;2038.71428571429;96.1428571428571
62477;2023;5;5;0;100;0;227000;2066.2;111.8
62478;2023;4;4;0;100;0;300262.5;2214;124.25
62479;2023;20;20;0;100;0;142335;1626.8;90.8
62480;2023;25;25;0;100;0;161518.6;1669.4;97.04
62481;2023;2;2;0;100;0;82500;1004;81.5
62483;2023;2;2;0;100;0;112500;1327;87
62484;2023;1;1;0;100;0;97900;1041;94
62485;2023;3;3;0;100;0;109166.666666667;1144.33333333333;98.3333333333333
62486;2023;15;15;0;100;0;151665.333333333;1647.46666666667;95.3333333333333
62487;2023;8;8;0;100;0;179463.25;1734.125;108.5
62488;2023;5;5;0;100;0;201980;2144.4;96.6
62489;2023;34;34;0;100;0;174570.058823529;1754.11764705882;99
62490;2023;1;1;0;100;0;215500;2565;84
62491;2023;52;51;1;98.0769230769231;1.92307692307692;279219.846153846;2429.32692307692;118.480769230769
62492;2023;4;4;0;100;0;142000;1985.25;73
62493;2023;3;3;0;100;0;120866.666666667;999.333333333333;112.333333333333
62494;2023;1;1;0;100;0;270000;1392;194
62496;2023;4;4;0;100;0;411737.5;3685.75;116
62497;2023;48;48;0;100;0;160926.270833333;1730.52083333333;93.1041666666667
62498;2023;256;170;86;66.40625;33.59375;120725.75;1506.81640625;81.390625
62499;2023;3;3;0;100;0;179000;2434.66666666667;75
62500;2023;4;4;0;100;0;164165.75;1632;98.75
62501;2023;2;2;0;100;0;180800;1226.5;152.5
62502;2023;44;44;0;100;0;242051.863636364;2258.27272727273;109.181818181818
62504;2023;2;2;0;100;0;138000;1501;100
62505;2023;2;2;0;100;0;156000;1455.5;138
62506;2023;14;13;1;92.8571428571429;7.14285714285714;173619.642857143;1697.07142857143;103.428571428571
62507;2023;4;4;0;100;0;192700;1754.25;111
62509;2023;2;2;0;100;0;196150;1472;133.5
62510;2023;205;177;28;86.3414634146341;13.6585365853659;138246.995121951;1544.33170731707;89.6146341463415
62511;2023;3;3;0;100;0;60000;494.666666666667;129.333333333333
62512;2023;4;4;0;100;0;184062.5;2144.25;85.5
62514;2023;1;1;0;100;0;160000;3200;50
62515;2023;1;1;0;100;0;340000;1126;302
62516;2023;122;120;2;98.3606557377049;1.63934426229508;112477.868852459;1177.19672131148;95.3032786885246
62517;2023;3;3;0;100;0;194078.666666667;1961.66666666667;99
62518;2023;1;1;0;100;0;66200;1018;65
62519;2023;6;6;0;100;0;112916.666666667;1204.33333333333;91.8333333333333
62520;2023;14;14;0;100;0;254032;2085.28571428571;124.428571428571
62521;2023;1;1;0;100;0;1,00E+05;1064;94
62522;2023;4;4;0;100;0;154875;2042.5;83.5
62523;2023;62;61;1;98.3870967741936;1.61290322580645;127760.193548387;1536.75806451613;83.6774193548387
62524;2023;12;12;0;100;0;170504.166666667;1756.91666666667;95.0833333333333
62525;2023;102;95;7;93.1372549019608;6.86274509803922;179988.784313725;1874.75490196078;96.421568627451
62526;2023;4;4;0;100;0;229761.25;2275.25;101.75
62527;2023;4;4;0;100;0;193900;1715.25;107.75
62528;2023;54;50;4;92.5925925925926;7.40740740740741;178248.888888889;1877.96296296296;100.611111111111
62529;2023;17;17;0;100;0;313582.352941176;2737.94117647059;117.882352941176
62530;2023;5;5;0;100;0;151038;1699.6;94.8
62531;2023;11;11;0;100;0;125481.818181818;1357.72727272727;96.0909090909091
62532;2023;5;5;0;100;0;131185;1302.6;100
62533;2023;3;3;0;100;0;190533.333333333;1519.66666666667;132.333333333333
62534;2023;36;36;0;100;0;143927.222222222;1560.13888888889;93.6111111111111
62536;2023;2;2;0;100;0;117500;1066.5;109.5
62538;2023;3;3;0;100;0;141666.666666667;1302;108.666666666667
62539;2023;1;1;0;100;0;115000;1162;99
62540;2023;15;15;0;100;0;182748.666666667;1867.33333333333;94.4
62541;2023;1;1;0;100;0;149000;1307;114
62542;2023;2;2;0;100;0;235505;2276;105
62543;2023;23;23;0;100;0;169270;1795.69565217391;97.4782608695652
62544;2023;1;1;0;100;0;325000;1912;170
62545;2023;3;3;0;100;0;121333.333333333;1222;105
62546;2023;2;2;0;100;0;348650;2138;163
62547;2023;1;1;0;100;0;72000;1674;43
62548;2023;99;95;4;95.959595959596;4.04040404040404;213253.484848485;2102.19191919192;102.818181818182
62549;2023;13;13;0;100;0;147974.615384615;1314.92307692308;113
62550;2023;10;10;0;100;0;115758;1152.1;105.1
62551;2023;3;3;0;100;0;161133.333333333;1472.33333333333;109
62552;2023;6;6;0;100;0;196806;1697.66666666667;114.666666666667
62553;2023;1;1;0;100;0;35000;432;81
62555;2023;23;23;0;100;0;111603.826086957;1395.78260869565;80.3913043478261
62556;2023;5;5;0;100;0;63200;1802.8;31.4
62557;2023;22;22;0;100;0;206412.818181818;1979.04545454545;103.454545454545
62558;2023;1;1;0;100;0;98750;1162;85
62559;2023;14;14;0;100;0;177668.642857143;1592.14285714286;122.857142857143
62560;2023;41;41;0;100;0;167391.731707317;1826.9512195122;93.1951219512195
62562;2023;2;2;0;100;0;32499.5;708.5;46
62563;2023;49;36;13;73.469387755102;26.530612244898;124960.836734694;1599.9387755102;79.4285714285714
62564;2023;5;5;0;100;0;139130;1421.6;92.6
62566;2023;8;8;0;100;0;266937.5;2249.875;125.375
62567;2023;7;7;0;100;0;175955;1463;132
62568;2023;7;7;0;100;0;274735.714285714;2609.42857142857;106
62569;2023;6;6;0;100;0;207900;1639;121.5
62570;2023;75;74;1;98.6666666666667;1.33333333333333;148547.44;1544.86666666667;95.8933333333333
62571;2023;150;80;70;53.3333333333333;46.6666666666667;237417.726666667;3985.64666666667;62.3866666666667
62572;2023;7;7;0;100;0;80385.7142857143;859.285714285714;98.8571428571429
62573;2023;48;47;1;97.9166666666667;2.08333333333333;182217.8125;1881.0625;95.25
62574;2023;1;1;0;100;0;138600;1238;112
62576;2023;1;1;0;100;0;55000;423;130
62579;2023;4;4;0;100;0;161262.5;1288.25;128.75
62580;2023;3;3;0;100;0;204266.666666667;1669.66666666667;127
62581;2023;4;4;0;100;0;172576;1589.75;112.25
62582;2023;6;6;0;100;0;234888.333333333;1899.66666666667;128
62583;2023;4;4;0;100;0;179450;1830.75;100.5
62584;2023;15;15;0;100;0;175793.333333333;1910.2;99.7333333333333
62585;2023;8;8;0;100;0;189608.75;1467.5;143.5
62586;2023;1;1;0;100;0;380000;2857;133
62587;2023;74;63;11;85.1351351351351;14.8648648648649;146305.743243243;1585.27027027027;90.4864864864865
62588;2023;33;27;6;81.8181818181818;18.1818181818182;243793.939393939;2759.60606060606;91.030303030303
62589;2023;9;9;0;100;0;324794.444444444;2356.22222222222;127.444444444444
62590;2023;1;1;0;100;0;22000;400;55
62591;2023;1;1;0;100;0;47000;588;80
62592;2023;2;2;0;100;0;172775;1741.5;99
62594;2023;2;2;0;100;0;490000;6190;80
62595;2023;15;15;0;100;0;175598.666666667;1746.8;92.4666666666667
62596;2023;8;8;0;100;0;111250;1393.5;87
62597;2023;4;4;0;100;0;116975;1004.25;105
62598;2023;10;10;0;100;0;139400;1771.7;83.1
62599;2023;1;1;0;100;0;246000;2733;90
62600;2023;2;2;0;100;0;167000;1801.5;93
62601;2023;3;3;0;100;0;136333.333333333;1145;122.666666666667
62602;2023;2;2;0;100;0;100617.5;903;107
62603;2023;8;8;0;100;0;154075;1633.625;90.5
62604;2023;157;60;97;38.2165605095541;61.7834394904459;372444.72611465;5134.17834394904;80.8789808917197
62605;2023;1;1;0;100;0;131868;1099;120
62606;2023;14;14;0;100;0;263821.428571429;2561;105.428571428571
62607;2023;1;1;0;100;0;125000;1471;85
62608;2023;1;1;0;100;0;92000;920;100
62609;2023;14;14;0;100;0;267846.428571429;2488.85714285714;109.642857142857
62610;2023;8;8;0;100;0;159515;1456.25;109.875
62611;2023;4;4;0;100;0;215625;2271.75;96.5
62612;2023;7;6;1;85.7142857142857;14.2857142857143;193922.857142857;2091.42857142857;98.2857142857143
62613;2023;4;4;0;100;0;271362.5;1800.25;149
62614;2023;5;5;0;100;0;151550;1943.2;75.4
62615;2023;2;2;0;100;0;105500;1385;75.5
62616;2023;1;1;0;100;0;90000;1098;82
62617;2023;133;118;15;88.7218045112782;11.2781954887218;126001.30075188;1503.21804511278;85.1729323308271
62618;2023;10;10;0;100;0;186635;1918;97
62619;2023;1;1;0;100;0;110000;917;120
62620;2023;10;10;0;100;0;150035;1558.2;92.9
62621;2023;14;14;0;100;0;178669.5;1959.85714285714;91.8571428571429
62622;2023;4;4;0;100;0;158841.5;1478;129.25
62623;2023;1;1;0;100;0;82500;1375;60
62624;2023;21;20;1;95.2380952380952;4.76190476190476;149231.428571429;1719.09523809524;86.3333333333333
62626;2023;14;14;0;100;0;154985;1697.57142857143;91.4285714285714
62627;2023;9;9;0;100;0;192488.888888889;1974.22222222222;101.666666666667
62628;2023;27;26;1;96.2962962962963;3.7037037037037;100271.333333333;1272.2962962963;81.3333333333333
62629;2023;2;2;0;100;0;270910;3499.5;78.5
62630;2023;7;7;0;100;0;174315.714285714;1708.85714285714;105.714285714286
62631;2023;5;5;0;100;0;132164;1560.4;92
62633;2023;4;4;0;100;0;160000;1108.25;157
62634;2023;8;8;0;100;0;273905.375;2441.625;116.875
62635;2023;1;1;0;100;0;60300;744;81
62636;2023;3;3;0;100;0;217000;2358.33333333333;89.3333333333333
62637;2023;72;63;9;87.5;12.5;152619.319444444;1781.375;87.5555555555556
62638;2023;15;15;0;100;0;191870;1674.6;111.333333333333
62639;2023;3;3;0;100;0;182333.333333333;1750;95.3333333333333
62640;2023;1;1;0;100;0;259997;1857;140
62641;2023;2;2;0;100;0;70000;1004.5;66.5
62642;2023;7;7;0;100;0;98364.2857142857;1026.57142857143;91.2857142857143
62643;2023;123;114;9;92.6829268292683;7.31707317073171;156340.048780488;1750.45528455285;90.1869918699187
62644;2023;13;13;0;100;0;126352.461538462;1215.69230769231;106.153846153846
62645;2023;58;56;2;96.551724137931;3.44827586206897;188665.844827586;1964.74137931034;96.051724137931
62646;2023;4;4;0;100;0;138375;1404;100.75
62647;2023;4;4;0;100;0;112725;1723.5;66
62648;2023;4;4;0;100;0;109375;1076.75;108.5
62649;2023;7;7;0;100;0;94890;804.571428571429;116.285714285714
62650;2023;5;5;0;100;0;177450;1678.4;107.6
62651;2023;4;4;0;100;0;137925;1428;105
62652;2023;12;12;0;100;0;97708.3333333333;1171.25;86.75
62653;2023;6;6;0;100;0;377066.666666667;2539.5;155
62654;2023;11;11;0;100;0;259840.909090909;2454.18181818182;120.727272727273
62655;2023;1;1;0;100;0;95000;1319;72
62656;2023;6;6;0;100;0;155116.666666667;1640.33333333333;104.166666666667
62657;2023;4;4;0;100;0;295875;2286.75;125.5
62658;2023;1;1;0;100;0;474530;5158;92
62659;2023;1;1;0;100;0;250000;1866;134
62660;2023;4;4;0;100;0;200650;2227.25;90.25
62661;2023;8;8;0;100;0;121643.5;1572.25;84.125
62662;2023;5;5;0;100;0;202200;1939.2;104.8
62663;2023;1;1;0;100;0;95000;1118;85
62664;2023;1;1;0;100;0;75000;789;95
62665;2023;3;3;0;100;0;93383.3333333333;1120.33333333333;87.6666666666667
62666;2023;36;36;0;100;0;130343.388888889;1527.13888888889;83.0555555555556
62667;2023;104;75;29;72.1153846153846;27.8846153846154;154030.711538462;1975.82692307692;83.9038461538462
62668;2023;1;1;0;100;0;66000;1015;65
62669;2023;1;1;0;100;0;225000;2394;94
62670;2023;6;6;0;100;0;127333.333333333;1621.66666666667;92.6666666666667
62671;2023;3;3;0;100;0;238966.666666667;2400.33333333333;100.666666666667
62672;2023;5;5;0;100;0;176359;1847.2;94.6
62673;2023;7;7;0;100;0;185721.428571429;1922.85714285714;101.142857142857
62674;2023;5;5;0;100;0;209000;1910.8;121
62675;2023;1;1;0;100;0;211850;2278;93
62676;2023;1;1;0;100;0;253435;3053;83
62677;2023;3;3;0;100;0;190433.333333333;1546.66666666667;128.666666666667
62678;2023;8;8;0;100;0;139915.375;1348.125;109.5
62679;2023;3;3;0;100;0;217000;1253.66666666667;171.666666666667
62680;2023;5;5;0;100;0;172350;1866.6;93.6
62681;2023;1;1;0;100;0;253800;2307;110
62682;2023;1;1;0;100;0;87500;465;188
62683;2023;1;1;0;100;0;64000;542;118
62684;2023;25;25;0;100;0;171097.64;1859.48;95.2
62685;2023;6;6;0;100;0;87736.6666666667;1004.83333333333;82.3333333333333
62686;2023;1;1;0;100;0;210000;1448;145
62688;2023;65;65;0;100;0;200328.215384615;2551.6;81.2461538461538
62689;2023;4;4;0;100;0;160500;1565.75;97.5
62690;2023;3;3;0;100;0;132933.333333333;1390.33333333333;89
62691;2023;8;8;0;100;0;230937.5;2149.25;114.125
62692;2023;2;2;0;100;0;215525;2042.5;105
62693;2023;11;11;0;100;0;187712.090909091;1851.63636363636;101.181818181818
62694;2023;4;4;0;100;0;78560;1099.75;72
62695;2023;5;5;0;100;0;91927;1302.8;73.2
62696;2023;3;3;0;100;0;154000;1281;119.333333333333
62697;2023;3;3;0;100;0;201233.333333333;1925;101
62698;2023;2;2;0;100;0;241952.5;2912;89.5
62699;2023;7;7;0;100;0;165285.714285714;1940;85
62700;2023;1;1;0;100;0;202000;1295;156
62701;2023;3;3;0;100;0;180266.666666667;1848.33333333333;114.333333333333
62702;2023;2;2;0;100;0;198150;2002;101.5
62703;2023;7;7;0;100;0;193942.857142857;1888.85714285714;106
62704;2023;6;6;0;100;0;141916.666666667;1564.33333333333;101.666666666667
62705;2023;19;19;0;100;0;193471.157894737;1822.68421052632;105.842105263158
62706;2023;29;29;0;100;0;264564.275862069;2332.48275862069;115.103448275862
62709;2023;1;1;0;100;0;130000;2500;52
62711;2023;28;28;0;100;0;192400.714285714;1912.75;102.214285714286
62712;2023;14;14;0;100;0;196795;1833.78571428571;109.428571428571
62713;2023;12;12;0;100;0;199075;1608.83333333333;119
62714;2023;17;17;0;100;0;286588.529411765;2421.58823529412;116.058823529412
62715;2023;2;2;0;100;0;101500;1386;73.5
62716;2023;5;5;0;100;0;197600;1732.6;115
62717;2023;4;4;0;100;0;181375;1690;107.75
62718;2023;9;9;0;100;0;193547.222222222;1886;101.444444444444
62719;2023;2;2;0;100;0;152095;2087.5;74.5
62721;2023;11;11;0;100;0;159309.090909091;1725.54545454545;95.1818181818182
62722;2023;1;1;0;100;0;136000;1214;112
62723;2023;1;1;0;100;0;238000;1497;159
62724;2023;54;54;0;100;0;145304.648148148;1580.83333333333;95.4074074074074
62725;2023;2;2;0;100;0;166500;1875;89.5
62726;2023;1;1;0;100;0;175600;1774;99
62727;2023;18;15;3;83.3333333333333;16.6666666666667;163377.777777778;1695.44444444444;96.1666666666667
62728;2023;6;6;0;100;0;170116.666666667;1551.5;105.166666666667
62729;2023;2;2;0;100;0;140000;1416.5;97.5
62730;2023;18;18;0;100;0;202976.666666667;1897.83333333333;111.5
62731;2023;3;3;0;100;0;105666.666666667;1063.66666666667;96.6666666666667
62732;2023;3;3;0;100;0;179000;1374;128
62733;2023;4;4;0;100;0;146111.25;1469.5;100
62734;2023;6;6;0;100;0;234700;1886.66666666667;130.666666666667
62735;2023;23;23;0;100;0;165537.043478261;1715.13043478261;95.7391304347826
62736;2023;28;26;2;92.8571428571429;7.14285714285714;255898.785714286;2470.71428571429;101.678571428571
62737;2023;59;53;6;89.8305084745763;10.1694915254237;131562.372881356;1548.96610169492;83.9322033898305
62739;2023;3;3;0;100;0;148833.333333333;1046.33333333333;145.666666666667
62740;2023;6;6;0;100;0;127500;1497.16666666667;84.6666666666667
62741;2023;2;2;0;100;0;74666.5;725.5;92.5
62742;2023;4;4;0;100;0;313750;3184.75;97.25
62744;2023;44;36;8;81.8181818181818;18.1818181818182;220920.113636364;2199.84090909091;101.431818181818
62745;2023;4;4;0;100;0;137250;1714.75;80
62746;2023;48;48;0;100;0;177044.3125;2075.04166666667;87.4583333333333
62747;2023;4;4;0;100;0;157725;1772.75;99.25
62748;2023;19;19;0;100;0;211436.578947368;2008.31578947368;106.421052631579
62749;2023;6;6;0;100;0;132500;1472.83333333333;94.1666666666667
62750;2023;5;5;0;100;0;176740;1366.8;122
62751;2023;9;9;0;100;0;200278.888888889;2162;96.2222222222222
62752;2023;17;17;0;100;0;405480.411764706;3029.23529411765;131.764705882353
62753;2023;70;57;13;81.4285714285714;18.5714285714286;190005.357142857;2055.6;92.3285714285714
62754;2023;3;3;0;100;0;249141.666666667;1628.66666666667;149.333333333333
62755;2023;32;31;1;96.875;3.125;222757.90625;2258.78125;99.9375
62756;2023;16;16;0;100;0;155681.25;1638.75;97.9375
62757;2023;49;48;1;97.9591836734694;2.04081632653061;193518.163265306;1837.63265306122;104.285714285714
62758;2023;155;122;33;78.7096774193548;21.2903225806452;177710.522580645;1988.84516129032;92.8064516129032
62759;2023;4;4;0;100;0;169375;1953;91.25
62760;2023;5;5;0;100;0;140118;1469.2;92.4
62761;2023;1;1;0;100;0;361620;2333;155
62763;2023;12;12;0;100;0;112016.666666667;1113.66666666667;102.416666666667
62764;2023;43;43;0;100;0;181914.697674419;1818.32558139535;101.232558139535
62765;2023;163;104;59;63.8036809815951;36.1963190184049;155813.687116564;1765.8036809816;90.5337423312883
62766;2023;7;7;0;100;0;206985.714285714;2260.28571428571;91.8571428571429
62767;2023;55;45;10;81.8181818181818;18.1818181818182;92990.1818181818;1115;83.2727272727273
62768;2023;2;2;0;100;0;203000;1132.5;178.5
62769;2023;5;5;0;100;0;258400;2274;115.2
62770;2023;33;33;0;100;0;168706.727272727;1775.15151515152;94.4848484848485
62771;2023;41;40;1;97.5609756097561;2.4390243902439;112687.926829268;1308.29268292683;86.8536585365854
62772;2023;5;5;0;100;0;67030;1429;47.8
62773;2023;41;41;0;100;0;176823.56097561;1908.90243902439;92.0975609756098
62774;2023;41;34;7;82.9268292682927;17.0731707317073;225430.853658537;2578.75609756098;87.5121951219512
62775;2023;1;1;0;100;0;120000;4000;30
62776;2023;2;2;0;100;0;210500;1856;113
62777;2023;4;4;0;100;0;103662.5;1505;69
62778;2023;1;1;0;100;0;231810;1783;130
62779;2023;2;2;0;100;0;92500;1430.5;66
62780;2023;2;2;0;100;0;69000;812;85
62781;2023;7;7;0;100;0;112728.571428571;1053;109.428571428571
62782;2023;3;3;0;100;0;183030;1676.66666666667;111.666666666667
62783;2023;8;8;0;100;0;134774.625;1427.75;95.25
62784;2023;3;3;0;100;0;146333.333333333;1066;138.333333333333
62785;2023;6;4;2;66.6666666666667;33.3333333333333;233577.5;2138.16666666667;107.833333333333
62786;2023;5;5;0;100;0;220600;2080;112.2
62787;2023;3;3;0;100;0;185823.333333333;1786.33333333333;106.666666666667
62788;2023;6;6;0;100;0;202728.333333333;1916.83333333333;102.666666666667
62789;2023;2;2;0;100;0;180850;2002.5;90
62791;2023;1;1;0;100;0;164000;1929;85
62792;2023;11;11;0;100;0;130809.090909091;1951.18181818182;64.3636363636364
62793;2023;3;3;0;100;0;281416.666666667;2277;123.333333333333
62794;2023;2;2;0;100;0;173318.5;1637;106
62796;2023;2;2;0;100;0;160187.5;1324.5;128
62797;2023;3;3;0;100;0;135000;1175;116.333333333333
62799;2023;11;11;0;100;0;351920.454545455;2886.90909090909;126.545454545455
62800;2023;4;4;0;100;0;122450;1146.25;101.5
62801;2023;28;28;0;100;0;232071.428571429;2100.57142857143;108.892857142857
62803;2023;1;1;0;100;0;220000;2529;87
62804;2023;5;5;0;100;0;202360;1623.6;132.4
62805;2023;1;1;0;100;0;166345;1957;85
62806;2023;4;4;0;100;0;657500;4468.5;176.5
62810;2023;15;13;2;86.6666666666667;13.3333333333333;259076.666666667;2224.53333333333;115.733333333333
62811;2023;9;9;0;100;0;154327.777777778;1658.88888888889;93.5555555555556
62812;2023;5;5;0;100;0;171220;1654.8;107.8
62813;2023;6;6;0;100;0;155833.333333333;1555.83333333333;108.166666666667
62814;2023;1;1;0;100;0;50000;510;98
62815;2023;5;5;0;100;0;145119;1703;85.2
62817;2023;11;8;3;72.7272727272727;27.2727272727273;231094.818181818;2564.27272727273;87.2727272727273
62818;2023;1;1;0;100;0;60000;1034;58
62819;2023;4;4;0;100;0;289925;1886;141
62820;2023;6;6;0;100;0;141816.666666667;1814.33333333333;79.1666666666667
62821;2023;1;1;0;100;0;95980;1371;70
62822;2023;3;3;0;100;0;351333.333333333;5494;63
62823;2023;2;2;0;100;0;182500;1594.5;114
62824;2023;1;1;0;100;0;385000;3598;107
62825;2023;6;6;0;100;0;142494.166666667;1735.5;88.5
62826;2023;335;111;224;33.134328358209;66.8656716417911;672827.017910448;8906.86268656716;73.555223880597
62827;2023;9;9;0;100;0;170900;1293.55555555556;142.555555555556
62829;2023;4;4;0;100;0;123877.5;1335.75;102
62830;2023;3;3;0;100;0;113996.666666667;1507.33333333333;77.6666666666667
62831;2023;1;1;0;100;0;135000;1274;106
62832;2023;9;9;0;100;0;280743.333333333;2505.33333333333;120.555555555556
62834;2023;2;2;0;100;0;160400;1505;109
62835;2023;2;2;0;100;0;136500;928.5;135.5
62836;2023;7;7;0;100;0;189371.428571429;1938.71428571429;97.8571428571429
62837;2023;4;4;0;100;0;194125;1767.25;109.5
62838;2023;4;4;0;100;0;156875;1400;128
62839;2023;7;7;0;100;0;134378.571428571;1556.85714285714;94.4285714285714
62841;2023;20;19;1;95;5;165402.6;1762.15;95.7
62842;2023;73;70;3;95.8904109589041;4.10958904109589;164569.123287671;1760.3698630137;95.958904109589
62843;2023;5;5;0;100;0;123920;1101.2;113.8
62844;2023;5;5;0;100;0;235358;2441.6;111.8
62845;2023;3;3;0;100;0;257300;2506;103.666666666667
62846;2023;36;36;0;100;0;172546.777777778;1710;102.888888888889
62847;2023;14;13;1;92.8571428571429;7.14285714285714;175128.571428571;1749.21428571429;94.5714285714286
62848;2023;41;36;5;87.8048780487805;12.1951219512195;137287.804878049;1611.39024390244;84.5365853658537
62849;2023;35;35;0;100;0;278580.428571429;2497.85714285714;117.828571428571
62850;2023;5;5;0;100;0;155360;968.2;151.8
62851;2023;6;6;0;100;0;261933.333333333;2751.66666666667;97.6666666666667
62852;2023;8;8;0;100;0;257875;2089.75;128.125
62853;2023;5;5;0;100;0;210600;2163;101.6
62854;2023;3;3;0;100;0;187033.333333333;1695.33333333333;116.666666666667
62855;2023;3;3;0;100;0;122333.333333333;1277;96
62856;2023;2;2;0;100;0;113650;1533.5;104.5
62858;2023;5;5;0;100;0;215044;2542.8;99.8
62860;2023;2;2;0;100;0;137000;1455.5;101
62861;2023;43;42;1;97.6744186046512;2.32558139534884;208771.209302326;2003.16279069767;107.441860465116
62862;2023;3;3;0;100;0;87666.6666666667;1127.33333333333;65.3333333333333
62863;2023;43;43;0;100;0;211808.720930233;2058.20930232558;103.674418604651
62864;2023;10;10;0;100;0;213867.5;1593.8;135.7
62865;2023;33;33;0;100;0;167767.575757576;1706;95.5151515151515
62866;2023;2;2;0;100;0;350075;3178;115.5
62867;2023;2;2;0;100;0;267050;3079;87.5
62868;2023;4;4;0;100;0;154077.75;1597.25;98.5
62869;2023;5;5;0;100;0;197467.8;1981.6;101.6
62870;2023;10;10;0;100;0;194675.5;2030;96
62871;2023;2;2;0;100;0;107755;1465;81
62872;2023;2;2;0;100;0;136000;921.5;136
62873;2023;7;7;0;100;0;279819.285714286;2393.71428571429;122.285714285714
62874;2023;6;6;0;100;0;194700;1761.66666666667;107
62875;2023;3;3;0;100;0;138850;1648.66666666667;86.6666666666667
62878;2023;4;4;0;100;0;133500;1391.75;99.25
62879;2023;1;1;0;100;0;85000;1214;70
62880;2023;2;2;0;100;0;209500;2472;82.5
62881;2023;4;4;0;100;0;126100;1203.75;96.5
62882;2023;11;11;0;100;0;111770.454545455;1387.27272727273;81.5454545454545
62883;2023;2;2;0;100;0;138962.5;1441;104
62885;2023;2;2;0;100;0;212450;1931.5;114.5
62886;2023;2;2;0;100;0;170750;1716.5;101
62887;2023;2;2;0;100;0;351000;2457.5;164
62888;2023;2;2;0;100;0;244500;2308.5;103
62889;2023;1;1;0;100;0;222000;1930;115
62890;2023;2;2;0;100;0;101000;988.5;106.5
62891;2023;2;2;0;100;0;91000;1006;94.5
62892;2023;7;7;0;100;0;235830.714285714;1787.42857142857;130.142857142857
62893;2023;117;56;61;47.8632478632479;52.1367521367521;310072.11965812;4713.88034188034;70.8888888888889
62894;2023;40;37;3;92.5;7.5;277384.25;2819.75;99.475
62895;2023;74;72;2;97.2972972972973;2.7027027027027;153636.364864865;1694.10810810811;93.7027027027027
62896;2023;8;8;0;100;0;235295;2295.875;120.25
62897;2023;6;6;0;100;0;145833.333333333;1659.5;94.1666666666667
62899;2023;29;15;14;51.7241379310345;48.2758620689655;375082.068965517;5242.31034482759;81.7241379310345
62900;2023;6;6;0;100;0;167016.666666667;1177.66666666667;151.333333333333
62901;2023;12;12;0;100;0;235424.166666667;1852.75;125
62902;2023;30;30;0;100;0;159155.666666667;1703.93333333333;93.2333333333333
62903;2023;3;3;0;100;0;210050;2558.33333333333;83
62904;2023;6;6;0;100;0;185841.666666667;1690.66666666667;109.5
62905;2023;3;3;0;100;0;406666.666666667;2339.66666666667;172
62906;2023;16;16;0;100;0;206988.0625;2457.3125;88.1875
62907;2023;50;49;1;98;2;151877.28;1790.82;88.78
62908;2023;11;11;0;100;0;293140.909090909;2752.27272727273;110.636363636364
62909;2023;4;3;1;75;25;172625;1787;97
63001;2023;18;17;1;94.4444444444444;5.55555555555556;135476.666666667;1361.05555555556;99.5
63003;2023;74;72;2;97.2972972972973;2.7027027027027;118689.459459459;1302.71621621622;93.7297297297297
63004;2023;15;15;0;100;0;120354.666666667;1393.53333333333;89.2
63005;2023;3;3;0;100;0;240366.666666667;1813.33333333333;132.333333333333
63006;2023;2;2;0;100;0;70290;1136;62.5
63007;2023;3;3;0;100;0;105150;1294;80
63008;2023;9;9;0;100;0;79251.1111111111;993;76.6666666666667
63009;2023;5;5;0;100;0;70554;713.2;97.4
63010;2023;11;10;1;90.9090909090909;9.09090909090909;84723.6363636364;1066.90909090909;87.8181818181818
63012;2023;9;9;0;100;0;229917.888888889;1828.22222222222;108.888888888889
63013;2023;8;8;0;100;0;183731.25;1704.5;110.5
63014;2023;98;66;32;67.3469387755102;32.6530612244898;194757.591836735;2512.4387755102;76.765306122449
63015;2023;1;1;0;100;0;159644;1057;151
63016;2023;13;13;0;100;0;108697.692307692;1220.92307692308;83.3846153846154
63019;2023;29;20;9;68.9655172413793;31.0344827586207;172679.793103448;2159.58620689655;79.5862068965517
63020;2023;2;2;0;100;0;201683.5;1526.5;126.5
63021;2023;3;3;0;100;0;101000;1154;113.333333333333
63022;2023;37;37;0;100;0;117062.675675676;1387.48648648649;86.0810810810811
63023;2023;3;3;0;100;0;108250;1074;93.3333333333333
63024;2023;1;1;0;100;0;100540;1622;62
63025;2023;3;3;0;100;0;158025;1490.66666666667;112
63026;2023;20;20;0;100;0;262431;2607.8;99.95
63027;2023;4;4;0;100;0;112351.25;1298.75;87.25
63028;2023;7;7;0;100;0;79357.1428571429;1103;72.4285714285714
63029;2023;5;5;0;100;0;120000;1327.8;81.4
63030;2023;1;1;0;100;0;124900;976;128
63031;2023;5;5;0;100;0;107690;1437;74.2
63032;2023;120;52;68;43.3333333333333;56.6666666666667;181013.916666667;2504.00833333333;71.525
63033;2023;1;1;0;100;0;146000;1217;120
63034;2023;8;7;1;87.5;12.5;185212.5;2254.125;80.625
63035;2023;3;3;0;100;0;266828.666666667;2751.33333333333;115
63037;2023;6;6;0;100;0;126166.666666667;1329.83333333333;108
63038;2023;92;15;77;16.304347826087;83.695652173913;131837.206521739;2892.15217391304;47.75
63039;2023;2;2;0;100;0;104150;910.5;97.5
63040;2023;45;42;3;93.3333333333333;6.66666666666667;179057.4;1858.04444444444;100.733333333333
63041;2023;8;7;1;87.5;12.5;153950;1011.625;140.375
63042;2023;20;20;0;100;0;209032.7;2811.8;84.15
63043;2023;5;5;0;100;0;88070;918.8;96.4
63044;2023;5;5;0;100;0;209066;2416.2;90
63045;2023;6;6;0;100;0;139092.833333333;1685.83333333333;79
63046;2023;1;1;0;100;0;110000;1222;90
63047;2023;89;19;70;21.3483146067416;78.6516853932584;97675.2584269663;1790.83146067416;59.9101123595506
63048;2023;5;5;0;100;0;74800;1369.6;68.2
63049;2023;5;5;0;100;0;145260;1645;89
63050;2023;47;45;2;95.7446808510638;4.25531914893617;133584.042553191;1449.02127659574;90
63051;2023;3;3;0;100;0;162600;2830;62.3333333333333
63052;2023;4;4;0;100;0;121750;1259.25;98.5
63053;2023;3;3;0;100;0;77333.3333333333;915.666666666667;92
63054;2023;8;8;0;100;0;170056.25;1759.125;98.625
63055;2023;6;6;0;100;0;131716.666666667;1448.16666666667;88.1666666666667
63056;2023;5;5;0;100;0;109580;1887.6;74
63057;2023;3;2;1;66.6666666666667;33.3333333333333;43000;1245.66666666667;36
63058;2023;3;3;0;100;0;268646.666666667;1888.33333333333;143.333333333333
63060;2023;1;1;0;100;0;50000;463;108
63061;2023;2;2;0;100;0;167150;1286;128
63062;2023;1;1;0;100;0;54000;900;60
63063;2023;72;57;15;79.1666666666667;20.8333333333333;216457.541666667;2793.41666666667;84.3194444444444
63064;2023;2;2;0;100;0;38750;484.5;80
63065;2023;4;4;0;100;0;132687.5;1196.5;100.5
63066;2023;11;11;0;100;0;95231.8181818182;1468;65.9090909090909
63067;2023;1;1;0;100;0;134100;1676;80
63069;2023;64;56;8;87.5;12.5;222761.8125;2408.53125;93.734375
63070;2023;60;53;7;88.3333333333333;11.6666666666667;329697.8;3000.58333333333;104.533333333333
63071;2023;3;3;0;100;0;289433.333333333;2743.66666666667;106.333333333333
63072;2023;15;15;0;100;0;106915.666666667;1128.53333333333;92.8666666666667
63073;2023;3;3;0;100;0;197966.666666667;1889;100.666666666667
63074;2023;1;1;0;100;0;208200;1407;148
63075;2023;348;43;305;12.3563218390805;87.6436781609195;201502.718390805;2651.56034482759;71.5977011494253
63076;2023;2;2;0;100;0;93250;1083.5;78
63077;2023;13;11;2;84.6153846153846;15.3846153846154;204813.846153846;2194.61538461538;86.2307692307692
63079;2023;3;2;1;66.6666666666667;33.3333333333333;56766.6666666667;677.333333333333;77.6666666666667
63080;2023;14;14;0;100;0;140686.428571429;1518.42857142857;93.5714285714286
63081;2023;3;3;0;100;0;117200;1487.33333333333;82.3333333333333
63082;2023;3;3;0;100;0;201133.333333333;1168.33333333333;156.666666666667
63083;2023;4;4;0;100;0;196737.5;2072.25;94.5
63084;2023;13;13;0;100;0;190630.769230769;2461.61538461538;70.6923076923077
63085;2023;11;11;0;100;0;108195.454545455;1434;81
63086;2023;5;5;0;100;0;159105;1460;112.6
63089;2023;13;13;0;100;0;276916;2504.84615384615;113.461538461538
63090;2023;2;2;0;100;0;213775;1876;112.5
63091;2023;7;7;0;100;0;153302.428571429;1729.85714285714;84.8571428571429
63092;2023;10;10;0;100;0;182152;1874.2;95.8
63093;2023;10;10;0;100;0;158022;2077.9;74.1
63094;2023;6;6;0;100;0;117275;1101.16666666667;100.833333333333
63095;2023;2;2;0;100;0;173500;1733;97.5
63096;2023;3;3;0;100;0;215783.333333333;1584.33333333333;134.333333333333
63097;2023;1;1;0;100;0;40000;606;66
63098;2023;7;4;3;57.1428571428571;42.8571428571429;154040.714285714;2258.71428571429;65.2857142857143
63099;2023;29;28;1;96.551724137931;3.44827586206897;210401.068965517;2073.8275862069;101.172413793103
63100;2023;3;3;0;100;0;128526.666666667;1043.33333333333;116.333333333333
63101;2023;2;2;0;100;0;65500;901.5;72
63102;2023;11;11;0;100;0;130917;1354.09090909091;93.6363636363636
63103;2023;117;59;58;50.4273504273504;49.5726495726496;152506.948717949;2393.82051282051;69.8034188034188
63105;2023;1;1;0;100;0;55000;786;70
63106;2023;12;12;0;100;0;205240.5;1953.33333333333;111.083333333333
63107;2023;4;4;0;100;0;261637.5;2167.25;120.75
63108;2023;6;6;0;100;0;178770.833333333;1942;82.1666666666667
63109;2023;5;5;0;100;0;181200;2141.4;82.2
63110;2023;3;3;0;100;0;121220;1508;89
63111;2023;4;4;0;100;0;109575;1241.5;91
63112;2023;7;7;0;100;0;260052.142857143;2373.57142857143;105.714285714286
63113;2023;1997;317;1680;15.8738107160741;84.1261892839259;148834.468703055;2342.63445167752;64.5162744116174
63114;2023;3;3;0;100;0;117823.333333333;1457.66666666667;69
63115;2023;1;1;0;100;0;120000;500;240
63116;2023;31;31;0;100;0;169623.870967742;1993.54838709677;91.8387096774194
63117;2023;3;3;0;100;0;87723.3333333333;838;101.666666666667
63118;2023;3;3;0;100;0;92000;856.333333333333;105.333333333333
63119;2023;4;4;0;100;0;62500;1000.75;64
63120;2023;12;10;2;83.3333333333333;16.6666666666667;203924.666666667;1939.5;106.5
63121;2023;13;13;0;100;0;175478.461538462;1898.15384615385;92.2307692307692
63122;2023;1;1;0;100;0;80000;1905;42
63123;2023;4;4;0;100;0;278787.5;2258.25;121
63124;2023;213;132;81;61.9718309859155;38.0281690140845;194768.056338028;2389.15023474178;83.9154929577465
63125;2023;43;40;3;93.0232558139535;6.97674418604651;133775.697674419;1349.18604651163;101.651162790698
63126;2023;16;16;0;100;0;263870.9375;2693.5625;98.5
63128;2023;9;8;1;88.8888888888889;11.1111111111111;104251.888888889;1058.55555555556;117.555555555556
63129;2023;5;5;0;100;0;68700;1266;57.8
63130;2023;1;1;0;100;0;162549;2322;70
63131;2023;14;14;0;100;0;182535.214285714;1692.64285714286;110.571428571429
63132;2023;19;19;0;100;0;99327.1052631579;1230.84210526316;88.1052631578947
63135;2023;7;7;0;100;0;200028.571428571;2117.71428571429;101.857142857143
63136;2023;4;4;0;100;0;111184.5;1269.75;83
63137;2023;5;5;0;100;0;57250;1029;54.8
63138;2023;3;3;0;100;0;143516.666666667;1686;90
63139;2023;6;6;0;100;0;74133.3333333333;928;72.6666666666667
63140;2023;2;2;0;100;0;91000;1093;88
63141;2023;16;16;0;100;0;318247.625;2709.625;110.875
63142;2023;7;7;0;100;0;89050;900.714285714286;102.285714285714
63143;2023;10;10;0;100;0;190137.1;2056.9;90.6
63144;2023;18;17;1;94.4444444444444;5.55555555555556;60898.2777777778;1040.44444444444;56.7222222222222
63145;2023;1;1;0;100;0;197580;1176;168
63146;2023;4;4;0;100;0;141912.5;1851;73.75
63147;2023;2;2;0;100;0;71000;870.5;93.5
63148;2023;18;18;0;100;0;252974.444444444;2339.11111111111;105.555555555556
63149;2023;3;2;1;66.6666666666667;33.3333333333333;225333.333333333;2232;106
63150;2023;9;7;2;77.7777777777778;22.2222222222222;255072.222222222;2681.88888888889;93.8888888888889
63151;2023;11;11;0;100;0;160327.272727273;1580.54545454545;93.0909090909091
63152;2023;2;2;0;100;0;91676;814;116
63153;2023;5;3;2;60;40;84764;1032.6;87.6
63154;2023;6;6;0;100;0;213737.833333333;1909.16666666667;112.166666666667
63155;2023;5;5;0;100;0;145812;1817.6;97.8
63157;2023;9;9;0;100;0;171126.444444444;1620.66666666667;104.666666666667
63158;2023;2;2;0;100;0;126500;1371.5;87
63160;2023;8;8;0;100;0;180963.125;1828.625;103.25
63161;2023;4;4;0;100;0;80325;1135.25;67.25
63162;2023;3;3;0;100;0;76843.6666666667;1437.33333333333;61.3333333333333
63163;2023;6;5;1;83.3333333333333;16.6666666666667;100916.666666667;1066.66666666667;93.3333333333333
63164;2023;105;67;38;63.8095238095238;36.1904761904762;181578.6;2197.66666666667;81.1142857142857
63165;2023;9;8;1;88.8888888888889;11.1111111111111;128150;1407.22222222222;89.4444444444444
63166;2023;2;2;0;100;0;103825;1433;73
63167;2023;6;6;0;100;0;238877.666666667;2385.33333333333;103.333333333333
63168;2023;4;4;0;100;0;117200;1296.25;88
63170;2023;3;3;0;100;0;195833.333333333;1337;153.666666666667
63171;2023;1;1;0;100;0;85000;1062;80
63172;2023;2;2;0;100;0;144825;2176;69
63173;2023;7;7;0;100;0;89169.2857142857;1091;83.1428571428571
63174;2023;3;3;0;100;0;83333.3333333333;972.333333333333;95
63175;2023;3;3;0;100;0;81303.3333333333;833;93.3333333333333
63176;2023;1;1;0;100;0;85000;2073;41
63177;2023;5;5;0;100;0;165724;2362.2;80.8
63178;2023;204;114;90;55.8823529411765;44.1176470588235;158600.926470588;2100.55882352941;78.1078431372549
63179;2023;14;14;0;100;0;155967.142857143;1350;108.857142857143
63180;2023;8;8;0;100;0;187069.375;1921.75;103.125
63181;2023;3;3;0;100;0;211080;2285.33333333333;92
63182;2023;8;7;1;87.5;12.5;75197.5;984.125;72.25
63183;2023;2;2;0;100;0;105000;1708.5;64
63184;2023;4;4;0;100;0;96125;1111.75;82.75
63185;2023;8;8;0;100;0;85018.625;1321.125;70.5
63187;2023;5;5;0;100;0;106009;1755.2;85.4
63188;2023;8;8;0;100;0;202874.625;2149.875;95.375
63189;2023;2;2;0;100;0;56000;939;53.5
63190;2023;6;6;0;100;0;63480.8333333333;1045.83333333333;63.8333333333333
63191;2023;2;2;0;100;0;126655;1792;71
63192;2023;14;14;0;100;0;121672.142857143;1559.42857142857;81.7857142857143
63193;2023;64;55;9;85.9375;14.0625;213363.40625;2361.375;89.203125
63194;2023;4;4;0;100;0;181625;1774;103.75
63195;2023;59;59;0;100;0;185632.440677966;1955.05084745763;94.9830508474576
63196;2023;7;7;0;100;0;171214.285714286;1670.28571428571;100
63197;2023;1;1;0;100;0;117360;1067;110
63198;2023;9;9;0;100;0;207047.666666667;2744.55555555556;82.2222222222222
63199;2023;7;7;0;100;0;181800;1812.57142857143;100.285714285714
63200;2023;8;8;0;100;0;216308.75;1928.875;110.125
63201;2023;15;15;0;100;0;168313.333333333;1508.4;110.933333333333
63203;2023;4;4;0;100;0;244050;2048.5;111
63204;2023;8;8;0;100;0;160400.125;1678.25;91.875
63205;2023;9;9;0;100;0;144753.333333333;1303.88888888889;121.444444444444
63206;2023;12;12;0;100;0;114172.5;1400.75;84.75
63207;2023;10;10;0;100;0;125825;1348.5;101.6
63208;2023;4;4;0;100;0;165530;1814.75;78.75
63209;2023;2;2;0;100;0;156235;1623;102
63210;2023;19;18;1;94.7368421052632;5.26315789473684;120818.947368421;1251.21052631579;106.263157894737
63211;2023;22;21;1;95.4545454545455;4.54545454545455;113523;1202.59090909091;95.7272727272727
63212;2023;18;18;0;100;0;275222.666666667;2485.05555555556;107.444444444444
63213;2023;17;17;0;100;0;239703.294117647;2857.35294117647;95.5882352941177
63214;2023;42;41;1;97.6190476190476;2.38095238095238;205544.404761905;2142.52380952381;97.9047619047619
63215;2023;6;6;0;100;0;279377.5;2403.16666666667;115
63216;2023;1;1;0;100;0;60000;1622;37
63218;2023;6;6;0;100;0;92623.3333333333;942.833333333333;96.8333333333333
63219;2023;6;6;0;100;0;167475;1813.33333333333;87.3333333333333
63220;2023;3;3;0;100;0;50766.6666666667;1073.33333333333;57.3333333333333
63221;2023;3;3;0;100;0;110229.333333333;1902.33333333333;61.3333333333333
63222;2023;3;3;0;100;0;82416.6666666667;819.333333333333;103.666666666667
63223;2023;5;4;1;80;20;78893;982.8;93.6
63224;2023;9;9;0;100;0;218661.111111111;2510.44444444444;86.5555555555556
63225;2023;18;17;1;94.4444444444444;5.55555555555556;96452.7777777778;849.666666666667;113.944444444444
63226;2023;38;38;0;100;0;235659.842105263;2263.47368421053;104.421052631579
63227;2023;22;22;0;100;0;245660.909090909;2474.27272727273;94.5
63228;2023;8;8;0;100;0;241473.625;1900.625;127.75
63229;2023;14;14;0;100;0;209233.071428571;2303.85714285714;104.071428571429
63230;2023;4;4;0;100;0;79795;1000.25;75.25
63231;2023;16;13;3;81.25;18.75;93935.625;953.875;95.3125
63232;2023;3;3;0;100;0;106713.333333333;1325.66666666667;88
63233;2023;9;9;0;100;0;97858.8888888889;1007.11111111111;95.6666666666667
63234;2023;3;3;0;100;0;127716.666666667;2144.66666666667;73
63235;2023;1;1;0;100;0;253700;2306;110
63236;2023;102;18;84;17.6470588235294;82.3529411764706;119682.62745098;2708.91176470588;45.1470588235294
63237;2023;12;11;1;91.6666666666667;8.33333333333333;77088.3333333333;994.416666666667;78.75
63238;2023;1;1;0;100;0;40000;667;60
63239;2023;7;7;0;100;0;233135.714285714;2473.28571428571;93.2857142857143
63240;2023;2;2;0;100;0;239700;2025;118
63241;2023;2;2;0;100;0;322275;2283.5;146.5
63242;2023;7;6;1;85.7142857142857;14.2857142857143;105258.571428571;1319.14285714286;78.7142857142857
63243;2023;5;5;0;100;0;101040;1125.6;91.8
63244;2023;17;17;0;100;0;213792.470588235;2153.05882352941;98.6470588235294
63245;2023;35;32;3;91.4285714285714;8.57142857142857;242272.085714286;2552.22857142857;94.4857142857143
63246;2023;14;9;5;64.2857142857143;35.7142857142857;134542.071428571;1634.64285714286;79.3571428571429
63247;2023;14;9;5;64.2857142857143;35.7142857142857;125754.5;2029.07142857143;61.9285714285714
63248;2023;4;4;0;100;0;174400.5;2085;84.5
63249;2023;5;5;0;100;0;197059.8;1952.8;100.8
63250;2023;9;9;0;100;0;161715.444444444;2572.22222222222;87.1111111111111
63251;2023;2;2;0;100;0;57000;736.5;80
63252;2023;2;2;0;100;0;305328.5;1962.5;152
63254;2023;20;20;0;100;0;213322.5;2665.05;82.4
63255;2023;5;5;0;100;0;133790;1427.6;98
63256;2023;4;4;0;100;0;96450;1045.75;94.5
63257;2023;9;9;0;100;0;204261.666666667;1901.88888888889;106.333333333333
63258;2023;9;9;0;100;0;80905.8888888889;875.888888888889;97.3333333333333
63259;2023;4;4;0;100;0;82300;1955;41
63260;2023;3;3;0;100;0;90706.6666666667;907.333333333333;98.3333333333333
63261;2023;10;10;0;100;0;162675;1985.9;84.1
63262;2023;30;30;0;100;0;274730.5;2675.4;102.533333333333
63263;2023;26;26;0;100;0;282069.923076923;2838.73076923077;103.692307692308
63264;2023;1;1;0;100;0;211380;10569;20
63265;2023;18;18;0;100;0;239856.666666667;2109.55555555556;112
63267;2023;4;4;0;100;0;75250;876.25;85.25
63269;2023;17;17;0;100;0;183735.294117647;2135.05882352941;91.5882352941177
63270;2023;3;3;0;100;0;221866.666666667;1916.66666666667;109.666666666667
63271;2023;12;12;0;100;0;125077.166666667;1378.08333333333;87.3333333333333
63272;2023;23;19;4;82.6086956521739;17.3913043478261;255917.391304348;2472.86956521739;103.739130434783
63273;2023;11;11;0;100;0;268392.727272727;2429.90909090909;113.272727272727
63274;2023;2;2;0;100;0;128000;2027.5;65
63275;2023;8;8;0;100;0;202825;2296.75;90
63276;2023;22;19;3;86.3636363636364;13.6363636363636;153231.590909091;1704.68181818182;93.1818181818182
63277;2023;2;2;0;100;0;62500;670.5;86.5
63278;2023;5;5;0;100;0;376530;2516.8;157.2
63279;2023;8;6;2;75;25;96643;2010;60
63280;2023;2;2;0;100;0;192500;2833;67.5
63281;2023;14;13;1;92.8571428571429;7.14285714285714;96089.2857142857;1038.71428571429;90.2142857142857
63282;2023;22;22;0;100;0;201802.136363636;2301.22727272727;94.8181818181818
63283;2023;10;8;2;80;20;64479.1;829;70.3
63284;2023;100;94;6;94;6;221076.3;2315.79;94.95
63285;2023;10;10;0;100;0;148370.2;1557.7;89.3
63286;2023;1;1;0;100;0;488500;1978;247
63287;2023;1;1;0;100;0;278200;2754;101
63288;2023;2;2;0;100;0;120000;2327.5;58.5
63289;2023;2;2;0;100;0;157500;1136;138.5
63290;2023;6;6;0;100;0;161499.5;2105.16666666667;77
63291;2023;35;34;1;97.1428571428571;2.85714285714286;126391.428571429;1463.54285714286;85.7142857142857
63292;2023;1;1;0;100;0;40000;533;75
63293;2023;7;7;0;100;0;81171.4285714286;1176.28571428571;69
63294;2023;7;7;0;100;0;104807.142857143;1381;87.2857142857143
63295;2023;22;22;0;100;0;139437.272727273;1467.77272727273;105.727272727273
63296;2023;9;9;0;100;0;236764.666666667;2195.11111111111;112.777777777778
63297;2023;2;2;0;100;0;185700;1866.5;92.5
63298;2023;4;4;0;100;0;104841.5;1812.5;78.5
63299;2023;1;1;0;100;0;163000;1358;120
63300;2023;205;105;100;51.219512195122;48.780487804878;178003.912195122;2221.74634146341;80.0536585365854
63301;2023;3;3;0;100;0;120500;1342;90
63302;2023;21;20;1;95.2380952380952;4.76190476190476;255469;2561.52380952381;100.285714285714
63303;2023;2;2;0;100;0;71160;962.5;62
63304;2023;3;3;0;100;0;92025;1006;88
63305;2023;3;3;0;100;0;149990;1903;84
63306;2023;5;5;0;100;0;177381.6;1702.4;107.6
63307;2023;71;55;16;77.4647887323944;22.5352112676056;235968.408450704;2461.40845070423;92.4507042253521
63308;2023;111;30;81;27.027027027027;72.972972972973;184615.945945946;2456.92792792793;69.945945945946
63309;2023;3;3;0;100;0;177533.333333333;1450.66666666667;118.333333333333
63310;2023;4;4;0;100;0;76175;776.25;95
63311;2023;5;5;0;100;0;230470;2020.8;111.2
63312;2023;5;5;0;100;0;121200;1279.8;96
63313;2023;2;2;0;100;0;60750;1080.5;59.5
63314;2023;9;9;0;100;0;102749.888888889;1051;106.222222222222
63315;2023;20;20;0;100;0;247182.8;2436.1;101.3
63317;2023;2;2;0;100;0;276725;2347.5;118.5
63318;2023;4;4;0;100;0;102750;1112.5;87
63319;2023;15;14;1;93.3333333333333;6.66666666666667;118884.666666667;1484.86666666667;81.7333333333333
63320;2023;6;6;0;100;0;96691.6666666667;1007.33333333333;100.5
63321;2023;7;7;0;100;0;97100;1081.71428571429;81.1428571428571
63322;2023;16;14;2;87.5;12.5;202285.4375;2094.5625;96.125
63323;2023;2;2;0;100;0;80685;801.5;117.5
63324;2023;6;6;0;100;0;84383.3333333333;976;75.8333333333333
63325;2023;1;1;0;100;0;293500;2795;105
63326;2023;3;3;0;100;0;254366.666666667;1665;154.333333333333
63327;2023;24;24;0;100;0;210427.083333333;2433.54166666667;88.7916666666667
63328;2023;1;1;0;100;0;72000;758;95
63329;2023;2;2;0;100;0;243325;1322;173.5
63330;2023;4;4;0;100;0;237625;2041.75;119.75
63331;2023;3;3;0;100;0;64333.3333333333;756.666666666667;87
63332;2023;8;8;0;100;0;208315.625;1920.25;113.5
63333;2023;4;4;0;100;0;243047.5;1936.75;121.25
63334;2023;9;9;0;100;0;111382.333333333;1085.22222222222;97.3333333333333
63335;2023;8;8;0;100;0;154685;1635;105.625
63336;2023;3;3;0;100;0;106000;2277.33333333333;53
63338;2023;28;28;0;100;0;93940.8928571429;1013.75;95.6785714285714
63340;2023;1;1;0;100;0;180000;1071;168
63341;2023;7;7;0;100;0;171941.428571429;1629.57142857143;108.571428571429
63342;2023;1;1;0;100;0;81000;1038;78
63343;2023;4;4;0;100;0;114450;1137;98.25
63344;2023;5;5;0;100;0;120788;1129;108
63345;2023;19;19;0;100;0;221450.789473684;2225.63157894737;104.368421052632
63346;2023;3;3;0;100;0;162033.666666667;3026.33333333333;63.3333333333333
63347;2023;2;2;0;100;0;193630;2146;95
63348;2023;5;5;0;100;0;104355.8;1142.8;97
63349;2023;19;19;0;100;0;119882.631578947;1202.84210526316;104.578947368421
63350;2023;13;13;0;100;0;218441.538461538;2247.15384615385;96.3076923076923
63352;2023;18;18;0;100;0;152323.333333333;1506.22222222222;99.8333333333333
63353;2023;9;8;1;88.8888888888889;11.1111111111111;90684.4444444444;1135.88888888889;88.3333333333333
63354;2023;17;17;0;100;0;77682.3529411765;980.235294117647;87.0588235294118
63355;2023;5;4;1;80;20;87540;1066.6;79.2
63356;2023;3;3;0;100;0;135266.666666667;1553.33333333333;88
63357;2023;1;1;0;100;0;133200;1025;130
63358;2023;7;7;0;100;0;116385.714285714;1256.57142857143;99
63359;2023;1;1;0;100;0;107000;982;109
63360;2023;4;4;0;100;0;68750;1257.25;75.5
63362;2023;5;5;0;100;0;143190;1247;108
63363;2023;2;2;0;100;0;166050;1641.5;97
63364;2023;6;6;0;100;0;112351.5;1293.66666666667;87
63365;2023;3;3;0;100;0;66833.3333333333;1167.66666666667;54.6666666666667
63366;2023;4;4;0;100;0;208425;1991.75;105.5
63367;2023;1;1;0;100;0;63000;1286;49
63368;2023;11;11;0;100;0;207822.272727273;2012.90909090909;115
63369;2023;1;1;0;100;0;42000;1556;27
63370;2023;2;2;0;100;0;28000;583;48
63371;2023;6;6;0;100;0;74466.6666666667;1120;72.1666666666667
63372;2023;5;5;0;100;0;241101.4;2289.6;114.2
63373;2023;3;3;0;100;0;95666.6666666667;989.666666666667;101.333333333333
63374;2023;3;3;0;100;0;88200;1123.33333333333;85.3333333333333
63375;2023;3;3;0;100;0;155986.666666667;1522.66666666667;110.333333333333
63376;2023;3;3;0;100;0;58083.3333333333;806.333333333333;80.6666666666667
63377;2023;4;4;0;100;0;113262.5;1067.25;96.25
63378;2023;11;11;0;100;0;240535.454545455;2198.81818181818;106.818181818182
63379;2023;3;3;0;100;0;189800;2376;78
63380;2023;13;6;7;46.1538461538462;53.8461538461538;102497.769230769;1587.69230769231;64.2307692307692
63381;2023;14;11;3;78.5714285714286;21.4285714285714;167332.142857143;1809.07142857143;95.6428571428571
63382;2023;4;4;0;100;0;133475;1217.75;104.25
63383;2023;1;1;0;100;0;215000;2792;77
63384;2023;6;6;0;100;0;70120;832.666666666667;93.6666666666667
63385;2023;3;3;0;100;0;81950;1568.66666666667;51.3333333333333
63386;2023;3;3;0;100;0;160743.333333333;1293;130.333333333333
63387;2023;5;5;0;100;0;119920;1195;88
63388;2023;9;9;0;100;0;83921.1111111111;853.222222222222;95.3333333333333
63389;2023;3;3;0;100;0;130163.333333333;1441;78.3333333333333
63390;2023;5;5;0;100;0;106508;1419.4;69.6
63391;2023;4;4;0;100;0;107935;1322.25;84.25
63392;2023;1;1;0;100;0;197430;1795;110
63393;2023;25;24;1;96;4;109279.36;1135.96;97.56
63394;2023;2;2;0;100;0;102075;1275.5;78.5
63395;2023;10;10;0;100;0;175835;2651.7;69.7
63396;2023;10;9;1;90;10;428182;2963;107.9
63397;2023;5;5;0;100;0;96009;1547.6;63.4
63398;2023;3;3;0;100;0;133800;1489.66666666667;85
63399;2023;1;1;0;100;0;40000;1333;30
63400;2023;15;15;0;100;0;151281.133333333;1602.46666666667;95.6
63401;2023;5;5;0;100;0;106500;1514.4;83.8
63402;2023;1;1;0;100;0;55750;1014;55
63403;2023;5;5;0;100;0;192823;1869.2;113.2
63404;2023;9;9;0;100;0;202434.777777778;1956.88888888889;115.444444444444
63405;2023;6;6;0;100;0;139733.333333333;2197;60.1666666666667
63406;2023;1;1;0;100;0;244500;2601;94
63407;2023;2;2;0;100;0;131255;2230.5;58
63408;2023;2;2;0;100;0;42500;875;48
63409;2023;4;4;0;100;0;81500;1080.75;67.25
63410;2023;1;1;0;100;0;250000;919;272
63411;2023;8;8;0;100;0;168711.875;1848.375;90.75
63412;2023;5;5;0;100;0;105740;1418.8;76
63413;2023;6;6;0;100;0;119866.666666667;1571.16666666667;75.6666666666667
63414;2023;6;6;0;100;0;190255;1984.83333333333;117.333333333333
63415;2023;19;19;0;100;0;98131.5789473684;1170.52631578947;80.6315789473684
63416;2023;2;2;0;100;0;69000;925.5;78
63417;2023;20;19;1;95;5;263141.6;2650.8;99.1
63418;2023;5;5;0;100;0;113280;1233.4;84.8
63419;2023;9;9;0;100;0;80455.5555555556;946.444444444444;81.4444444444444
63420;2023;7;7;0;100;0;189137.142857143;2436.14285714286;75.5714285714286
63421;2023;2;2;0;100;0;77550;1069.5;59
63422;2023;8;8;0;100;0;148050;1782.375;80.125
63423;2023;9;9;0;100;0;88972.2222222222;1443.88888888889;73.3333333333333
63424;2023;4;4;0;100;0;164258.75;1843.25;86.25
63425;2023;6;6;0;100;0;334841.666666667;2888;113.5
63426;2023;3;3;0;100;0;136445;1639;81.3333333333333
63427;2023;4;4;0;100;0;167508.75;1650;96.25
63428;2023;4;4;0;100;0;77485;1047;68.25
63429;2023;4;4;0;100;0;113750;1577;72.5
63430;2023;98;74;24;75.5102040816327;24.4897959183673;105331.193877551;1208.23469387755;87.5918367346939
63431;2023;1;1;0;100;0;235330;1121;210
63432;2023;3;3;0;100;0;186766.666666667;2104.66666666667;101
63433;2023;3;3;0;100;0;77000;929.666666666667;90.6666666666667
63434;2023;2;2;0;100;0;226700;1117.5;195
63435;2023;3;3;0;100;0;130716.666666667;1240.33333333333;102.333333333333
63437;2023;1;1;0;100;0;92500;617;150
63438;2023;6;6;0;100;0;133691.666666667;1804.66666666667;82.5
63439;2023;3;3;0;100;0;206483.333333333;2173.66666666667;103
63440;2023;2;2;0;100;0;70750;1289.5;74
63441;2023;10;10;0;100;0;112870;1309.3;92.4
63443;2023;4;4;0;100;0;281239;2576.5;107.5
63444;2023;2;2;0;100;0;267390;2588;103
63445;2023;4;4;0;100;0;238187.5;2042;116.25
63446;2023;8;8;0;100;0;180445.25;1560;128.875
63447;2023;1;1;0;100;0;90000;652;138
63448;2023;14;13;1;92.8571428571429;7.14285714285714;118858.5;1304.85714285714;97.7142857142857
63449;2023;5;4;1;80;20;79642;1367;54.8
63450;2023;2;2;0;100;0;60000;1115.5;51.5
63451;2023;3;3;0;100;0;185556.666666667;1852.33333333333;94.6666666666667
63453;2023;32;31;1;96.875;3.125;211491.875;2125.71875;104.21875
63454;2023;6;6;0;100;0;129366.666666667;1219.33333333333;106
63455;2023;37;37;0;100;0;243806.459459459;2492.32432432432;97.2162162162162
63456;2023;2;2;0;100;0;139550;1365.5;85
63457;2023;53;49;4;92.4528301886792;7.54716981132075;215240.773584906;2165.28301886792;97.3962264150943
63458;2023;3;3;0;100;0;128266.666666667;1523.33333333333;80.3333333333333
63459;2023;7;7;0;100;0;169192.857142857;1515;110.714285714286
63460;2023;1;1;0;100;0;140100;2030;69
63461;2023;5;5;0;100;0;174300;1669.2;106.8
63462;2023;3;3;0;100;0;99000;959;100.666666666667
63463;2023;3;3;0;100;0;81796.6666666667;968;84.6666666666667
63464;2023;1;1;0;100;0;215000;1991;108
63465;2023;5;5;0;100;0;97090;1071.2;84.2
63466;2023;3;3;0;100;0;98791.6666666667;1191.66666666667;84
63467;2023;1;1;0;100;0;74000;925;80
63468;2023;2;2;0;100;0;89900;1239;73
63469;2023;5;5;0;100;0;104780;1202.4;87.6
63470;2023;46;45;1;97.8260869565217;2.17391304347826;190587.47826087;2038.58695652174;93.0652173913043
63471;2023;8;8;0;100;0;78800;981.125;82.875
63472;2023;8;8;0;100;0;167878.75;1909.5;93.625
63473;2023;4;4;0;100;0;176250;1566.75;115.5
64001;2023;2;2;0;100;0;208750;1818.5;112
64003;2023;7;7;0;100;0;206652.857142857;1887;112.857142857143
64004;2023;3;3;0;100;0;165000;1810;95.6666666666667
64005;2023;3;3;0;100;0;204550;1773.66666666667;119
64006;2023;7;6;1;85.7142857142857;14.2857142857143;164785.714285714;1750.85714285714;90.8571428571429
64007;2023;4;4;0;100;0;137750;1525.75;93
64009;2023;10;4;6;40;60;722442.3;5596.1;124.6
64010;2023;3;3;0;100;0;225000;2164.66666666667;121
64014;2023;5;5;0;100;0;399512;3134.6;134.2
64015;2023;2;2;0;100;0;63000;735.5;81.5
64016;2023;2;2;0;100;0;123605;866.5;130
64017;2023;5;4;1;80;20;116980.6;1199.2;115
64018;2023;1;1;0;100;0;430000;1623;265
64019;2023;1;1;0;100;0;351000;2700;130
64021;2023;7;7;0;100;0;286577.714285714;2437.85714285714;124.428571428571
64022;2023;5;5;0;100;0;328732.2;1528.6;201.2
64023;2023;10;10;0;100;0;239225;2099.7;113.1
64024;2023;646;180;466;27.8637770897833;72.1362229102167;476768.640866873;6124.88699690403;73.5526315789474
64026;2023;1;1;0;100;0;310000;2650;117
64027;2023;1;1;0;100;0;245400;1845;133
64028;2023;3;3;0;100;0;267200;2065;141.666666666667
64029;2023;3;3;0;100;0;125000;1080;123.333333333333
64031;2023;1;1;0;100;0;190000;2184;87
64032;2023;1;1;0;100;0;140000;1239;113
64034;2023;1;1;0;100;0;344250;2513;137
64035;2023;22;15;7;68.1818181818182;31.8181818181818;827448.409090909;6625.09090909091;134.227272727273
64036;2023;2;2;0;100;0;105000;951;148
64037;2023;1;1;0;100;0;299610;2203;136
64038;2023;34;18;16;52.9411764705882;47.0588235294118;591913.529411765;5691.23529411765;104.264705882353
64039;2023;3;3;0;100;0;224216.666666667;2062.66666666667;105.666666666667
64040;2023;44;15;29;34.0909090909091;65.9090909090909;99704.7727272727;2008.34090909091;53.8863636363636
64041;2023;5;4;1;80;20;310944;2988.4;101.6
64042;2023;11;11;0;100;0;203867.272727273;2097.36363636364;99.8181818181818
64043;2023;3;3;0;100;0;217866.666666667;1747.66666666667;114.333333333333
64044;2023;3;3;0;100;0;271751;1356;180
64046;2023;1;1;0;100;0;255000;1796;142
64047;2023;4;3;1;75;25;115955;1875.5;64.25
64049;2023;3;3;0;100;0;411666.666666667;2264.66666666667;191.666666666667
64050;2023;1;1;0;100;0;280000;1818;154
64051;2023;1;1;0;100;0;310000;3875;80
64052;2023;1;1;0;100;0;193705;1845;105
64053;2023;2;2;0;100;0;194725;1882;103.5
64054;2023;4;4;0;100;0;198775;1725.25;127
64056;2023;4;4;0;100;0;157500;1689.75;90.5
64057;2023;33;32;1;96.969696969697;3.03030303030303;215501.515151515;1807.45454545455;117.848484848485
64058;2023;5;5;0;100;0;197840;1960;100.2
64059;2023;7;7;0;100;0;305872.428571429;1962.14285714286;163.571428571429
64060;2023;21;17;4;80.9523809523809;19.047619047619;276184.095238095;2577.47619047619;110.809523809524
64061;2023;30;18;12;60;40;168569.666666667;2067.66666666667;82.9333333333333
64062;2023;29;26;3;89.6551724137931;10.3448275862069;175828.551724138;1768.44827586207;100.862068965517
64063;2023;9;9;0;100;0;150256.666666667;1626;98.4444444444444
64064;2023;2;2;0;100;0;129500;1076;123.5
64065;2023;36;24;12;66.6666666666667;33.3333333333333;593595.027777778;5295.22222222222;109.694444444444
64067;2023;11;10;1;90.9090909090909;9.09090909090909;315065;2589.90909090909;125.363636363636
64068;2023;14;14;0;100;0;196369.285714286;1853.57142857143;113.357142857143
64069;2023;5;5;0;100;0;156810;2012.6;77.4
64070;2023;4;4;0;100;0;244609.75;2498.75;98
64071;2023;4;4;0;100;0;175961.5;1549.25;107.5
64072;2023;3;3;0;100;0;209225;1957.33333333333;121.333333333333
64073;2023;1;1;0;100;0;535900;2224;241
64074;2023;2;2;0;100;0;118642.5;1543.5;75.5
64075;2023;2;2;0;100;0;139000;1172.5;119.5
64077;2023;4;4;0;100;0;195750;2086.25;94.5
64078;2023;1;1;0;100;0;357850;2957;121
64080;2023;6;6;0;100;0;330660.333333333;2813;119.5
64081;2023;2;2;0;100;0;90500;712;132
64082;2023;1;1;0;100;0;179075;1756;102
64083;2023;1;1;0;100;0;210000;1533;137
64084;2023;1;1;0;100;0;163290;1814;90
64085;2023;3;3;0;100;0;117250;2230.33333333333;54.6666666666667
64086;2023;9;8;1;88.8888888888889;11.1111111111111;295405.555555556;2860.66666666667;109.222222222222
64087;2023;7;6;1;85.7142857142857;14.2857142857143;259871.428571429;2250.71428571429;118.285714285714
64088;2023;3;3;0;100;0;394933.333333333;2721;156
64090;2023;2;2;0;100;0;206177.5;1699;121
64091;2023;6;6;0;100;0;226391.666666667;1891;125.333333333333
64092;2023;1;1;0;100;0;50000;526;95
64093;2023;7;7;0;100;0;159714.142857143;1408.28571428571;121
64094;2023;9;7;2;77.7777777777778;22.2222222222222;418815.777777778;3895.33333333333;110.444444444444
64095;2023;3;3;0;100;0;263166.666666667;2136;125.333333333333
64096;2023;4;4;0;100;0;110675;1056.75;106
64097;2023;6;6;0;100;0;161083.333333333;1614.5;106.166666666667
64098;2023;1;1;0;100;0;80000;1569;51
64099;2023;1;1;0;100;0;183000;1076;170
64100;2023;35;20;15;57.1428571428571;42.8571428571429;569588.771428571;5652.42857142857;95.2285714285714
64101;2023;5;5;0;100;0;263164;2119.2;128
64102;2023;782;69;713;8.82352941176471;91.1764705882353;274764.02173913;4325.03452685422;63.8222506393862
64103;2023;2;2;0;100;0;229852.5;2183.5;107.5
64104;2023;8;6;2;75;25;129225;1431.75;93.875
64105;2023;1;1;0;100;0;294150;3677;80
64106;2023;2;2;0;100;0;290500;2146;135
64108;2023;13;13;0;100;0;183005.307692308;2160.76923076923;84.3846153846154
64109;2023;13;13;0;100;0;280611.538461538;2064.69230769231;133.769230769231
64110;2023;2;2;0;100;0;119000;1705.5;75
64111;2023;1;1;0;100;0;160250;1381;116
64112;2023;5;5;0;100;0;300740;2319.8;138.6
64114;2023;2;2;0;100;0;335000;2909.5;117.5
64115;2023;1;1;0;100;0;40000;400;100
64116;2023;2;2;0;100;0;260450;2971.5;95.5
64119;2023;6;6;0;100;0;326256;2907.5;116.5
64120;2023;3;3;0;100;0;248000;2756;96.3333333333333
64122;2023;616;109;507;17.6948051948052;82.3051948051948;577737.095779221;8253.4237012987;68.775974025974
64123;2023;8;6;2;75;25;328615;3027.75;135
64124;2023;2;2;0;100;0;313500;2777.5;115
64125;2023;108;38;70;35.1851851851852;64.8148148148148;496576.981481481;6740.35185185185;75.3888888888889
64126;2023;20;16;4;80;20;195610;1609;117.85
64127;2023;2;2;0;100;0;660900;7244;74.5
64128;2023;2;2;0;100;0;130000;1104;106.5
64129;2023;277;69;208;24.9097472924188;75.0902527075812;156758.790613718;2242.74368231047;70.043321299639
64130;2023;12;7;5;58.3333333333333;41.6666666666667;361462.5;3673.25;105.083333333333
64131;2023;7;7;0;100;0;238228.571428571;2311;105.285714285714
64132;2023;61;34;27;55.7377049180328;44.2622950819672;246455.68852459;2491.45901639344;95.9508196721311
64133;2023;7;5;2;71.4285714285714;28.5714285714286;214464.714285714;2262.28571428571;98.8571428571429
64134;2023;2;0;2;0;100;234250;4775;77
64135;2023;5;5;0;100;0;216051.6;1490.2;144.2
64136;2023;3;3;0;100;0;165833.333333333;1622.66666666667;104
64137;2023;7;7;0;100;0;225447.142857143;2232;105
64138;2023;24;24;0;100;0;265809.958333333;2488.625;110.875
64139;2023;7;7;0;100;0;243371.428571429;2129.14285714286;118.857142857143
64140;2023;91;49;42;53.8461538461538;46.1538461538462;341049.945054945;4317.62637362637;81.2197802197802
64141;2023;6;6;0;100;0;137666.666666667;1447.16666666667;100.5
64142;2023;8;8;0;100;0;264047.5;2012.125;129.375
64143;2023;1;1;0;100;0;229010;1908;120
64144;2023;2;2;0;100;0;244100;910;226.5
64145;2023;7;6;1;85.7142857142857;14.2857142857143;253244.285714286;2242.42857142857;112.857142857143
64146;2023;1;1;0;100;0;225000;1758;128
64147;2023;17;8;9;47.0588235294118;52.9411764705882;340994.705882353;3483;95.9411764705882
64148;2023;7;7;0;100;0;199263.714285714;1900.71428571429;107.571428571429
64149;2023;3;3;0;100;0;237016.666666667;2266.33333333333;102
64150;2023;1;1;0;100;0;180000;1091;165
64151;2023;2;2;0;100;0;110000;1283;97.5
64152;2023;14;14;0;100;0;347862;2805.07142857143;126.785714285714
64153;2023;1;1;0;100;0;225600;832;271
64156;2023;6;5;1;83.3333333333333;16.6666666666667;115508.333333333;1429;78.8333333333333
64157;2023;7;7;0;100;0;211804.285714286;2277.42857142857;94.2857142857143
64158;2023;2;2;0;100;0;288300;1393.5;178
64160;2023;89;33;56;37.0786516853933;62.9213483146067;302115.202247191;4084.79775280899;79.6966292134831
64161;2023;9;9;0;100;0;340954.222222222;2501.33333333333;138.111111111111
64165;2023;3;3;0;100;0;214958.666666667;1812.33333333333;112
64166;2023;1;1;0;100;0;205000;2929;70
64167;2023;1;1;0;100;0;217000;1528;142
64168;2023;9;9;0;100;0;144683.333333333;1294.33333333333;123.666666666667
64170;2023;3;3;0;100;0;255978.333333333;1840.33333333333;156
64172;2023;1;1;0;100;0;190000;1429;133
64175;2023;4;4;0;100;0;133375;1817.75;65.75
64176;2023;2;2;0;100;0;167500;1276;145.5
64177;2023;5;5;0;100;0;172800.4;1693.6;100
64178;2023;8;8;0;100;0;235013.75;1717.75;145.5
64179;2023;2;2;0;100;0;464615;3202.5;149.5
64180;2023;5;5;0;100;0;289104;1662.4;174.8
64181;2023;1;1;0;100;0;232000;1406;165
64183;2023;1;1;0;100;0;171000;2375;72
64184;2023;2;2;0;100;0;207430;1630;124
64185;2023;2;2;0;100;0;126500;1902.5;81
64186;2023;2;2;0;100;0;273750;2491.5;110
64187;2023;1;1;0;100;0;250000;1302;192
64188;2023;7;7;0;100;0;226214.285714286;1425.71428571429;158.142857142857
64189;2023;131;24;107;18.3206106870229;81.6793893129771;441425.687022901;6397.09160305344;67.2977099236641
64191;2023;20;15;5;75;25;186982.55;2003.2;97.15
64193;2023;3;3;0;100;0;155933.333333333;2866.33333333333;72
64194;2023;2;2;0;100;0;250185;2580;96.5
64196;2023;1;1;0;100;0;135000;1849;73
64197;2023;1;1;0;100;0;433500;1970;220
64198;2023;17;17;0;100;0;256532.117647059;2457.41176470588;105.352941176471
64200;2023;3;3;0;100;0;203707.666666667;1700.66666666667;123.333333333333
64201;2023;1;1;0;100;0;130000;929;140
64202;2023;3;3;0;100;0;260246.666666667;2069.66666666667;120.666666666667
64203;2023;5;5;0;100;0;246020;2159.8;121.8
64204;2023;78;3;75;3.84615384615385;96.1538461538462;65467.1025641026;1845.26923076923;38.9358974358974
64205;2023;8;2;6;25;75;127725;2012.75;64.75
64206;2023;2;2;0;100;0;140750;2030.5;71
64207;2023;3;3;0;100;0;223133.333333333;1642.66666666667;132
64208;2023;2;2;0;100;0;193500;1398.5;138.5
64209;2023;6;6;0;100;0;219116.666666667;1938.5;111.5
64210;2023;2;2;0;100;0;256250;1195;210.5
64211;2023;6;6;0;100;0;230555;2522.16666666667;97.8333333333333
64213;2023;15;13;2;86.6666666666667;13.3333333333333;489047.133333333;3910.46666666667;132.266666666667
64214;2023;4;4;0;100;0;158750;1602.25;98.5
64215;2023;1;1;0;100;0;130000;1287;101
64216;2023;11;10;1;90.9090909090909;9.09090909090909;317344.545454545;2388.90909090909;132.272727272727
64217;2023;3;3;0;100;0;268800;2101;140.666666666667
64218;2023;1;1;0;100;0;232000;1228;189
64219;2023;2;2;0;100;0;64500;834;74.5
64220;2023;2;2;0;100;0;225500;2029.5;110.5
64222;2023;1;1;0;100;0;150275;970;155
64224;2023;14;14;0;100;0;229337.857142857;2246.71428571429;106.928571428571
64225;2023;7;5;2;71.4285714285714;28.5714285714286;166695.714285714;1743;93
64226;2023;1;1;0;100;0;231000;1777;130
64227;2023;3;3;0;100;0;213000;1847;117
64229;2023;1;0;1;0;100;220000;2245;98
64230;2023;49;46;3;93.8775510204082;6.12244897959184;283003;2455.48979591837;119.591836734694
64231;2023;7;6;1;85.7142857142857;14.2857142857143;156542.857142857;1641.14285714286;100
64232;2023;2;2;0;100;0;177000;1591.5;128.5
64233;2023;16;16;0;100;0;173336.8125;1510.375;119.8125
64234;2023;3;3;0;100;0;175350;1442.66666666667;120
64235;2023;3;2;1;66.6666666666667;33.3333333333333;233500;1960;121.333333333333
64236;2023;2;2;0;100;0;138880;1329.5;131
64237;2023;39;29;10;74.3589743589744;25.6410256410256;257536.282051282;2522.82051282051;99.7692307692308
64238;2023;18;17;1;94.4444444444444;5.55555555555556;262515.666666667;2312.33333333333;117.833333333333
64240;2023;4;4;0;100;0;131820;2224;58.25
64241;2023;5;5;0;100;0;257014;2105.8;132
64242;2023;1;1;0;100;0;300700;2118;142
64243;2023;2;2;0;100;0;224750;3070;75
64244;2023;1;1;0;100;0;250100;1924;130
64245;2023;7;7;0;100;0;180728.571428571;1697.28571428571;114.428571428571
64246;2023;1;1;0;100;0;120000;764;157
64247;2023;6;5;1;83.3333333333333;16.6666666666667;170000;1583.5;107
64249;2023;15;5;10;33.3333333333333;66.6666666666667;917909;9439.86666666667;92.5333333333333
64250;2023;6;5;1;83.3333333333333;16.6666666666667;282250;3091.16666666667;94
64251;2023;3;2;1;66.6666666666667;33.3333333333333;199146.666666667;2480;97.3333333333333
64252;2023;8;8;0;100;0;258375;2213.5;114.625
64253;2023;4;4;0;100;0;299175;1927.75;174.5
64254;2023;5;5;0;100;0;191720;2035;95.2
64255;2023;4;3;1;75;25;498033.5;4496.25;117.75
64256;2023;53;27;26;50.9433962264151;49.0566037735849;305649.018867925;3607.39622641509;84.9811320754717
64257;2023;2;2;0;100;0;346350;2043;182.5
64258;2023;2;2;0;100;0;200200;1293.5;168
64259;2023;4;4;0;100;0;323383.25;3158;108
64260;2023;336;44;292;13.0952380952381;86.9047619047619;277068.782738095;5033.56547619048;56.6994047619048
64261;2023;4;4;0;100;0;176085;1827;97.5
64262;2023;1;1;0;100;0;410000;2908;141
64263;2023;1;1;0;100;0;378250;3568;106
64265;2023;1;1;0;100;0;248000;2067;120
64267;2023;1;1;0;100;0;255000;3446;74
64268;2023;1;1;0;100;0;65000;867;75
64269;2023;46;31;15;67.3913043478261;32.6086956521739;323569.630434783;2709.08695652174;121.326086956522
64270;2023;11;11;0;100;0;187370.909090909;2304;89.6363636363636
64271;2023;2;2;0;100;0;333050;3043;112.5
64272;2023;1;1;0;100;0;3,00E+05;1250;240
64273;2023;2;2;0;100;0;308117;2527;123
64274;2023;1;1;0;100;0;440000;3385;130
64275;2023;6;4;2;66.6666666666667;33.3333333333333;209438;2449.5;86.5
64276;2023;4;4;0;100;0;141987.5;1924.75;91.5
64277;2023;1;1;0;100;0;563000;2872;196
64279;2023;22;13;9;59.0909090909091;40.9090909090909;350194.545454545;3841.77272727273;98.0454545454545
64280;2023;4;4;0;100;0;151737.5;1894.25;80.75
64281;2023;2;2;0;100;0;158175;1294.5;110
64282;2023;9;8;1;88.8888888888889;11.1111111111111;456654.444444444;4134.22222222222;122.666666666667
64284;2023;85;34;51;40;60;193658.541176471;2297.45882352941;84.6941176470588
64285;2023;1;1;0;100;0;355000;2383;149
64286;2023;5;2;3;40;60;196600;1903.8;107
64287;2023;1;1;0;100;0;229000;1722;133
64288;2023;8;8;0;100;0;231562.75;2136.5;116
64289;2023;7;6;1;85.7142857142857;14.2857142857143;396532.857142857;4502.42857142857;84.8571428571429
64290;2023;6;6;0;100;0;271360;2073.5;144.166666666667
64291;2023;3;3;0;100;0;146433.333333333;1029.66666666667;141.333333333333
64292;2023;2;2;0;100;0;184125;1405.5;146
64293;2023;2;2;0;100;0;126815;914.5;157
64294;2023;2;2;0;100;0;237750;1358;175
64296;2023;1;1;0;100;0;2,00E+05;2273;88
64298;2023;2;2;0;100;0;54000;940;60.5
64299;2023;1;1;0;100;0;179000;2011;89
64300;2023;4;4;0;100;0;150930.75;1558;93.5
64301;2023;15;15;0;100;0;195888.133333333;1498.93333333333;136.866666666667
64302;2023;3;2;1;66.6666666666667;33.3333333333333;179833.333333333;1300.66666666667;136.666666666667
64304;2023;34;27;7;79.4117647058823;20.5882352941176;438739.588235294;3865.38235294118;115.176470588235
64305;2023;9;9;0;100;0;182370.888888889;1594.22222222222;115.555555555556
64306;2023;9;9;0;100;0;193701.333333333;1593.44444444444;134.111111111111
64307;2023;2;2;0;100;0;157500;1315;118.5
64308;2023;2;2;0;100;0;232500;2210;107.5
64310;2023;3;3;0;100;0;89380;1442;65
64311;2023;1;1;0;100;0;206000;862;239
64313;2023;3;3;0;100;0;216166.666666667;2800;119.666666666667
64314;2023;3;3;0;100;0;216916.666666667;1822;128.333333333333
64315;2023;11;11;0;100;0;308216.090909091;2482.90909090909;127.363636363636
64316;2023;2;2;0;100;0;45500;767;59.5
64317;2023;21;10;11;47.6190476190476;52.3809523809524;321715.19047619;3618.33333333333;91.0476190476191
64318;2023;3;2;1;66.6666666666667;33.3333333333333;175666.666666667;1792;97.6666666666667
64320;2023;27;8;19;29.6296296296296;70.3703703703704;77137.037037037;1918.59259259259;48.4074074074074
64321;2023;1;1;0;100;0;224293;2243;100
64322;2023;1;1;0;100;0;393000;2325;169
64323;2023;3;3;0;100;0;125000;912.333333333333;127.333333333333
64324;2023;10;10;0;100;0;206650;1605.2;135.2
64325;2023;1;1;0;100;0;195000;2532;77
64326;2023;1;1;0;100;0;180000;1286;140
64328;2023;10;10;0;100;0;199225;1807.5;109.9
64329;2023;18;18;0;100;0;394106.388888889;2691;139.333333333333
64330;2023;3;2;1;66.6666666666667;33.3333333333333;133333.333333333;1307;99.3333333333333
64331;2023;6;6;0;100;0;120183.333333333;1332.66666666667;107.5
64332;2023;1;1;0;100;0;219000;1386;158
64334;2023;2;2;0;100;0;194750;1377.5;147.5
64335;2023;94;63;31;67.0212765957447;32.9787234042553;266730.765957447;2702.14893617021;97.0425531914894
64336;2023;5;5;0;100;0;227646;1978.4;110
64339;2023;8;8;0;100;0;219628.125;1980.25;115
64341;2023;1;1;0;100;0;135000;1089;124
64342;2023;4;4;0;100;0;177986.75;1699;108.75
64343;2023;4;4;0;100;0;285740;2403.75;120
64344;2023;5;4;1;80;20;243760;1882.8;131.8
64345;2023;1;1;0;100;0;365000;3763;97
64346;2023;2;2;0;100;0;185200;1577.5;123.5
64347;2023;4;4;0;100;0;332625;2541.25;134.5
64348;2023;179;94;85;52.5139664804469;47.4860335195531;217377.117318436;2490.62569832402;86.5139664804469
64349;2023;5;5;0;100;0;264705;1943.6;139.4
64350;2023;5;3;2;60;40;284300;3183.2;74.8
64351;2023;1;1;0;100;0;170000;1250;136
64352;2023;2;2;0;100;0;222250;2071;111.5
64353;2023;11;8;3;72.7272727272727;27.2727272727273;132448.181818182;1500.27272727273;89.8181818181818
64354;2023;1;1;0;100;0;259000;3866;67
64355;2023;3;3;0;100;0;145000;939.333333333333;155.333333333333
64356;2023;2;2;0;100;0;126000;1305.5;95.5
64357;2023;1;1;0;100;0;280000;1818;154
64358;2023;5;5;0;100;0;256515.4;2061.6;151.6
64359;2023;11;11;0;100;0;226430.181818182;1457.54545454545;139.545454545455
64360;2023;1;1;0;100;0;126000;788;160
64361;2023;2;2;0;100;0;121000;1037;117.5
64363;2023;4;4;0;100;0;130283.75;2158.75;71.25
64364;2023;2;2;0;100;0;274500;3534.5;69.5
64365;2023;4;4;0;100;0;150920;1251.75;115.5
64366;2023;1;1;0;100;0;97000;815;119
64367;2023;7;7;0;100;0;227714;1616.85714285714;145.571428571429
64368;2023;1;1;0;100;0;104145;491;212
64370;2023;4;4;0;100;0;369137.5;2998.5;125.5
64371;2023;29;22;7;75.8620689655172;24.1379310344828;153808.448275862;1628.86206896552;99.1724137931034
64373;2023;18;15;3;83.3333333333333;16.6666666666667;240064.444444444;2490.22222222222;96.4444444444444
64374;2023;12;12;0;100;0;303499.166666667;2310.91666666667;131.25
64375;2023;2;2;0;100;0;211000;1532.5;146.5
64376;2023;9;9;0;100;0;338069;2658.88888888889;128.666666666667
64377;2023;2;2;0;100;0;4,00E+05;1886.5;210
64379;2023;2;2;0;100;0;122500;1157.5;104
64380;2023;2;2;0;100;0;161300;1701.5;95
64381;2023;1;1;0;100;0;190000;1284;148
64382;2023;4;4;0;100;0;134900;1384;113.5
64383;2023;1;1;0;100;0;208000;1908;109
64385;2023;3;3;0;100;0;166970;2281.66666666667;75.3333333333333
64386;2023;22;17;5;77.2727272727273;22.7272727272727;220247.909090909;2053.59090909091;116.636363636364
64387;2023;6;6;0;100;0;250723.5;1959.83333333333;122.166666666667
64388;2023;1;1;0;100;0;185000;1082;171
64389;2023;3;3;0;100;0;155000;1652;94
64390;2023;1;1;0;100;0;120000;1500;80
64391;2023;2;2;0;100;0;171500;1667;103
64393;2023;34;31;3;91.1764705882353;8.82352941176471;217513.647058824;2010.82352941176;111.794117647059
64394;2023;1;1;0;100;0;65000;650;100
64395;2023;5;5;0;100;0;149530;1738.8;90.6
64396;2023;8;8;0;100;0;171836.375;1492.25;117.5
64397;2023;1;1;0;100;0;167000;2197;76
64398;2023;3;3;0;100;0;201216.666666667;1748.33333333333;113.333333333333
64399;2023;17;17;0;100;0;307546.235294118;2355;127.882352941176
64400;2023;12;12;0;100;0;220179.166666667;1983.16666666667;116.333333333333
64403;2023;3;3;0;100;0;191511.666666667;1796;122
64404;2023;5;5;0;100;0;206200;1901.4;106.2
64405;2023;38;34;4;89.4736842105263;10.5263157894737;256455.921052632;2248.57894736842;119.526315789474
64406;2023;8;8;0;100;0;290446.875;2293;120.25
64407;2023;48;38;10;79.1666666666667;20.8333333333333;440384.979166667;4518.85416666667;101.5625
64408;2023;1;1;0;100;0;175000;1167;150
64409;2023;6;6;0;100;0;221025;1969.16666666667;117.333333333333
64410;2023;62;30;32;48.3870967741936;51.6129032258064;104172.967741935;1312;78.3387096774194
64411;2023;1;1;0;100;0;357000;5852;61
64413;2023;6;5;1;83.3333333333333;16.6666666666667;168690.833333333;2793;73.8333333333333
64414;2023;2;2;0;100;0;175000;1016;170
64415;2023;7;7;0;100;0;274604.285714286;2616.42857142857;111
64416;2023;20;15;5;75;25;146990.35;1689.65;90.35
64417;2023;46;25;21;54.3478260869565;45.6521739130435;163647.739130435;1949.86956521739;86.195652173913
64418;2023;3;2;1;66.6666666666667;33.3333333333333;140666.666666667;1096;133.333333333333
64419;2023;10;9;1;90;10;223115;2042.3;106.2
64421;2023;13;13;0;100;0;135062;1443.15384615385;101.846153846154
64422;2023;176;102;74;57.9545454545455;42.0454545454545;140157.625;1567.77272727273;91.5113636363636
64423;2023;1;1;0;100;0;142858;1200;119
64424;2023;5;5;0;100;0;172840;1673.4;92.4
64425;2023;3;3;0;100;0;300197.666666667;2067.66666666667;142
64426;2023;4;4;0;100;0;242450;2051;120.5
64427;2023;2;2;0;100;0;268064;2207.5;123.5
64428;2023;2;2;0;100;0;623067.5;2983.5;217.5
64429;2023;2;2;0;100;0;192500;1456.5;157
64430;2023;177;88;89;49.7175141242938;50.2824858757062;153663.960451977;1886.52542372881;84.7966101694915
64431;2023;5;5;0;100;0;196700;1835.8;106.2
64432;2023;4;4;0;100;0;96030;1190.5;92.5
64433;2023;2;2;0;100;0;119950;1625;78.5
64435;2023;2;2;0;100;0;180000;1946.5;72.5
64436;2023;6;4;2;66.6666666666667;33.3333333333333;179881;1355.16666666667;138.5
64437;2023;1;1;0;100;0;240100;1149;209
64438;2023;3;3;0;100;0;282353.333333333;2371;118.666666666667
64439;2023;17;16;1;94.1176470588235;5.88235294117647;273452.941176471;2307.41176470588;124.647058823529
64441;2023;2;2;0;100;0;120000;1139.5;104
64442;2023;2;2;0;100;0;201750;1746;116
64443;2023;12;11;1;91.6666666666667;8.33333333333333;180633.416666667;1777;101.833333333333
64444;2023;5;5;0;100;0;208188;1528.2;146.4
64445;2023;1790;242;1548;13.5195530726257;86.4804469273743;156527.925698324;2291.97430167598;67.2368715083799
64446;2023;1;1;0;100;0;222000;2337;95
64447;2023;1;1;0;100;0;52500;525;100
64448;2023;15;13;2;86.6666666666667;13.3333333333333;288892.666666667;2791.53333333333;105.6
64450;2023;1;1;0;100;0;289100;3960;73
64452;2023;1;1;0;100;0;177000;1383;128
64453;2023;29;24;5;82.7586206896552;17.2413793103448;203729.137931034;1850.8275862069;106.689655172414
64455;2023;3;3;0;100;0;154666.666666667;1315.66666666667;145.333333333333
64456;2023;1;1;0;100;0;280900;2675;105
64458;2023;2;2;0;100;0;236000;1183.5;248
64460;2023;4;4;0;100;0;168945;1079.75;147.75
64461;2023;16;15;1;93.75;6.25;169897.3125;1825.75;95.0625
64462;2023;7;7;0;100;0;204274.285714286;2279.57142857143;93
64463;2023;3;3;0;100;0;192433.333333333;1755.33333333333;111.666666666667
64465;2023;2;2;0;100;0;120200;1541.5;76.5
64467;2023;6;4;2;66.6666666666667;33.3333333333333;307083.333333333;3152;103.333333333333
64468;2023;2;2;0;100;0;125000;1577.5;77.5
64469;2023;2;2;0;100;0;237000;1629.5;151.5
64470;2023;9;9;0;100;0;261161.111111111;2115;125.333333333333
64471;2023;2;2;0;100;0;229800;2265;99
64472;2023;8;8;0;100;0;301026.25;2264.75;132.625
64474;2023;1;1;0;100;0;211500;2324;91
64475;2023;4;4;0;100;0;105250;1147.5;101.5
64476;2023;1;1;0;100;0;393000;2692;146
64477;2023;9;9;0;100;0;316680;3356.11111111111;101
64478;2023;5;5;0;100;0;467920;2467.4;192.4
64479;2023;4;4;0;100;0;198800;1647;120.75
64480;2023;1;1;0;100;0;185000;1814;102
64481;2023;2;2;0;100;0;258075;2516;103
64482;2023;5;5;0;100;0;213800;1976;110.4
64483;2023;305;49;256;16.0655737704918;83.9344262295082;478703.809836066;6638.41967213115;70.1016393442623
64484;2023;11;11;0;100;0;271809.090909091;2867.27272727273;98.9090909090909
64485;2023;6;3;3;50;50;264490.833333333;2494.66666666667;108.833333333333
64488;2023;3;3;0;100;0;246934.333333333;2204.66666666667;114.666666666667
64489;2023;2;2;0;100;0;300025;2662.5;112.5
64490;2023;3;3;0;100;0;291000;2082.66666666667;147.666666666667
64491;2023;2;2;0;100;0;270275;1398;176.5
64492;2023;2;2;0;100;0;240000;1996.5;122.5
64493;2023;17;6;11;35.2941176470588;64.7058823529412;167435;1893.17647058824;86.2941176470588
64494;2023;3;3;0;100;0;341666.666666667;2685.66666666667;128.666666666667
64495;2023;57;26;31;45.6140350877193;54.3859649122807;391535.438596491;4265.21052631579;92.0877192982456
64496;2023;49;22;27;44.8979591836735;55.1020408163265;341791.673469388;3969.89795918367;88.1836734693878
64499;2023;85;64;21;75.2941176470588;24.7058823529412;190645.152941176;2045.30588235294;92.8235294117647
64500;2023;6;6;0;100;0;290052.333333333;2437;123.666666666667
64501;2023;7;7;0;100;0;174535.714285714;2251.71428571429;81.7142857142857
64502;2023;4;4;0;100;0;169950;2119;70.5
64503;2023;2;2;0;100;0;169577.5;1598;130.5
64504;2023;9;6;3;66.6666666666667;33.3333333333333;422969.444444444;3789.88888888889;115.888888888889
64506;2023;3;3;0;100;0;119666.666666667;1398.33333333333;86.3333333333333
64507;2023;3;3;0;100;0;104000;1016.66666666667;114.666666666667
64508;2023;1;1;0;100;0;176000;1354;130
64509;2023;1;1;0;100;0;81000;862;94
64510;2023;13;13;0;100;0;194113.230769231;2028.07692307692;97
64511;2023;29;27;2;93.1034482758621;6.89655172413793;295219.482758621;2558.72413793103;114.620689655172
64513;2023;17;15;2;88.2352941176471;11.7647058823529;259257.352941176;2296.52941176471;124.941176470588
64514;2023;1;1;0;100;0;249000;2243;111
64515;2023;1;1;0;100;0;155000;2627;59
64516;2023;3;3;0;100;0;224613.333333333;1548.66666666667;145.333333333333
64517;2023;4;4;0;100;0;148012.5;1499.25;96.25
64518;2023;16;16;0;100;0;360678.75;2821.75;133.0625
64519;2023;32;28;4;87.5;12.5;271491.125;2657.34375;103.28125
64520;2023;8;8;0;100;0;418603;2809.375;151.25
64521;2023;3;3;0;100;0;245533.333333333;2101.66666666667;122.333333333333
64522;2023;3;3;0;100;0;158308.333333333;2224;87.6666666666667
64523;2023;6;6;0;100;0;195656;1654.83333333333;113.666666666667
64524;2023;1;1;0;100;0;186000;1265;147
64525;2023;4;4;0;100;0;257862.5;2856.75;89.75
64526;2023;16;15;1;93.75;6.25;229565.1875;2214.4375;104.3125
64527;2023;18;9;9;50;50;391247.777777778;4261.72222222222;90.0555555555556
64528;2023;1;1;0;100;0;135000;1274;106
64529;2023;9;9;0;100;0;180732.777777778;2009.44444444444;97.1111111111111
64530;2023;5;5;0;100;0;176093.6;1984.4;91.6
64531;2023;2;2;0;100;0;133400;1294.5;122.5
64533;2023;2;1;1;50;50;70971;903;83.5
64534;2023;2;2;0;100;0;190000;1382;146.5
64535;2023;5;5;0;100;0;249670;1949;139.4
64536;2023;9;9;0;100;0;209255;2101.11111111111;98.7777777777778
64537;2023;1;1;0;100;0;120000;1043;115
64538;2023;14;3;11;21.4285714285714;78.5714285714286;140444.285714286;2741.92857142857;55.6428571428571
64540;2023;24;18;6;75;25;414249;4290;96.0833333333333
64541;2023;1;1;0;100;0;54000;568;95
64542;2023;8;7;1;87.5;12.5;146216.25;1992.25;76
64543;2023;2;2;0;100;0;150000;1655;110
64545;2023;130;48;82;36.9230769230769;63.0769230769231;437593.738461538;5329.06153846154;83.6923076923077
64546;2023;15;12;3;80;20;351916.666666667;3879.86666666667;92.2666666666667
64547;2023;69;25;44;36.231884057971;63.768115942029;308655.753623188;4176.84057971014;75.304347826087
64548;2023;4;4;0;100;0;303730;2064;149
64549;2023;7;7;0;100;0;223990;1641.85714285714;142.714285714286
64550;2023;8;8;0;100;0;345676.25;2799.75;127.625
64551;2023;4;4;0;100;0;211750;1936;123.5
64552;2023;2;2;0;100;0;167500;1299.5;139.5
64554;2023;1;1;0;100;0;375850;2685;140
64555;2023;3;3;0;100;0;262666.666666667;3283.33333333333;80
64556;2023;1;1;0;100;0;223500;2429;92
64557;2023;2;2;0;100;0;221050;2084;106.5
64558;2023;17;13;4;76.4705882352941;23.5294117647059;535963.882352941;4212.82352941176;129.235294117647
64559;2023;8;8;0;100;0;244456.875;2139.375;109.375
65001;2023;2;2;0;100;0;309750;2813.5;110
65002;2023;4;4;0;100;0;185725.75;1528.75;116.75
65003;2023;2;0;2;0;100;156750;3174;46.5
65004;2023;6;6;0;100;0;223793.833333333;2248.33333333333;105.833333333333
65005;2023;4;4;0;100;0;221516.25;1951.25;119
65007;2023;14;14;0;100;0;220746.928571429;2272.28571428571;100.714285714286
65009;2023;1;1;0;100;0;1,00E+05;833;120
65010;2023;3;2;1;66.6666666666667;33.3333333333333;144444.333333333;1264;119.666666666667
65012;2023;2;2;0;100;0;104000;834.5;125
65013;2023;1;1;0;100;0;57000;548;104
65014;2023;1;1;0;100;0;176920;1805;98
65015;2023;2;2;0;100;0;117000;1003;114
65016;2023;2;2;0;100;0;209700;2024.5;103
65017;2023;29;0;29;0;100;74200.6206896552;2458.31034482759;30.4137931034483
65018;2023;3;3;0;100;0;166133.333333333;1830.66666666667;105.333333333333
65019;2023;9;9;0;100;0;165827.777777778;1430;119.777777777778
65020;2023;1;1;0;100;0;1,00E+05;901;111
65021;2023;4;4;0;100;0;207000;2564.75;81.25
65023;2023;1;1;0;100;0;110000;1068;103
65024;2023;1;1;0;100;0;181650;2488;73
65025;2023;55;17;38;30.9090909090909;69.0909090909091;192805.036363636;2729.69090909091;73.1090909090909
65026;2023;2;2;0;100;0;172302.5;1518;118.5
65028;2023;4;4;0;100;0;142560;1158.5;117
65029;2023;5;5;0;100;0;295370;1996.6;138.2
65031;2023;34;10;24;29.4117647058824;70.5882352941177;121478.529411765;2318.76470588235;57.9411764705882
65032;2023;9;6;3;66.6666666666667;33.3333333333333;197588.888888889;2986.55555555556;69.7777777777778
65033;2023;2;2;0;100;0;160390;1622;100.5
65034;2023;1;1;0;100;0;142690;1049;136
65035;2023;4;4;0;100;0;80125;767.25;101.5
65036;2023;2;2;0;100;0;350000;3946;95
65040;2023;19;4;15;21.0526315789474;78.9473684210526;76281.8421052632;1328.31578947368;51.1052631578947
65041;2023;5;5;0;100;0;141840.6;1826.2;84.6
65042;2023;13;13;0;100;0;188214.461538462;1711.23076923077;110.307692307692
65043;2023;1;1;0;100;0;185000;1186;156
65044;2023;1;1;0;100;0;256000;1730;148
65045;2023;6;5;1;83.3333333333333;16.6666666666667;208631.666666667;2382.33333333333;97.6666666666667
65046;2023;1;1;0;100;0;310000;3444;90
65047;2023;113;83;30;73.4513274336283;26.5486725663717;152353.256637168;1750.12389380531;87.716814159292
65048;2023;4;4;0;100;0;163421.5;1664;102
65049;2023;5;5;0;100;0;163322;1229.6;134.6
65050;2023;1;1;0;100;0;360000;2000;180
65051;2023;1;1;0;100;0;280000;1333;210
65052;2023;1;1;0;100;0;160000;2286;70
65053;2023;1;1;0;100;0;180000;1731;104
65054;2023;7;7;0;100;0;111068.428571429;1157;103.285714285714
65055;2023;5;4;1;80;20;263868.6;2269.2;122.8
65056;2023;4;4;0;100;0;224796.25;1660.5;137.5
65057;2023;10;9;1;90;10;176120;1922.2;93.2
65058;2023;3;3;0;100;0;338400;3002.33333333333;108.666666666667
65059;2023;231;62;169;26.8398268398268;73.1601731601732;119471.632034632;2006.9696969697;61.7575757575758
65060;2023;2;2;0;100;0;160000;1632;96.5
65061;2023;2;2;0;100;0;140450;1252.5;111.5
65062;2023;29;27;2;93.1034482758621;6.89655172413793;182024.931034483;1834.86206896552;100
65064;2023;2;2;0;100;0;127020;1749;79
65065;2023;3;3;0;100;0;86195.6666666667;1068.66666666667;77.3333333333333
65066;2023;1;1;0;100;0;40000;533;75
65069;2023;10;10;0;100;0;145195.4;1621.2;96.4
65070;2023;2;2;0;100;0;290000;2349.5;125
65072;2023;20;20;0;100;0;183001.2;1814.8;109.75
65073;2023;2;2;0;100;0;181600;1310;138.5
65075;2023;2;2;0;100;0;584950;2900;197
65077;2023;3;3;0;100;0;320150.666666667;2161.66666666667;145.666666666667
65078;2023;9;9;0;100;0;182003.333333333;2213.88888888889;87.8888888888889
65079;2023;3;3;0;100;0;129100;1584.33333333333;82.3333333333333
65081;2023;1;1;0;100;0;190000;2375;80
65083;2023;7;7;0;100;0;219788;2078.28571428571;108.428571428571
65084;2023;1;1;0;100;0;216600;2256;96
65085;2023;2;2;0;100;0;147500;1815.5;87
65086;2023;4;4;0;100;0;146375;1292.75;105
65087;2023;1;1;0;100;0;165400;1654;100
65089;2023;5;5;0;100;0;128779;2242.4;57.2
65091;2023;1;1;0;100;0;78000;975;80
65092;2023;2;2;0;100;0;164850;1641;108
65093;2023;3;3;0;100;0;73333.3333333333;1084;73.3333333333333
65094;2023;3;3;0;100;0;252700;1811.33333333333;145.333333333333
65095;2023;2;2;0;100;0;101200;1000;100.5
65096;2023;3;3;0;100;0;124741;1696;72.3333333333333
65097;2023;1;1;0;100;0;260000;1595;163
65098;2023;1;1;0;100;0;299630;2497;120
65099;2023;6;6;0;100;0;263740;3099.83333333333;89.5
65100;2023;40;34;6;85;15;174944;1833.85;97.225
65101;2023;4;4;0;100;0;132181.25;1484.5;94.5
65103;2023;2;2;0;100;0;242617.5;1724.5;149
65104;2023;3;3;0;100;0;178333.333333333;1766;105.666666666667
65105;2023;2;2;0;100;0;126035;1488;83.5
65106;2023;7;4;3;57.1428571428571;42.8571428571429;336233.428571429;3559.42857142857;95
65108;2023;9;9;0;100;0;212618.444444444;1869.77777777778;126.333333333333
65109;2023;1;1;0;100;0;140000;700;200
65110;2023;2;2;0;100;0;93750;1491.5;76
65112;2023;2;2;0;100;0;314961;2981.5;101.5
65113;2023;2;2;0;100;0;173970;1294;138.5
65116;2023;9;6;3;66.6666666666667;33.3333333333333;238125.555555556;2366.44444444444;106.777777777778
65119;2023;3;3;0;100;0;66800;628.333333333333;105.666666666667
65121;2023;4;4;0;100;0;188141.25;1816;114.25
65123;2023;45;33;12;73.3333333333333;26.6666666666667;167552.777777778;2315.91111111111;81.1333333333333
65124;2023;1;1;0;100;0;370000;2312;160
65125;2023;3;3;0;100;0;170960;1203.33333333333;131.666666666667
65126;2023;1;1;0;100;0;75000;417;180
65127;2023;29;22;7;75.8620689655172;24.1379310344828;135690.517241379;1445.93103448276;88.5172413793103
65129;2023;9;9;0;100;0;182088.888888889;1592.55555555556;109.222222222222
65130;2023;5;5;0;100;0;109200;1207.8;96.6
65133;2023;3;3;0;100;0;170733.333333333;2452.66666666667;69.3333333333333
65137;2023;1;1;0;100;0;438000;2920;150
65138;2023;145;13;132;8.96551724137931;91.0344827586207;139506.848275862;3626.55172413793;38.2275862068966
65141;2023;1;1;0;100;0;2,00E+05;2500;80
65142;2023;1;1;0;100;0;150000;909;165
65143;2023;2;2;0;100;0;301595;2442;126
65144;2023;2;2;0;100;0;267721.5;4306;62
65145;2023;3;3;0;100;0;164109.333333333;2132.66666666667;75
65146;2023;1;1;0;100;0;145000;1283;113
65147;2023;4;4;0;100;0;215317.5;2051.5;101.25
65149;2023;2;2;0;100;0;217000;2287;92.5
65150;2023;1;1;0;100;0;214800;2527;85
65151;2023;2;2;0;100;0;182500;1617.5;114
65153;2023;2;2;0;100;0;99750;759.5;133
65154;2023;1;1;0;100;0;107000;1408;76
65156;2023;2;2;0;100;0;183125;2104.5;87
65158;2023;1;1;0;100;0;113950;1899;60
65159;2023;6;6;0;100;0;175383.333333333;1634.66666666667;109
65160;2023;1;1;0;100;0;119000;992;120
65161;2023;3;3;0;100;0;184498.333333333;1551.66666666667;117.666666666667
65164;2023;1;1;0;100;0;388100;2156;180
65165;2023;3;3;0;100;0;215000;2868.66666666667;69.6666666666667
65166;2023;1;1;0;100;0;95000;1900;50
65167;2023;1;1;0;100;0;210900;1506;140
65168;2023;14;4;10;28.5714285714286;71.4285714285714;124308.357142857;2701.28571428571;55.7142857142857
65169;2023;4;4;0;100;0;238276.25;3762.75;62.25
65170;2023;1;1;0;100;0;1,00E+05;676;148
65173;2023;2;2;0;100;0;175720;3305.5;63
65174;2023;3;3;0;100;0;105833.333333333;1407;79
65175;2023;1;1;0;100;0;140000;1750;80
65176;2023;4;4;0;100;0;115767.5;1054.75;105
65177;2023;3;3;0;100;0;160000;1168.66666666667;136.666666666667
65181;2023;1;1;0;100;0;2,00E+05;1887;106
65182;2023;4;4;0;100;0;303375;2767.5;116
65183;2023;10;10;0;100;0;139284.2;1259.7;117.1
65184;2023;2;2;0;100;0;168000;1508;114.5
65185;2023;3;3;0;100;0;252913;2686;98.6666666666667
65186;2023;1;1;0;100;0;142000;1945;73
65187;2023;1;1;0;100;0;430000;2057;209
65189;2023;1;1;0;100;0;182500;1484;123
65190;2023;2;2;0;100;0;128000;1896.5;92
65191;2023;3;3;0;100;0;99333.3333333333;1562;72.6666666666667
65192;2023;7;3;4;42.8571428571429;57.1428571428571;123665;2601.28571428571;45.7142857142857
65193;2023;1;1;0;100;0;75000;1364;55
65194;2023;1;1;0;100;0;81818;1259;65
65195;2023;8;2;6;25;75;113602.125;3221.25;40.25
65197;2023;1;1;0;100;0;180000;2769;65
65198;2023;14;13;1;92.8571428571429;7.14285714285714;166248.571428571;1587.07142857143;111.571428571429
65199;2023;40;0;40;0;100;123451.025;2704.125;43.775
65200;2023;2;2;0;100;0;212308;2344;97.5
65201;2023;2;2;0;100;0;167500;2169;77.5
65202;2023;4;4;0;100;0;198296.25;2064.25;99.5
65205;2023;1;1;0;100;0;165220;3304;50
65206;2023;3;3;0;100;0;228050;2428;106
65208;2023;2;2;0;100;0;177500;2625;100
65209;2023;1;1;0;100;0;282000;2518;112
65210;2023;1;1;0;100;0;98840;1236;80
65211;2023;2;2;0;100;0;380325;2693;137.5
65212;2023;8;4;4;50;50;227015.375;2756.5;88.375
65213;2023;2;2;0;100;0;184013.5;1427.5;130
65215;2023;1;1;0;100;0;50000;806;62
65217;2023;1;1;0;100;0;241000;2060;117
65218;2023;5;5;0;100;0;130800;1505.8;95.4
65220;2023;3;3;0;100;0;238990;2131.33333333333;139.333333333333
65221;2023;3;3;0;100;0;227666.666666667;2978.66666666667;85
65223;2023;6;6;0;100;0;224671.833333333;1838.66666666667;131.333333333333
65224;2023;4;4;0;100;0;134275;1183.5;112.75
65226;2023;28;25;3;89.2857142857143;10.7142857142857;216320.714285714;2061.75;110.892857142857
65228;2023;1;1;0;100;0;195800;2797;70
65230;2023;6;6;0;100;0;168563.333333333;1319.83333333333;119.833333333333
65232;2023;2;2;0;100;0;233500;1887;123.5
65234;2023;3;3;0;100;0;171233.333333333;1643.33333333333;102
65235;2023;40;39;1;97.5;2.5;178239.7;1730.625;102.525
65236;2023;3;3;0;100;0;252631.666666667;1798;142.333333333333
65237;2023;1;1;0;100;0;190000;1357;140
65238;2023;4;4;0;100;0;167700;1811.25;109
65239;2023;1;1;0;100;0;80000;1067;75
65240;2023;8;8;0;100;0;113312.5;1042.875;114.125
65241;2023;4;4;0;100;0;259250;2126.5;125.25
65242;2023;2;2;0;100;0;191300;1261;152
65243;2023;3;3;0;100;0;137966;1147;125.666666666667
65244;2023;3;3;0;100;0;179900;2059.33333333333;89
65245;2023;3;3;0;100;0;215923.333333333;2123.33333333333;98
65247;2023;1;1;0;100;0;232750;1293;180
65248;2023;2;2;0;100;0;255000;1280.5;175.5
65251;2023;26;25;1;96.1538461538462;3.84615384615385;196368.961538462;1759.61538461538;112.115384615385
65252;2023;10;10;0;100;0;224858.9;1793.2;135.1
65254;2023;1;1;0;100;0;140080;1574;89
65257;2023;4;4;0;100;0;339525;2363.75;166.25
65258;2023;90;51;39;56.6666666666667;43.3333333333333;104301.1;1277.94444444444;83.4666666666667
65259;2023;2;2;0;100;0;321250;2320;144.5
65262;2023;4;4;0;100;0;113087.5;1077.75;107.25
65263;2023;1;1;0;100;0;247000;3431;72
65265;2023;4;4;0;100;0;202025;1738;114
65266;2023;1;1;0;100;0;104500;1608;65
65267;2023;4;4;0;100;0;240612.5;2581.75;91.25
65270;2023;2;2;0;100;0;252800;2022;122.5
65271;2023;2;2;0;100;0;151500;1378.5;111
65272;2023;1;1;0;100;0;70000;636;110
65273;2023;1;1;0;100;0;152000;1617;94
65274;2023;3;3;0;100;0;103314.666666667;863.666666666667;122.666666666667
65276;2023;1;1;0;100;0;305000;2521;121
65277;2023;4;4;0;100;0;116842.25;1353.75;70.5
65279;2023;3;3;0;100;0;136953.333333333;1643;86.6666666666667
65280;2023;1;1;0;100;0;120000;938;128
65281;2023;4;4;0;100;0;144737.5;1479;108.25
65282;2023;19;7;12;36.8421052631579;63.1578947368421;266939.526315789;4651;61
65283;2023;2;1;1;50;50;296000;3104;87
65284;2023;7;7;0;100;0;302205.857142857;2637.28571428571;113.285714285714
65286;2023;303;75;228;24.7524752475248;75.2475247524752;95885.0462046205;1544.63696369637;64.970297029703
65287;2023;6;5;1;83.3333333333333;16.6666666666667;117566.666666667;1406.66666666667;86.5
65288;2023;2;2;0;100;0;118500;1910.5;64
65289;2023;1;1;0;100;0;95000;556;171
65290;2023;1;1;0;100;0;130000;1193;109
65291;2023;1;1;0;100;0;202000;3258;62
65292;2023;4;4;0;100;0;217750;1966.25;113.5
65293;2023;2;2;0;100;0;107994.5;907.5;118.5
65294;2023;2;2;0;100;0;216000;2135;107
65295;2023;40;13;27;32.5;67.5;152780.6;2785.65;58.3
65296;2023;4;4;0;100;0;190487.5;1838;122.75
65299;2023;4;4;0;100;0;195763.25;1527.25;132
65300;2023;2;2;0;100;0;104415;1168.5;90.5
65301;2023;4;4;0;100;0;137375;1397;98
65303;2023;6;6;0;100;0;132176.666666667;1473.83333333333;102
65304;2023;29;28;1;96.551724137931;3.44827586206897;130955.862068966;1507.62068965517;90.6896551724138
65305;2023;7;4;3;57.1428571428571;42.8571428571429;87311.4285714286;1261.42857142857;76.4285714285714
65306;2023;3;3;0;100;0;97074.6666666667;1198;83.3333333333333
65307;2023;5;5;0;100;0;193940;1364.6;153.6
65308;2023;1;1;0;100;0;63000;1260;50
65311;2023;1;1;0;100;0;80000;1000;80
65313;2023;4;4;0;100;0;127750;1424.25;92
65314;2023;4;4;0;100;0;203000;1323.75;154
65315;2023;5;5;0;100;0;158437.8;1206;142
65316;2023;2;2;0;100;0;165000;1162.5;148
65318;2023;2;2;0;100;0;1,00E+05;991.5;95
65320;2023;8;7;1;87.5;12.5;209180;2022;112.5
65322;2023;2;2;0;100;0;180000;1347;135
65327;2023;3;3;0;100;0;116456.666666667;948;137
65328;2023;2;2;0;100;0;188140;2536;76.5
65329;2023;5;5;0;100;0;110000;1334;82.8
65330;2023;4;4;0;100;0;182412.5;1609.75;110.25
65331;2023;42;42;0;100;0;237537;2011.28571428571;117
65334;2023;1;1;0;100;0;256700;1874;137
65335;2023;6;6;0;100;0;211737.5;2389.66666666667;96.1666666666667
65338;2023;1;1;0;100;0;177000;1770;100
65339;2023;3;3;0;100;0;170607.666666667;1642;102.666666666667
65340;2023;24;24;0;100;0;205079.833333333;1843.58333333333;112.125
65343;2023;2;2;0;100;0;246370;1723.5;151.5
65344;2023;23;23;0;100;0;206641.217391304;1939.04347826087;101.260869565217
65347;2023;1;1;0;100;0;133090;1199;111
65348;2023;1;1;0;100;0;95000;1583;60
65350;2023;12;12;0;100;0;233759.083333333;2070.75;124.166666666667
65351;2023;1;1;0;100;0;199400;4243;47
65352;2023;2;2;0;100;0;130000;2656.5;51
65353;2023;3;3;0;100;0;263850;2636;100.333333333333
65354;2023;2;2;0;100;0;350000;4079;84
65360;2023;1;1;0;100;0;168000;1388;121
65362;2023;14;7;7;50;50;143540.642857143;2160.35714285714;70.7142857142857
65363;2023;5;5;0;100;0;109180;1166;92.6
65366;2023;4;4;0;100;0;210900;1910;110.5
65367;2023;1;1;0;100;0;102500;820;125
65369;2023;4;3;1;75;25;163277.5;1928.25;98
65370;2023;10;6;4;60;40;162907.5;2413.5;72.8
65371;2023;1;0;1;0;100;240000;3200;75
65372;2023;3;3;0;100;0;150633.333333333;1429;109.333333333333
65373;2023;6;6;0;100;0;123471.666666667;1259.66666666667;110.333333333333
65374;2023;2;2;0;100;0;156640;1408;110
65375;2023;17;15;2;88.2352941176471;11.7647058823529;112406.352941176;1072.94117647059;103.705882352941
65377;2023;3;3;0;100;0;195166.666666667;1832.33333333333;105.666666666667
65378;2023;2;2;0;100;0;169185;1682.5;105
65379;2023;1;1;0;100;0;220000;1467;150
65382;2023;3;3;0;100;0;56266.6666666667;914.666666666667;67.6666666666667
65383;2023;3;3;0;100;0;238270;2964.66666666667;93.6666666666667
65384;2023;2;1;1;50;50;107500;2071.5;57.5
65386;2023;4;4;0;100;0;187075;2129.25;86.5
65387;2023;2;2;0;100;0;222355;1548.5;145
65388;2023;185;7;178;3.78378378378378;96.2162162162162;137456.859459459;3364.56756756757;39.1405405405405
65389;2023;15;15;0;100;0;131648;1307.06666666667;109.2
65390;2023;8;8;0;100;0;209133.75;1710.125;120.625
65392;2023;3;3;0;100;0;266900;2096.66666666667;131
65393;2023;1;1;0;100;0;250000;3968;63
65395;2023;16;14;2;87.5;12.5;131499.375;1333.5625;102.875
65396;2023;5;2;3;40;60;246160.2;3931.8;64.4
65397;2023;1;1;0;100;0;115000;958;120
65398;2023;6;6;0;100;0;136142.166666667;1806.16666666667;83.6666666666667
65399;2023;2;0;2;0;100;141250;3061.5;48
65400;2023;2;2;0;100;0;108170;1149;94
65401;2023;6;6;0;100;0;235787.5;1961.16666666667;117.333333333333
65404;2023;1;1;0;100;0;178000;1079;165
65405;2023;4;4;0;100;0;116000.5;1724.5;82.5
65406;2023;4;4;0;100;0;161122.5;1429;119.5
65408;2023;9;8;1;88.8888888888889;11.1111111111111;164932.222222222;1917.66666666667;93.6666666666667
65409;2023;5;5;0;100;0;126664.8;1474.6;82.2
65410;2023;3;3;0;100;0;243333.333333333;1764;133
65411;2023;1;1;0;100;0;23000;622;37
65412;2023;3;3;0;100;0;239576.666666667;1457;174
65413;2023;5;4;1;80;20;158590.2;3084.8;56
65415;2023;2;2;0;100;0;251365;2356.5;107
65416;2023;2;2;0;100;0;87250;1033.5;75
65417;2023;70;58;12;82.8571428571429;17.1428571428571;158109.642857143;1790.32857142857;90.2428571428571
65418;2023;1;1;0;100;0;81000;1191;68
65421;2023;1;1;0;100;0;134250;1370;98
65423;2023;1;1;0;100;0;180000;1000;180
65424;2023;4;3;1;75;25;156733.75;3094.5;51.5
65425;2023;7;7;0;100;0;174378.571428571;1700.14285714286;104.142857142857
65426;2023;1;1;0;100;0;160000;1455;110
65427;2023;3;3;0;100;0;105356.666666667;1113.33333333333;118
65428;2023;1;1;0;100;0;120000;1935;62
65429;2023;5;5;0;100;0;177946.6;1329.6;142.8
65430;2023;1;1;0;100;0;306850;2006;153
65431;2023;4;4;0;100;0;119305;1399.75;88.5
65432;2023;4;4;0;100;0;166475;1377.25;112.75
65433;2023;31;21;10;67.741935483871;32.258064516129;149799.129032258;1722.96774193548;87.4516129032258
65435;2023;2;2;0;100;0;93900;1448;65
65436;2023;2;2;0;100;0;137500;2313;59
65437;2023;3;3;0;100;0;170833.333333333;2187.66666666667;78.6666666666667
65438;2023;1;1;0;100;0;212340;1896;112
65439;2023;1;1;0;100;0;164780;1735;95
65440;2023;836;221;615;26.4354066985646;73.5645933014354;109462.604066986;1559.61602870813;71.6232057416268
65441;2023;1;1;0;100;0;80001;667;120
65442;2023;4;4;0;100;0;158700;1367.75;118.25
65444;2023;2;2;0;100;0;219735;1609.5;122
65445;2023;5;5;0;100;0;195934;1946.2;97.6
65446;2023;6;6;0;100;0;221891.666666667;2201;111.5
65447;2023;13;12;1;92.3076923076923;7.69230769230769;145077.076923077;1407.61538461538;107.538461538462
65448;2023;1;1;0;100;0;270000;1125;240
65449;2023;1;1;0;100;0;109000;1677;65
65450;2023;1;1;0;100;0;270000;3253;83
65451;2023;9;9;0;100;0;223722.777777778;2242.55555555556;132.111111111111
65452;2023;10;10;0;100;0;151729;1207.6;126.2
65455;2023;7;7;0;100;0;129642.857142857;1274.42857142857;107.571428571429
65456;2023;2;2;0;100;0;166896;1333;131
65460;2023;59;49;10;83.0508474576271;16.9491525423729;139665.762711864;1526.64406779661;93.7118644067797
65462;2023;3;3;0;100;0;199533.333333333;1303.66666666667;164.333333333333
65463;2023;4;4;0;100;0;132840;2510.25;49.5
65464;2023;1;1;0;100;0;178000;1424;125
65465;2023;32;7;25;21.875;78.125;148309.46875;3480;43.15625
65466;2023;2;2;0;100;0;451952.5;5291;84.5
65467;2023;1;1;0;100;0;345000;2654;130
65468;2023;1;1;0;100;0;235000;1205;195
65470;2023;1;1;0;100;0;224800;1921;117
65471;2023;16;4;12;25;75;206495.875;3988.1875;53.6875
65473;2023;7;7;0;100;0;228768.285714286;2442;94.4285714285714
65474;2023;2;2;0;100;0;196000;972;224
65481;2023;28;2;26;7.14285714285714;92.8571428571429;90381.6071428571;2621.78571428571;36.3928571428571
65482;2023;3;3;0;100;0;178683.333333333;1632.33333333333;112
66001;2023;1;1;0;100;0;230000;1769;130
66002;2023;49;34;15;69.3877551020408;30.6122448979592;254200.428571429;2875.61224489796;86.8775510204082
66003;2023;270;27;243;10;90;68287.7962962963;1518.04814814815;44.8148148148148
66004;2023;119;26;93;21.8487394957983;78.1512605042017;181691.285714286;3726.65546218487;46.0084033613445
66005;2023;14;12;2;85.7142857142857;14.2857142857143;257457.785714286;3635.78571428571;81.5714285714286
66006;2023;2;2;0;100;0;101500;1086;94
66007;2023;2;2;0;100;0;129950;1424.5;92
66008;2023;448;158;290;35.2678571428571;64.7321428571429;180806.341517857;3665.39732142857;51.9955357142857
66009;2023;55;48;7;87.2727272727273;12.7272727272727;153980.636363636;1926.81818181818;80.6181818181818
66010;2023;2;1;1;50;50;85500;1156;66
66011;2023;66;59;7;89.3939393939394;10.6060606060606;223571.954545455;2529.77272727273;90.1515151515152
66012;2023;31;26;5;83.8709677419355;16.1290322580645;221854.225806452;2283.54838709677;90.6451612903226
66013;2023;3;3;0;100;0;77000;1235.66666666667;55
66014;2023;38;34;4;89.4736842105263;10.5263157894737;183503.815789474;2086.63157894737;84.5
66015;2023;26;25;1;96.1538461538462;3.84615384615385;233939.615384615;2548.26923076923;104.115384615385
66016;2023;102;39;63;38.2352941176471;61.7647058823529;244406.823529412;3761.80392156863;63.7450980392157
66017;2023;573;121;452;21.1169284467714;78.8830715532286;122307.22513089;3583.89354275742;34.9301919720768
66018;2023;1;1;0;100;0;259000;1619;160
66019;2023;6;6;0;100;0;87125;1252.5;63.1666666666667
66020;2023;114;34;80;29.8245614035088;70.1754385964912;166588.070175439;3848.38596491228;42.5964912280702
66021;2023;82;76;6;92.6829268292683;7.31707317073171;226808.963414634;2436.14634146341;95.390243902439
66022;2023;1;1;0;100;0;237700;1007;236
66023;2023;15;14;1;93.3333333333333;6.66666666666667;128636.2;1866.26666666667;85.3333333333333
66024;2023;105;71;34;67.6190476190476;32.3809523809524;206099.447619048;2483.80952380952;82.1714285714286
66025;2023;23;10;13;43.4782608695652;56.5217391304348;168421.260869565;2783.30434782609;66.2608695652174
66026;2023;19;19;0;100;0;301504.526315789;2691.73684210526;108.684210526316
66027;2023;7;7;0;100;0;243701.428571429;3632.14285714286;71.2857142857143
66028;2023;107;90;17;84.1121495327103;15.8878504672897;258862.121495327;2591.14953271028;100.177570093458
66030;2023;3;3;0;100;0;99333.3333333333;1821;72.3333333333333
66032;2023;2;2;0;100;0;169000;1955;97
66033;2023;7;7;0;100;0;281274.285714286;2716.57142857143;101.857142857143
66034;2023;6;6;0;100;0;120894.166666667;1529.66666666667;98
66036;2023;4;4;0;100;0;89062.5;1243.5;80
66037;2023;527;147;380;27.8937381404175;72.1062618595825;192574.590132827;3810.21442125237;51.9297912713472
66038;2023;77;66;11;85.7142857142857;14.2857142857143;268229.480519481;2801.44155844156;93.1168831168831
66039;2023;7;6;1;85.7142857142857;14.2857142857143;102857.142857143;1212.42857142857;82.7142857142857
66041;2023;16;16;0;100;0;181462.5625;1840.1875;89.8125
66042;2023;6;6;0;100;0;174783.333333333;1802.16666666667;105
66044;2023;5;5;0;100;0;355120;2683.8;114.2
66045;2023;13;13;0;100;0;157069.615384615;1801.76923076923;94.4615384615385
66046;2023;13;13;0;100;0;118592.307692308;1226.15384615385;90.9230769230769
66047;2023;1;1;0;100;0;118000;2360;50
66048;2023;29;8;21;27.5862068965517;72.4137931034483;159643.206896552;2446.79310344828;66.7586206896552
66049;2023;124;87;37;70.1612903225807;29.8387096774194;224713.814516129;2593.89516129032;87.1209677419355
66050;2023;60;53;7;88.3333333333333;11.6666666666667;236203.683333333;2377.8;95
66051;2023;1;1;0;100;0;140000;1061;132
66052;2023;3;3;0;100;0;183333.333333333;2805.66666666667;72
66053;2023;104;29;75;27.8846153846154;72.1153846153846;286194.923076923;5057.25961538462;59.125
66055;2023;11;11;0;100;0;154443.636363636;2126.63636363636;71.3636363636364
66056;2023;13;11;2;84.6153846153846;15.3846153846154;199563.076923077;2169.92307692308;91.5384615384615
66057;2023;7;7;0;100;0;103428.571428571;1520.28571428571;65
66058;2023;23;22;1;95.6521739130435;4.34782608695652;185798.695652174;2068.91304347826;92.9130434782609
66059;2023;43;30;13;69.7674418604651;30.2325581395349;216480.581395349;2528.93023255814;84.8604651162791
66060;2023;5;4;1;80;20;96048;1671.4;62.2
66061;2023;5;5;0;100;0;284200;2096;100.6
66062;2023;6;5;1;83.3333333333333;16.6666666666667;195500;2838.83333333333;76.5
66063;2023;3;3;0;100;0;268500;2289;122
66064;2023;10;3;7;30;70;207738.5;3058.1;66.2
66065;2023;135;105;30;77.7777777777778;22.2222222222222;208401.422222222;2482.54074074074;82.2222222222222
66066;2023;18;14;4;77.7777777777778;22.2222222222222;278448.333333333;2833.27777777778;98.5
66067;2023;20;3;17;15;85;178352;3160.6;61.05
66068;2023;4;4;0;100;0;112500;1636.75;68
66069;2023;43;42;1;97.6744186046512;2.32558139534884;173808.511627907;2009.02325581395;89.3720930232558
66070;2023;7;6;1;85.7142857142857;14.2857142857143;105640;1131.14285714286;106
66071;2023;40;37;3;92.5;7.5;115679.15;1388.7;80.975
66072;2023;23;12;11;52.1739130434783;47.8260869565217;202960;2869.60869565217;71.0869565217391
66073;2023;5;4;1;80;20;139100;1948.2;71.4
66074;2023;3;3;0;100;0;157250.666666667;2123.66666666667;86.3333333333333
66075;2023;17;13;4;76.4705882352941;23.5294117647059;187464.411764706;3727.88235294118;51.8235294117647
66078;2023;3;3;0;100;0;129666.666666667;1832.33333333333;68.3333333333333
66079;2023;5;5;0;100;0;246174;2508.4;88
66080;2023;8;8;0;100;0;107999.375;1356.875;81.875
66081;2023;2;1;1;50;50;176700;2559.5;70
66082;2023;18;7;11;38.8888888888889;61.1111111111111;169334.055555556;2801.88888888889;66.5555555555556
66083;2023;2;1;1;50;50;48125;1220.5;37.5
66084;2023;25;25;0;100;0;207280.4;1948.12;104.16
66085;2023;1;1;0;100;0;144000;1075;134
66088;2023;94;79;15;84.0425531914894;15.9574468085106;140331.510638298;1646.79787234043;82.2340425531915
66089;2023;7;7;0;100;0;290976.428571429;2378;119.142857142857
66090;2023;1;1;0;100;0;28530;538;53
66091;2023;2;2;0;100;0;122500;1520.5;81.5
66092;2023;3;3;0;100;0;167166.666666667;1398;113.333333333333
66093;2023;47;45;2;95.7446808510638;4.25531914893617;330312.340425532;3339.85106382979;100.468085106383
66094;2023;30;27;3;90;10;323631.7;3124.7;102.7
66095;2023;13;6;7;46.1538461538462;53.8461538461538;179487;2721.84615384615;74.3076923076923
66096;2023;17;16;1;94.1176470588235;5.88235294117647;87457.0588235294;1283.17647058824;70.8235294117647
66097;2023;2;2;0;100;0;300375;2581.5;110.5
66098;2023;4;0;4;0;100;101912.5;2448.25;43.5
66099;2023;4;4;0;100;0;274375;3481;77.5
66100;2023;3;3;0;100;0;204933.333333333;1971.66666666667;86
66101;2023;23;21;2;91.304347826087;8.69565217391304;276356.869565217;2509.86956521739;108.782608695652
66103;2023;9;9;0;100;0;131660.555555556;1636.44444444444;82
66104;2023;14;14;0;100;0;195275.357142857;2176.35714285714;89.5
66105;2023;7;6;1;85.7142857142857;14.2857142857143;229148.571428571;3577.57142857143;67.4285714285714
66106;2023;42;36;6;85.7142857142857;14.2857142857143;228913.761904762;2539.80952380952;92.6190476190476
66107;2023;18;17;1;94.4444444444444;5.55555555555556;113504.444444444;1258.83333333333;96.2777777777778
66108;2023;50;48;2;96;4;164786.6;1950.56;82.9
66109;2023;6;5;1;83.3333333333333;16.6666666666667;124190;1531.83333333333;87.5
66111;2023;1;1;0;100;0;154200;2659;58
66112;2023;4;4;0;100;0;236918.75;2692.25;92.5
66113;2023;6;6;0;100;0;269833.333333333;2255.66666666667;137.666666666667
66114;2023;17;15;2;88.2352941176471;11.7647058823529;243482.352941176;2553.47058823529;92.3529411764706
66115;2023;32;30;2;93.75;6.25;333945.3125;3096.75;109.34375
66116;2023;1;1;0;100;0;314976;2863;110
66117;2023;3;0;3;0;100;94833.3333333333;1991;49.3333333333333
66118;2023;8;8;0;100;0;129184.375;1614.875;71.75
66119;2023;6;6;0;100;0;81045.8333333333;1624;52.8333333333333
66120;2023;3;1;2;33.3333333333333;66.6666666666667;240350;2616.66666666667;95.3333333333333
66121;2023;17;16;1;94.1176470588235;5.88235294117647;190729.117647059;2136.64705882353;85.8235294117647
66122;2023;3;3;0;100;0;127433.333333333;2258.66666666667;78.3333333333333
66123;2023;1;1;0;100;0;230000;2277;101
66124;2023;199;27;172;13.5678391959799;86.4321608040201;149743.793969849;3222.73366834171;45.0904522613065
66125;2023;10;9;1;90;10;78551.5;1130.7;73.2
66126;2023;6;6;0;100;0;186476.666666667;2319.66666666667;75.1666666666667
66127;2023;16;15;1;93.75;6.25;156676;2037.4375;83.0625
66128;2023;4;4;0;100;0;70162.5;1102;63.75
66129;2023;27;24;3;88.8888888888889;11.1111111111111;238987.740740741;2670.62962962963;91.1111111111111
66130;2023;42;11;31;26.1904761904762;73.8095238095238;156450;2856.04761904762;57.5714285714286
66132;2023;15;13;2;86.6666666666667;13.3333333333333;268113.333333333;3758.53333333333;80.2666666666667
66133;2023;32;29;3;90.625;9.375;232517.84375;2639.3125;87.25
66134;2023;11;11;0;100;0;159840.090909091;1693.09090909091;95.4545454545455
66136;2023;2280;536;1744;23.5087719298246;76.4912280701754;133684.170614035;1834.81842105263;72.0614035087719
66137;2023;6;4;2;66.6666666666667;33.3333333333333;114041.666666667;1520.83333333333;83.3333333333333
66138;2023;30;26;4;86.6666666666667;13.3333333333333;174319.733333333;2184.66666666667;78.9333333333333
66139;2023;3;3;0;100;0;93333.3333333333;1084.66666666667;85.3333333333333
66140;2023;45;43;2;95.5555555555556;4.44444444444444;203021.222222222;2516.82222222222;84.4666666666667
66141;2023;126;119;7;94.4444444444444;5.55555555555556;226869.69047619;2429.07936507937;91.6428571428571
66142;2023;4;3;1;75;25;178820;2205.5;79.5
66143;2023;2;2;0;100;0;62750;1090;62
66144;2023;67;63;4;94.0298507462687;5.97014925373134;245456.149253731;2532.16417910448;95.9701492537313
66145;2023;36;36;0;100;0;238544.444444444;2568.05555555556;95.5
66146;2023;2;1;1;50;50;209570;2372.5;76
66147;2023;11;0;11;0;100;100196.818181818;2365.09090909091;43.4545454545455
66148;2023;99;19;80;19.1919191919192;80.8080808080808;217784.848484848;3198.18181818182;65.2828282828283
66149;2023;119;73;46;61.3445378151261;38.655462184874;136419.537815126;1638.21008403361;82.6386554621849
66150;2023;30;13;17;43.3333333333333;56.6666666666667;104160.166666667;1799.76666666667;69.2
66153;2023;2;2;0;100;0;52000;1044.5;57
66154;2023;23;17;6;73.9130434782609;26.0869565217391;111507.391304348;3176.34782608696;45.9130434782609
66155;2023;4;4;0;100;0;91500;1390;68.25
66156;2023;1;1;0;100;0;48000;960;50
66158;2023;2;2;0;100;0;103052.5;1644;66
66159;2023;3;3;0;100;0;130600;2117.66666666667;72
66160;2023;16;16;0;100;0;331473.25;3136.4375;105.9375
66161;2023;22;22;0;100;0;154710.272727273;1624.45454545455;89.2272727272727
66162;2023;5;5;0;100;0;254710;2442.6;102.6
66164;2023;63;58;5;92.0634920634921;7.93650793650794;198962.888888889;2172.66666666667;90.8253968253968
66165;2023;13;12;1;92.3076923076923;7.69230769230769;136165.307692308;1596.07692307692;81.6153846153846
66166;2023;7;6;1;85.7142857142857;14.2857142857143;85771.4285714286;1364.14285714286;66
66167;2023;34;16;18;47.0588235294118;52.9411764705882;184976.970588235;2898.97058823529;67.4411764705882
66168;2023;76;68;8;89.4736842105263;10.5263157894737;265965.236842105;2899.39473684211;90.1315789473684
66169;2023;3;3;0;100;0;145865;1310;102.666666666667
66171;2023;603;244;359;40.4643449419569;59.5356550580431;188606.205638474;4082.07960199005;49.4908789386401
66172;2023;145;91;54;62.7586206896552;37.2413793103448;210768.813793103;2430.92413793103;83.2827586206896
66173;2023;18;18;0;100;0;203015.388888889;2320.77777777778;85.6111111111111
66174;2023;38;35;3;92.1052631578947;7.89473684210526;205081.578947368;2223.71052631579;88.6052631578947
66175;2023;47;43;4;91.4893617021277;8.51063829787234;257556.382978723;2939.17021276596;89.2553191489362
66176;2023;38;37;1;97.3684210526316;2.63157894736842;191974.473684211;2136.71052631579;85.0263157894737
66177;2023;16;15;1;93.75;6.25;235449.4375;2464.9375;94.5625
66178;2023;30;25;5;83.3333333333333;16.6666666666667;213629.1;2509.7;84.0666666666667
66179;2023;27;22;5;81.4814814814815;18.5185185185185;121885.185185185;1405.25925925926;85.5555555555556
66180;2023;180;140;40;77.7777777777778;22.2222222222222;181379.077777778;2276.12222222222;78.3333333333333
66181;2023;17;8;9;47.0588235294118;52.9411764705882;267064.705882353;4219.58823529412;62
66182;2023;140;110;30;78.5714285714286;21.4285714285714;203419.7;3593.34285714286;60.3285714285714
66183;2023;3;3;0;100;0;121000;1409.33333333333;83
66184;2023;3;3;0;100;0;49333.3333333333;888.666666666667;61.6666666666667
66185;2023;5;5;0;100;0;182400;1910;83.8
66186;2023;40;38;2;95;5;237047.75;2495.625;94.125
66187;2023;30;27;3;90;10;113404;1189.9;91.4
66188;2023;17;8;9;47.0588235294118;52.9411764705882;220863.058823529;3888.70588235294;60.8235294117647
66189;2023;63;46;17;73.015873015873;26.984126984127;257064.111111111;2619.77777777778;94.1111111111111
66190;2023;50;48;2;96;4;169944.84;2290.68;76.08
66191;2023;1;1;0;100;0;25000;625;40
66192;2023;7;5;2;71.4285714285714;28.5714285714286;120167.142857143;1923.42857142857;65.8571428571429
66193;2023;9;8;1;88.8888888888889;11.1111111111111;87807.7777777778;1047.44444444444;87.4444444444444
66194;2023;4;4;0;100;0;173750;1303;119.25
66195;2023;96;88;8;91.6666666666667;8.33333333333333;231216.895833333;2563.44791666667;91.0833333333333
66196;2023;64;59;5;92.1875;7.8125;287110.921875;3251.015625;88.5625
66198;2023;5;4;1;80;20;136400;1639;76.8
66199;2023;4;4;0;100;0;332980;2620;130.5
66202;2023;5;2;3;40;60;200530;2938.6;58.6
66203;2023;1;1;0;100;0;71500;794;90
66204;2023;3;3;0;100;0;125843.333333333;1103.33333333333;111
66205;2023;16;16;0;100;0;153569.6875;2075.5;74.5625
66206;2023;2;2;0;100;0;62985;881.5;70.5
66207;2023;13;11;2;84.6153846153846;15.3846153846154;171640.769230769;1800.30769230769;108.307692307692
66208;2023;20;15;5;75;25;233975.75;2461.45;93.6
66210;2023;105;86;19;81.9047619047619;18.0952380952381;205114.80952381;2410.12380952381;85.9238095238095
66211;2023;3;3;0;100;0;342000;3217.66666666667;107
66212;2023;84;74;10;88.0952380952381;11.9047619047619;196984.345238095;3166.5;66.0357142857143
66213;2023;84;80;4;95.2380952380952;4.76190476190476;255933.238095238;2591.59523809524;99.4642857142857
66214;2023;24;22;2;91.6666666666667;8.33333333333333;238400.708333333;2621.08333333333;96.5
66215;2023;3;3;0;100;0;150966.666666667;1531.33333333333;97.6666666666667
66216;2023;2;2;0;100;0;57000;1370;57.5
66217;2023;40;34;6;85;15;175432.75;1992.7;88.5
66218;2023;10;6;4;60;40;244468;2555.6;97.1
66219;2023;2;2;0;100;0;87700;1540.5;57
66220;2023;2;2;0;100;0;138575;2238.5;62.5
66221;2023;1;0;1;0;100;33000;402;82
66222;2023;71;21;50;29.5774647887324;70.4225352112676;97948.8732394366;1533.64788732394;61.9577464788732
66223;2023;7;7;0;100;0;88214.2857142857;1563.28571428571;63.1428571428571
66224;2023;38;36;2;94.7368421052632;5.26315789473684;206738.421052632;2122.5;94.8157894736842
66225;2023;30;26;4;86.6666666666667;13.3333333333333;285908.233333333;3168.83333333333;90.9666666666667
66226;2023;16;16;0;100;0;248834.875;2627.1875;95.9375
66227;2023;37;31;6;83.7837837837838;16.2162162162162;348358.243243243;3011.56756756757;113.297297297297
66228;2023;12;12;0;100;0;188031.75;2113.5;84.9166666666667
66230;2023;40;38;2;95;5;152829.125;1713.975;84.675
66231;2023;7;7;0;100;0;191022.857142857;2113.28571428571;89.5714285714286
66232;2023;2;2;0;100;0;50000;622.5;77.5
66233;2023;2;2;0;100;0;529500;4260;129.5
66234;2023;2;2;0;100;0;76800;749;90
69001;2023;1;1;0;100;0;353000;2577;137
69002;2023;3;3;0;100;0;104166.666666667;1287.33333333333;83.3333333333333
69003;2023;25;13;12;52;48;331988;3951.44;85.32
69004;2023;5;5;0;100;0;295988;3829.6;92.8
69005;2023;6;5;1;83.3333333333333;16.6666666666667;309116.666666667;3300.83333333333;94.8333333333333
69006;2023;38;26;12;68.4210526315789;31.5789473684211;138239.105263158;1531.57894736842;96.5789473684211
69007;2023;12;8;4;66.6666666666667;33.3333333333333;246563.333333333;2684.5;93.3333333333333
69008;2023;5;5;0;100;0;356904;2908.2;127
69009;2023;66;44;22;66.6666666666667;33.3333333333333;327372.378787879;3382.4696969697;99.2878787878788
69010;2023;74;25;49;33.7837837837838;66.2162162162162;231872.878378378;2856.87837837838;81.0675675675676
69012;2023;5;5;0;100;0;284640;2054.2;137.2
69013;2023;41;31;10;75.609756097561;24.390243902439;324549.634146341;3221.85365853659;99.8048780487805
69014;2023;5;5;0;100;0;198000;1903.8;106.8
69016;2023;2;2;0;100;0;281500;3728;74.5
69017;2023;3;3;0;100;0;250333.333333333;2667.66666666667;98
69018;2023;24;20;4;83.3333333333333;16.6666666666667;140990.958333333;1635.20833333333;91.1666666666667
69019;2023;143;68;75;47.5524475524476;52.4475524475524;213155.923076923;2628.3006993007;81.2517482517483
69020;2023;3;0;3;0;100;240900;3137;78
69021;2023;13;12;1;92.3076923076923;7.69230769230769;268512.846153846;2411.38461538462;111.769230769231
69022;2023;3;3;0;100;0;172666.666666667;1940;82.6666666666667
69023;2023;11;11;0;100;0;321433.181818182;3091.09090909091;110.363636363636
69024;2023;43;30;13;69.7674418604651;30.2325581395349;341381.534883721;3423.13953488372;101.116279069767
69026;2023;6;6;0;100;0;387653.333333333;3138.66666666667;114.666666666667
69027;2023;104;48;56;46.1538461538462;53.8461538461538;358804.990384615;4235.66346153846;84.1634615384615
69028;2023;49;36;13;73.469387755102;26.530612244898;519657.346938776;4626.55102040816;108.020408163265
69029;2023;451;75;376;16.629711751663;83.370288248337;240577.962305987;3362.29490022173;71.3880266075388
69030;2023;5;5;0;100;0;311510;2243.4;139.2
69031;2023;10;10;0;100;0;241008;2678.2;92.7
69032;2023;23;20;3;86.9565217391304;13.0434782608696;327204.565217391;4125.4347826087;98.9130434782609
69033;2023;26;25;1;96.1538461538462;3.84615384615385;559818.846153846;4590.96153846154;125.153846153846
69034;2023;524;56;468;10.6870229007634;89.3129770992366;352895.091603053;4472.23664122137;77.3797709923664
69035;2023;5;5;0;100;0;215880;1861.6;118.6
69036;2023;4;4;0;100;0;251405;3107.25;86.5
69037;2023;9;9;0;100;0;190428.333333333;2488.55555555556;78.4444444444444
69038;2023;7;7;0;100;0;135628.571428571;1310.71428571429;105.857142857143
69039;2023;4;4;0;100;0;190011.25;2087;94.25
69040;2023;85;21;64;24.7058823529412;75.2941176470588;366653.023529412;4621.57647058824;76.8823529411765
69042;2023;3;3;0;100;0;174333.333333333;2064.33333333333;85
69043;2023;77;47;30;61.038961038961;38.961038961039;432853.766233766;4645.93506493507;95.4675324675325
69044;2023;57;26;31;45.6140350877193;54.3859649122807;561190.877192982;4954.38596491228;108.684210526316
69045;2023;7;5;2;71.4285714285714;28.5714285714286;184207.142857143;2764;67
69046;2023;39;29;10;74.3589743589744;25.6410256410256;489008.358974359;4373.17948717949;113.230769230769
69047;2023;5;4;1;80;20;278178;3321.6;84.4
69049;2023;28;19;9;67.8571428571429;32.1428571428571;359541.392857143;3814.67857142857;99.8928571428571
69050;2023;32;26;6;81.25;18.75;371469.1875;3673.21875;102.3125
69051;2023;8;7;1;87.5;12.5;394615.625;3137.625;122.25
69052;2023;47;35;12;74.468085106383;25.531914893617;451894.191489362;3973.1914893617;112.234042553191
69053;2023;4;4;0;100;0;263895;2309.25;120.25
69054;2023;7;7;0;100;0;175007.142857143;1845.85714285714;96.5714285714286
69055;2023;13;9;4;69.2307692307692;30.7692307692308;301067.846153846;2831.69230769231;103.615384615385
69056;2023;18;14;4;77.7777777777778;22.2222222222222;329620.555555556;3546.72222222222;92.7222222222222
69057;2023;1;1;0;100;0;240000;3380;71
69058;2023;5;5;0;100;0;250000;2100;120
69059;2023;16;11;5;68.75;31.25;355126.75;3778.5;94.875
69060;2023;6;6;0;100;0;167650;1813.66666666667;100
69061;2023;7;7;0;100;0;353575.714285714;3872.42857142857;93.1428571428571
69062;2023;2;2;0;100;0;235160;2608;88.5
69063;2023;56;26;30;46.4285714285714;53.5714285714286;473477.839285714;5008.23214285714;94.375
69064;2023;45;22;23;48.8888888888889;51.1111111111111;213848.555555556;2743.31111111111;77.5777777777778
69065;2023;12;11;1;91.6666666666667;8.33333333333333;304592.083333333;2775.16666666667;111.75
69066;2023;43;38;5;88.3720930232558;11.6279069767442;136154.720930233;1496.6511627907;93.4883720930233
69067;2023;7;6;1;85.7142857142857;14.2857142857143;237428.571428571;2050.85714285714;94.5714285714286
69068;2023;27;17;10;62.962962962963;37.037037037037;354375.148148148;3982.40740740741;85.9259259259259
69069;2023;130;50;80;38.4615384615385;61.5384615384615;396227;4654.2;84.7230769230769
69070;2023;12;12;0;100;0;159708.333333333;1556.25;94.25
69071;2023;12;8;4;66.6666666666667;33.3333333333333;410057.083333333;4021.08333333333;98.6666666666667
69072;2023;66;43;23;65.1515151515152;34.8484848484849;518049.181818182;4813.10606060606;108.212121212121
69074;2023;13;9;4;69.2307692307692;30.7692307692308;258012.692307692;2621;112.076923076923
69075;2023;2;2;0;100;0;367500;2057.5;190
69076;2023;21;19;2;90.4761904761905;9.52380952380952;570042.619047619;4884.2380952381;125.761904761905
69077;2023;14;13;1;92.8571428571429;7.14285714285714;303597.857142857;2940.71428571429;107.214285714286
69078;2023;10;9;1;90;10;284759.4;2461.2;118
69080;2023;17;12;5;70.5882352941177;29.4117647058824;288094.117647059;3063.35294117647;97.2941176470588
69081;2023;140;36;104;25.7142857142857;74.2857142857143;490535.714285714;4958.69285714286;94.5571428571429
69082;2023;3;3;0;100;0;388100;2817.66666666667;147
69083;2023;12;11;1;91.6666666666667;8.33333333333333;375942.083333333;3509.83333333333;106.166666666667
69084;2023;13;12;1;92.3076923076923;7.69230769230769;263276.153846154;2715.61538461538;101.923076923077
69085;2023;12;9;3;75;25;433361.333333333;4612.41666666667;94.9166666666667
69086;2023;28;14;14;50;50;324217.928571429;3536.53571428571;89.9285714285714
69087;2023;35;20;15;57.1428571428571;42.8571428571429;454103.857142857;4219.71428571429;105.457142857143
69088;2023;99;15;84;15.1515151515152;84.8484848484848;322113.181818182;3967.19191919192;78.1717171717172
69089;2023;182;61;121;33.5164835164835;66.4835164835165;360313.472527473;4233.81318681319;84.532967032967
69090;2023;8;7;1;87.5;12.5;313581.25;3076.75;102.75
69091;2023;159;62;97;38.9937106918239;61.0062893081761;177408.465408805;2403.04402515723;74.3459119496855
69092;2023;85;45;40;52.9411764705882;47.0588235294118;285629.341176471;3037.16470588235;89.9647058823529
69093;2023;18;15;3;83.3333333333333;16.6666666666667;132925;1427.94444444444;92.7222222222222
69094;2023;65;36;29;55.3846153846154;44.6153846153846;378908.046153846;4193.12307692308;89.3538461538461
69095;2023;4;4;0;100;0;283893.75;2946;98.5
69096;2023;107;48;59;44.8598130841121;55.1401869158878;221621.691588785;2734.47663551402;80.588785046729
69097;2023;3;3;0;100;0;340283.333333333;3416.33333333333;111.333333333333
69098;2023;2;2;0;100;0;225950;2283;101
69099;2023;12;12;0;100;0;242183.333333333;1901.58333333333;132.5
69100;2023;84;36;48;42.8571428571429;57.1428571428571;336701.44047619;3981.92857142857;84.3095238095238
69102;2023;7;7;0;100;0;171607.142857143;1800.14285714286;95.4285714285714
69103;2023;7;7;0;100;0;218371.428571429;2492.14285714286;97.8571428571429
69104;2023;4;4;0;100;0;182300;2054.75;97.75
69105;2023;10;8;2;80;20;357783;3426.3;102.5
69106;2023;12;11;1;91.6666666666667;8.33333333333333;439154;3164.33333333333;137.333333333333
69107;2023;9;7;2;77.7777777777778;22.2222222222222;145388.222222222;1507.77777777778;93.1111111111111
69108;2023;16;16;0;100;0;249176.875;2506.125;105.875
69109;2023;6;6;0;100;0;262833.333333333;2017.66666666667;141
69110;2023;12;12;0;100;0;178410.416666667;2133.08333333333;86.25
69111;2023;8;6;2;75;25;314187.5;2973.5;105
69112;2023;59;31;28;52.5423728813559;47.4576271186441;424576.254237288;4449.69491525424;95.9152542372881
69113;2023;13;11;2;84.6153846153846;15.3846153846154;278861.692307692;2352.53846153846;120.769230769231
69115;2023;56;28;28;50;50;290781.464285714;3134.92857142857;89.9285714285714
69116;2023;44;32;12;72.7272727272727;27.2727272727273;662857.272727273;5846.72727272727;114.75
69117;2023;19;15;4;78.9473684210526;21.0526315789474;488777.789473684;4314.36842105263;111.631578947368
69118;2023;20;14;6;70;30;216157.4;2727.75;82.1
69119;2023;9;9;0;100;0;225005.555555556;2375.55555555556;94.5555555555556
69120;2023;6;6;0;100;0;210450;2289.83333333333;94.1666666666667
69121;2023;34;19;15;55.8823529411765;44.1176470588235;330857.852941176;3950.64705882353;84.5882352941177
69122;2023;18;14;4;77.7777777777778;22.2222222222222;487187.222222222;4060;117
69123;2023;6455;155;6300;2.4012393493416;97.5987606506584;310717.250813323;4888.27079783114;63.9490317583269
69124;2023;3;3;0;100;0;228600;1702.33333333333;125
69125;2023;10;9;1;90;10;627498;4711.1;136.4
69126;2023;5;1;4;20;80;417834;3163.6;132.4
69127;2023;24;11;13;45.8333333333333;54.1666666666667;459922.583333333;5364.375;88.0833333333333
69130;2023;6;6;0;100;0;101842.333333333;1679.16666666667;74
69131;2023;13;11;2;84.6153846153846;15.3846153846154;404273.153846154;3964;105.230769230769
69132;2023;2;2;0;100;0;165000;1840;86.5
69133;2023;33;20;13;60.6060606060606;39.3939393939394;353308.181818182;4043.12121212121;89.1515151515152
69134;2023;1;1;0;100;0;875110;9212;95
69135;2023;25;24;1;96;4;163482.6;1613.04;101.64
69136;2023;25;23;2;92;8;411371.28;4266.12;100.32
69137;2023;4;3;1;75;25;360668.5;2880.5;123.75
69138;2023;1;1;0;100;0;1,00E+05;1250;80
69139;2023;10;10;0;100;0;176365;1797.9;96.8
69140;2023;19;17;2;89.4736842105263;10.5263157894737;444120.368421053;4238.47368421053;106.263157894737
69141;2023;57;31;26;54.3859649122807;45.6140350877193;331912.719298246;3864.94736842105;87.8245614035088
69142;2023;72;3;69;4.16666666666667;95.8333333333333;230339.861111111;3432.61111111111;66.1111111111111
69143;2023;99;22;77;22.2222222222222;77.7777777777778;283748.878787879;3862.07070707071;73.3838383838384
69145;2023;6;6;0;100;0;391141.666666667;2709.83333333333;145.5
69148;2023;28;20;8;71.4285714285714;28.5714285714286;338924.785714286;3691.82142857143;92.8214285714286
69149;2023;341;57;284;16.7155425219941;83.2844574780059;276620.653958944;3922.01173020528;69.2492668621701
69151;2023;21;15;6;71.4285714285714;28.5714285714286;227325.714285714;2270.14285714286;97.5714285714286
69152;2023;111;31;80;27.9279279279279;72.0720720720721;229638.387387387;3425.7027027027;68.6756756756757
69153;2023;10;10;0;100;0;596652;5302.9;118.5
69154;2023;25;12;13;48;52;398449.48;4458.84;88.4
69155;2023;4;4;0;100;0;266850;2810.5;94.25
69156;2023;26;25;1;96.1538461538462;3.84615384615385;535835.884615385;4137.73076923077;134
69157;2023;46;40;6;86.9565217391304;13.0434782608696;302782.173913043;3130.69565217391;102.108695652174
69159;2023;57;41;16;71.9298245614035;28.0701754385965;362075.701754386;3475.15789473684;101.824561403509
69160;2023;17;16;1;94.1176470588235;5.88235294117647;205091.764705882;1536.70588235294;135.529411764706
69161;2023;5;5;0;100;0;161170;1498;114
69162;2023;12;12;0;100;0;228127.833333333;2108;109.666666666667
69163;2023;28;22;6;78.5714285714286;21.4285714285714;373289.285714286;3697.75;103.5
69164;2023;7;7;0;100;0;117485.714285714;879.571428571429;130.571428571429
69165;2023;10;10;0;100;0;254265;2348.2;106.4
69166;2023;5;5;0;100;0;235108;3181.4;76.8
69168;2023;16;13;3;81.25;18.75;516133.125;4813.8125;105.1875
69169;2023;2;2;0;100;0;195000;1055.5;165
69170;2023;9;9;0;100;0;386217.777777778;3706.66666666667;102.444444444444
69171;2023;27;21;6;77.7777777777778;22.2222222222222;269447.925925926;2891.03703703704;94.5185185185185
69172;2023;8;7;1;87.5;12.5;256256.25;2430.75;100.5
69173;2023;13;11;2;84.6153846153846;15.3846153846154;265993.846153846;2955.84615384615;98.8461538461538
69174;2023;5;5;0;100;0;216506;2234.8;99.6
69175;2023;20;19;1;95;5;333158.7;3070.55;106.35
69176;2023;45;28;17;62.2222222222222;37.7777777777778;341770;3899.73333333333;90.6
69177;2023;16;14;2;87.5;12.5;313241.0625;3048.3125;105.9375
69178;2023;3;2;1;66.6666666666667;33.3333333333333;190030;1779.33333333333;99
69179;2023;34;33;1;97.0588235294118;2.94117647058824;362287.352941176;3536.41176470588;102.558823529412
69180;2023;2;2;0;100;0;264562.5;2041;129
69182;2023;3;3;0;100;0;204208.666666667;2163;92.3333333333333
69183;2023;9;9;0;100;0;151522.222222222;1265.44444444444;117.888888888889
69184;2023;8;7;1;87.5;12.5;243060.375;2477.625;105.125
69186;2023;2;2;0;100;0;130000;2003;65
69188;2023;11;10;1;90.9090909090909;9.09090909090909;182085.454545455;2111.72727272727;82.4545454545455
69189;2023;33;7;26;21.2121212121212;78.7878787878788;290762.878787879;3264.87878787879;88.5757575757576
69190;2023;13;8;5;61.5384615384615;38.4615384615385;534135.923076923;4329.76923076923;127.153846153846
69191;2023;62;46;16;74.1935483870968;25.8064516129032;810498.903225806;6364.09677419355;128.693548387097
69192;2023;1;1;0;100;0;162540;991;164
69193;2023;8;8;0;100;0;389248.75;3224.25;130.875
69194;2023;62;39;23;62.9032258064516;37.0967741935484;871955.467741936;6731.33870967742;123.951612903226
69196;2023;4;4;0;100;0;280950;2123.5;131.75
69197;2023;19;15;4;78.9473684210526;21.0526315789474;285632.631578947;2809.15789473684;101.947368421053
69198;2023;6;6;0;100;0;238500;2266.16666666667;105.5
69199;2023;135;29;106;21.4814814814815;78.5185185185185;173186.859259259;2522.88148148148;67.8888888888889
69200;2023;17;16;1;94.1176470588235;5.88235294117647;302519.411764706;2921.88235294118;102.235294117647
69201;2023;18;8;10;44.4444444444444;55.5555555555556;152993.833333333;3024.22222222222;67.3888888888889
69202;2023;249;58;191;23.2931726907631;76.7068273092369;393228.104417671;4323.55020080321;87.6265060240964
69203;2023;10;7;3;70;30;180215;1969.1;88
69204;2023;203;59;144;29.064039408867;70.935960591133;330610.009852217;4178.70443349754;78.4729064039409
69205;2023;38;32;6;84.2105263157895;15.7894736842105;489930.526315789;4790.28947368421;102.736842105263
69206;2023;34;27;7;79.4117647058823;20.5882352941176;324680.264705882;2764.17647058824;112.558823529412
69207;2023;25;11;14;44;56;378425.16;3657.48;98.32
69208;2023;18;15;3;83.3333333333333;16.6666666666667;389931.611111111;3453.27777777778;119.722222222222
69209;2023;10;10;0;100;0;190996;1760.3;112.3
69212;2023;5;4;1;80;20;514594;4360.2;124.4
69214;2023;9;9;0;100;0;200750;1974.77777777778;102
69215;2023;9;9;0;100;0;429601.666666667;2845.22222222222;147.888888888889
69216;2023;4;4;0;100;0;289556.5;3271.5;113.5
69217;2023;9;9;0;100;0;143164.555555556;1439.44444444444;98.5555555555556
69218;2023;6;4;2;66.6666666666667;33.3333333333333;232541.666666667;3120.83333333333;72.1666666666667
69219;2023;22;18;4;81.8181818181818;18.1818181818182;404565;4088.36363636364;101.136363636364
69220;2023;35;17;18;48.5714285714286;51.4285714285714;142188.8;1887.48571428571;74.7714285714286
69225;2023;4;4;0;100;0;324590;2746;116.25
69227;2023;37;31;6;83.7837837837838;16.2162162162162;283561.891891892;2835.37837837838;101.918918918919
69228;2023;41;34;7;82.9268292682927;17.0731707317073;287574.829268293;3106.34146341463;94.1707317073171
69229;2023;7;7;0;100;0;131882.857142857;1336.57142857143;98.8571428571429
69231;2023;15;11;4;73.3333333333333;26.6666666666667;316582;2992.6;107.866666666667
69233;2023;11;7;4;63.6363636363636;36.3636363636364;562634.090909091;5765.63636363636;101.272727272727
69234;2023;13;13;0;100;0;345830;2900.23076923077;120.076923076923
69235;2023;30;8;22;26.6666666666667;73.3333333333333;260630.3;3253.76666666667;79.3
69236;2023;5;5;0;100;0;291740;2693.8;105.4
69238;2023;46;34;12;73.9130434782609;26.0869565217391;230936.630434783;2395.41304347826;93.6086956521739
69239;2023;16;16;0;100;0;292678.125;3217.5625;91.0625
69240;2023;6;5;1;83.3333333333333;16.6666666666667;148500;1949.83333333333;83.1666666666667
69241;2023;26;17;9;65.3846153846154;34.6153846153846;427690.730769231;4308.34615384615;107
69242;2023;9;8;1;88.8888888888889;11.1111111111111;211353.888888889;2337;93.7777777777778
69243;2023;128;29;99;22.65625;77.34375;147925.5390625;1834.8984375;81.0703125
69244;2023;291;45;246;15.4639175257732;84.5360824742268;373586.037800687;4657.21993127148;77.4158075601375
69245;2023;12;10;2;83.3333333333333;16.6666666666667;313062.083333333;3882.08333333333;79.8333333333333
69246;2023;7;7;0;100;0;395241.428571429;4154.42857142857;97.7142857142857
69248;2023;68;52;16;76.4705882352941;23.5294117647059;138576.044117647;1550.26470588235;93.8088235294118
69249;2023;33;25;8;75.7575757575758;24.2424242424242;330771.303030303;3855.30303030303;85.6060606060606
69250;2023;50;27;23;54;46;452137.82;4751.44;94.62
69252;2023;5;4;1;80;20;210000;2915;78.6
69253;2023;2;2;0;100;0;750000;4142;178.5
69254;2023;9;8;1;88.8888888888889;11.1111111111111;237026.666666667;2735.33333333333;92
69255;2023;43;30;13;69.7674418604651;30.2325581395349;360102.395348837;3943.62790697674;93.9069767441861
69256;2023;322;76;246;23.6024844720497;76.3975155279503;210173.158385093;3128.67391304348;67.527950310559
69257;2023;12;11;1;91.6666666666667;8.33333333333333;299275.416666667;2674.83333333333;119.416666666667
69258;2023;3;3;0;100;0;105333.333333333;1364;74.6666666666667
69259;2023;431;63;368;14.6171693735499;85.3828306264501;208852.807424594;3187.90719257541;66.6357308584687
69260;2023;34;16;18;47.0588235294118;52.9411764705882;386494.735294118;3945.11764705882;92.5
69263;2023;16;16;0;100;0;146645.625;1915.375;76.375
69264;2023;504;77;427;15.2777777777778;84.7222222222222;195227.174603175;2696.05555555556;72.8531746031746
69265;2023;7;7;0;100;0;397485.714285714;2844.14285714286;130.428571428571
69266;2023;1944;99;1845;5.09259259259259;94.9074074074074;233798.935185185;3883.51131687243;61.7530864197531
69267;2023;16;16;0;100;0;261216.5625;2761.25;99.1875
69268;2023;32;17;15;53.125;46.875;477489.0625;4726;99.15625
69269;2023;13;11;2;84.6153846153846;15.3846153846154;244723.461538462;2879;86.7692307692308
69270;2023;34;25;9;73.5294117647059;26.4705882352941;485932.617647059;4262.55882352941;118.058823529412
69271;2023;87;56;31;64.367816091954;35.632183908046;416040.183908046;4533.32183908046;93.0114942528736
69272;2023;25;24;1;96;4;399934.2;3963.12;102.04
69273;2023;92;46;46;50;50;276779.684782609;3453;79.4891304347826
69275;2023;289;73;216;25.2595155709343;74.7404844290657;256590.802768166;3599.52249134948;71.1764705882353
69276;2023;74;38;36;51.3513513513513;48.6486486486487;261552.702702703;3162.78378378378;84.3513513513514
69277;2023;117;86;31;73.5042735042735;26.4957264957265;501516.794871795;4981.13675213675;103.34188034188
69278;2023;41;21;20;51.219512195122;48.780487804878;387828.536585366;3704.48780487805;103.09756097561
69279;2023;38;33;5;86.8421052631579;13.1578947368421;428405;4371.42105263158;101.078947368421
69280;2023;9;6;3;66.6666666666667;33.3333333333333;278255.555555556;3374.11111111111;83.6666666666667
69281;2023;13;7;6;53.8461538461538;46.1538461538462;379657.692307692;3563.46153846154;107.230769230769
69282;2023;289;139;150;48.0968858131488;51.9031141868512;308318.183391003;3991.1384083045;77.8754325259516
69283;2023;105;68;37;64.7619047619048;35.2380952380952;343319.171428571;4103;83.3904761904762
69284;2023;29;25;4;86.2068965517241;13.7931034482759;431109.965517241;4539.68965517241;95.448275862069
69285;2023;19;17;2;89.4736842105263;10.5263157894737;392218.789473684;4246.84210526316;91.8947368421053
69286;2023;186;53;133;28.494623655914;71.505376344086;281974.569892473;3376.61290322581;85.0967741935484
69287;2023;59;41;18;69.4915254237288;30.5084745762712;394011.13559322;4247.08474576271;93.8983050847458
69288;2023;56;38;18;67.8571428571429;32.1428571428571;351206.267857143;3902.28571428571;92.5357142857143
69289;2023;23;17;6;73.9130434782609;26.0869565217391;367326.956521739;4059.78260869565;92.2173913043478
69290;2023;495;111;384;22.4242424242424;77.5757575757576;234645.064646465;3166.80202020202;74.4363636363636
69291;2023;54;22;32;40.7407407407407;59.2592592592593;271240.277777778;3433.83333333333;79.1666666666667
69292;2023;46;9;37;19.5652173913043;80.4347826086957;303871.717391304;4237.5;72.0869565217391
69293;2023;13;6;7;46.1538461538462;53.8461538461538;332903.769230769;5017.38461538462;76.5384615384615
69294;2023;32;16;16;50;50;302712.0625;3820.34375;78.71875
69295;2023;10;6;4;60;40;366584;3678.9;109.4
69296;2023;31;25;6;80.6451612903226;19.3548387096774;439015.032258065;4131.93548387097;108.322580645161
69297;2023;47;36;11;76.5957446808511;23.4042553191489;368105.29787234;3921.76595744681;96.9574468085106
69298;2023;19;15;4;78.9473684210526;21.0526315789474;385987.157894737;3999.15789473684;97.0526315789474
69299;2023;23;22;1;95.6521739130435;4.34782608695652;395995.217391304;4236.78260869565;107.913043478261
70001;2023;3;3;0;100;0;155000;1398;116
70002;2023;1;1;0;100;0;30000;429;70
70003;2023;1;1;0;100;0;60000;714;84
70004;2023;2;2;0;100;0;123725;759;161
70006;2023;14;13;1;92.8571428571429;7.14285714285714;123872.857142857;1329.28571428571;98.3571428571429
70007;2023;3;3;0;100;0;112000;1126.33333333333;108.666666666667
70008;2023;3;3;0;100;0;110000;1044;118
70009;2023;1;1;0;100;0;37500;536;70
70011;2023;4;4;0;100;0;157250;1218.75;114
70012;2023;8;8;0;100;0;90490.625;777.375;120.625
70014;2023;2;2;0;100;0;180000;1970;86.5
70015;2023;4;4;0;100;0;103000;856.5;121.75
70016;2023;2;2;0;100;0;245000;1560;122
70017;2023;3;3;0;100;0;110666.666666667;923;132.333333333333
70018;2023;4;3;1;75;25;81750;954;80.75
70020;2023;5;5;0;100;0;137100;1459.4;92.8
70021;2023;1;1;0;100;0;238000;1983;120
70023;2023;4;4;0;100;0;87062.5;917;101.5
70024;2023;2;2;0;100;0;50550;463.5;109
70025;2023;3;3;0;100;0;104506.666666667;835;125.333333333333
70026;2023;30;27;3;90;10;125455.2;1250.36666666667;99.4
70028;2023;1;1;0;100;0;264000;1714;154
70031;2023;8;8;0;100;0;118156.25;1127.875;107.125
70032;2023;1;1;0;100;0;250325;1594;157
70035;2023;3;3;0;100;0;135833.333333333;1072.33333333333;141.666666666667
70036;2023;1;1;0;100;0;260000;2796;93
70037;2023;4;4;0;100;0;186825;1381.25;148.25
70038;2023;5;5;0;100;0;163416;1523.2;109
70039;2023;5;5;0;100;0;99304.4;1231.8;96.8
70040;2023;3;3;0;100;0;122166.666666667;1457.33333333333;88.3333333333333
70041;2023;6;6;0;100;0;130333.333333333;1009.66666666667;119.5
70042;2023;2;2;0;100;0;82750;676;110
70043;2023;1;1;0;100;0;60000;577;104
70044;2023;3;3;0;100;0;215133.333333333;2032.33333333333;107
70045;2023;2;2;0;100;0;207000;1311;177
70046;2023;3;3;0;100;0;136666.666666667;1539.33333333333;87.6666666666667
70047;2023;1;1;0;100;0;212000;1493;142
70049;2023;3;3;0;100;0;184188;1507.33333333333;110
70050;2023;1;1;0;100;0;285000;2209;129
70053;2023;1;1;0;100;0;156950;872;180
70054;2023;1;1;0;100;0;40000;727;55
70055;2023;5;5;0;100;0;154130;1703.6;91
70056;2023;4;4;0;100;0;105270;1210;91
70057;2023;3;3;0;100;0;127666.666666667;1504;82
70058;2023;8;7;1;87.5;12.5;160273.125;1305.5;129.875
70059;2023;7;7;0;100;0;163928.571428571;2040.85714285714;94.8571428571429
70060;2023;1;1;0;100;0;35000;583;60
70061;2023;4;4;0;100;0;98245.5;1515.75;62.75
70063;2023;3;3;0;100;0;109766.666666667;980.666666666667;134.666666666667
70064;2023;1;1;0;100;0;101600;1168;87
70065;2023;1;1;0;100;0;60000;577;104
70066;2023;2;2;0;100;0;116465;1177.5;99
70067;2023;2;2;0;100;0;219500;1682;144
70070;2023;2;2;0;100;0;58500;548;113.5
70074;2023;4;4;0;100;0;89145;862.25;102
70075;2023;1;1;0;100;0;212000;2409;88
70076;2023;2;2;0;100;0;144500;1467;97
70077;2023;1;1;0;100;0;127500;1062;120
70079;2023;6;6;0;100;0;179791.666666667;1622.66666666667;110.666666666667
70080;2023;3;3;0;100;0;102133.333333333;745.666666666667;124.333333333333
70081;2023;4;4;0;100;0;252075;2049.25;133.5
70082;2023;2;2;0;100;0;254500;1941;126
70083;2023;7;7;0;100;0;102771.428571429;1022.71428571429;102.571428571429
70084;2023;5;5;0;100;0;138696;1838.6;76.8
70085;2023;7;6;1;85.7142857142857;14.2857142857143;160738.571428571;1945.14285714286;82.1428571428571
70086;2023;1;1;0;100;0;77000;570;135
70087;2023;1;0;1;0;100;118750;1120;106
70088;2023;2;2;0;100;0;100610;766.5;121
70089;2023;3;3;0;100;0;95103.3333333333;837.333333333333;110
70090;2023;2;1;1;50;50;128900;1348;100
70091;2023;1;1;0;100;0;58000;725;80
70092;2023;2;2;0;100;0;78000;975;80.5
70093;2023;8;8;0;100;0;101596.125;1080.25;94.375
70094;2023;1;1;0;100;0;75000;625;120
70095;2023;8;8;0;100;0;142925;1239;118.125
70096;2023;6;6;0;100;0;141358.333333333;1645.33333333333;90.8333333333333
70097;2023;1;1;0;100;0;138830;1297;107
70098;2023;1;1;0;100;0;62000;816;76
70099;2023;1;1;0;100;0;82000;837;98
70100;2023;1;1;0;100;0;110000;1078;102
70101;2023;3;3;0;100;0;79000;666.333333333333;115
70102;2023;2;1;1;50;50;201300;1437;158
70103;2023;3;3;0;100;0;126000;1654.33333333333;67.6666666666667
70104;2023;2;2;0;100;0;93950;1138;84.5
70107;2023;5;4;1;80;20;238684;2229.8;105.6
70109;2023;2;1;1;50;50;158000;1333;118.5
70111;2023;5;5;0;100;0;87150;988.2;88.2
70112;2023;4;4;0;100;0;90250;974.25;85.25
70114;2023;2;2;0;100;0;77500;1053;74
70116;2023;7;7;0;100;0;158287.428571429;1383.71428571429;109.714285714286
70117;2023;7;6;1;85.7142857142857;14.2857142857143;207864.285714286;1792.57142857143;119.428571428571
70118;2023;5;5;0;100;0;150800;1653.6;95.2
70119;2023;2;2;0;100;0;150750;1175;118
70120;2023;28;26;2;92.8571428571429;7.14285714285714;133862.964285714;1511.85714285714;94.4642857142857
70121;2023;9;9;0;100;0;210765.555555556;2220.11111111111;97.7777777777778
70122;2023;13;13;0;100;0;89441.5384615385;964.307692307692;99.0769230769231
70124;2023;1;1;0;100;0;45000;450;100
70125;2023;1;1;0;100;0;118000;1326;89
70127;2023;1;1;0;100;0;140000;1000;140
70128;2023;1;1;0;100;0;174500;1918;91
70130;2023;4;4;0;100;0;144537.5;1472.5;95
70132;2023;10;10;0;100;0;166259.3;1768.5;97.5
70133;2023;3;3;0;100;0;63000;533;119
70134;2023;1;1;0;100;0;252100;1939;130
70136;2023;12;10;2;83.3333333333333;16.6666666666667;160725.416666667;1604.16666666667;100.583333333333
70137;2023;4;4;0;100;0;109000;1305.25;89.75
70140;2023;1;1;0;100;0;437000;4162;105
70141;2023;2;2;0;100;0;116350;1314.5;97
70142;2023;2;2;0;100;0;71000;918;78
70143;2023;3;3;0;100;0;79433.3333333333;682;120
70146;2023;3;3;0;100;0;125316.666666667;1228.33333333333;101.666666666667
70147;2023;3;3;0;100;0;131333.333333333;1786.66666666667;84.6666666666667
70148;2023;5;5;0;100;0;214240;1957.4;107.2
70149;2023;4;4;0;100;0;213225;1747;120.25
70150;2023;5;4;1;80;20;113030;1237.6;97
70151;2023;1;1;0;100;0;70000;778;90
70152;2023;9;9;0;100;0;123596.666666667;1366.88888888889;93.8888888888889
70153;2023;1;0;1;0;100;80000;1053;76
70154;2023;5;5;0;100;0;231850;1995.4;119.6
70155;2023;6;6;0;100;0;155358.166666667;1774.66666666667;82.3333333333333
70156;2023;1;1;0;100;0;320000;2462;130
70157;2023;4;4;0;100;0;123500;1337;92.5
70159;2023;1;1;0;100;0;175000;1549;113
70160;2023;3;3;0;100;0;103576.666666667;1347.66666666667;74.3333333333333
70162;2023;4;4;0;100;0;243700;1520.5;154.5
70163;2023;3;3;0;100;0;185850;1349;136.333333333333
70164;2023;1;1;0;100;0;130400;1003;130
70165;2023;4;4;0;100;0;119725;925;132.5
70166;2023;1;1;0;100;0;36000;514;70
70167;2023;5;5;0;100;0;96840;1032.6;102
70168;2023;5;5;0;100;0;98260;1038;90.6
70169;2023;2;2;0;100;0;65700;741;90
70170;2023;1;1;0;100;0;105900;3652;29
70171;2023;10;10;0;100;0;174785;1612.3;100.7
70174;2023;1;1;0;100;0;50000;625;80
70176;2023;5;4;1;80;20;86900;896.4;100.8
70177;2023;5;5;0;100;0;99995;961.4;105.6
70178;2023;6;6;0;100;0;136616.666666667;1596.5;88.5
70179;2023;2;2;0;100;0;136100;897.5;141.5
70180;2023;1;1;0;100;0;163000;2090;78
70181;2023;1;1;0;100;0;156200;1433;109
70182;2023;1;1;0;100;0;75200;1671;45
70183;2023;2;2;0;100;0;59570;705.5;95
70184;2023;10;6;4;60;40;119145.4;1401.5;84.2
70187;2023;2;2;0;100;0;118000;1752.5;60
70189;2023;2;2;0;100;0;124000;2139.5;58
70190;2023;1;1;0;100;0;345200;1836;188
70193;2023;1;1;0;100;0;153750;1922;80
70194;2023;1;1;0;100;0;65000;739;88
70195;2023;4;4;0;100;0;172175;1565.75;104.25
70196;2023;2;2;0;100;0;132500;903;147
70197;2023;8;8;0;100;0;130690.625;1237.75;106.5
70198;2023;13;13;0;100;0;117773.076923077;1232.46153846154;95.3076923076923
70199;2023;3;3;0;100;0;166666.666666667;1580.33333333333;101.333333333333
70200;2023;1;1;0;100;0;92500;797;116
70201;2023;1;1;0;100;0;126000;1726;73
70202;2023;2;2;0;100;0;128850;1401;92.5
70203;2023;1;1;0;100;0;185500;1508;123
70204;2023;1;1;0;100;0;117000;1064;110
70206;2023;6;6;0;100;0;202250;2122.16666666667;90.5
70207;2023;37;32;5;86.4864864864865;13.5135135135135;128642.972972973;1495.18918918919;86.4324324324324
70208;2023;2;2;0;100;0;107750;817.5;119
70211;2023;2;2;0;100;0;165500;1177;139.5
70213;2023;3;3;0;100;0;122800;987.666666666667;113.333333333333
70214;2023;2;2;0;100;0;145425;1184.5;123.5
70215;2023;3;3;0;100;0;247200;2231.33333333333;138
70216;2023;10;10;0;100;0;180080;1715.2;102.7
70217;2023;2;2;0;100;0;90260;810.5;102
70218;2023;1;1;0;100;0;44500;556;80
70219;2023;4;4;0;100;0;124400;1096;103
70220;2023;5;5;0;100;0;96400;1308;81
70224;2023;7;6;1;85.7142857142857;14.2857142857143;212285.714285714;1840.42857142857;126.428571428571
70226;2023;3;3;0;100;0;130250;1016.33333333333;139.333333333333
70227;2023;1;1;0;100;0;95000;1357;70
70228;2023;12;9;3;75;25;116167.833333333;1079.66666666667;101.916666666667
70229;2023;1;1;0;100;0;110000;1864;59
70230;2023;5;5;0;100;0;74600;671.4;122.6
70232;2023;1;1;0;100;0;48600;868;56
70234;2023;1;1;0;100;0;130150;723;180
70236;2023;2;2;0;100;0;161500;1175;137
70237;2023;1;1;0;100;0;28000;500;56
70239;2023;1;1;0;100;0;307400;2562;120
70240;2023;7;7;0;100;0;141900;1339.57142857143;111.571428571429
70242;2023;2;2;0;100;0;102500;1044.5;97
70243;2023;4;4;0;100;0;140950;1438.25;101.75
70245;2023;38;37;1;97.3684210526316;2.63157894736842;121064.131578947;1258;99.2894736842105
70247;2023;1;1;0;100;0;39000;488;80
70248;2023;13;12;1;92.3076923076923;7.69230769230769;151523.076923077;1713.84615384615;95.7692307692308
70249;2023;2;2;0;100;0;125025;1022;109.5
70250;2023;5;5;0;100;0;159492;1665.4;107
70252;2023;3;3;0;100;0;81666.6666666667;794;101
70253;2023;3;3;0;100;0;121466.666666667;1511.66666666667;76.6666666666667
70254;2023;3;2;1;66.6666666666667;33.3333333333333;123650;1298.66666666667;98
70255;2023;3;3;0;100;0;102333.333333333;1084.66666666667;84.3333333333333
70256;2023;11;10;1;90.9090909090909;9.09090909090909;148587.727272727;2066.27272727273;91.0909090909091
70257;2023;4;4;0;100;0;182750;1552.5;114
70258;2023;19;16;3;84.2105263157895;15.7894736842105;112060.526315789;1208.89473684211;95.4210526315789
70259;2023;5;5;0;100;0;129220;1331.4;104.2
70260;2023;5;5;0;100;0;186100;1945;94.2
70261;2023;17;15;2;88.2352941176471;11.7647058823529;182357.882352941;1687.05882352941;110.117647058824
70263;2023;3;3;0;100;0;158833.333333333;1339;120.666666666667
70267;2023;6;6;0;100;0;89007.6666666667;816;108.5
70268;2023;2;2;0;100;0;137225;1775;82.5
70271;2023;4;4;0;100;0;161537.5;1577.75;110
70272;2023;2;2;0;100;0;104200;878.5;118
70274;2023;1;1;0;100;0;47500;731;65
70275;2023;4;4;0;100;0;116325;1093.75;110.5
70276;2023;3;3;0;100;0;169216.666666667;1283.66666666667;129.333333333333
70277;2023;4;4;0;100;0;135950;1100.5;118
70278;2023;4;4;0;100;0;122750;1480;89.75
70279;2023;54;23;31;42.5925925925926;57.4074074074074;104861.722222222;1149.5;92.0555555555556
70280;2023;10;10;0;100;0;126568.5;1179.8;116.2
70282;2023;12;10;2;83.3333333333333;16.6666666666667;111141.333333333;933.916666666667;117.666666666667
70283;2023;5;5;0;100;0;162406;2067;85.4
70284;2023;3;3;0;100;0;82333.3333333333;1139.33333333333;73
70285;2023;100;67;33;67;33;131057.45;1502.72;85.66
70286;2023;2;2;0;100;0;334500;3105;106.5
70288;2023;1;1;0;100;0;235000;1469;160
70290;2023;1;1;0;100;0;175750;976;180
70291;2023;3;3;0;100;0;262000;1299.66666666667;194.666666666667
70292;2023;22;18;4;81.8181818181818;18.1818181818182;75649.7727272727;933.545454545455;87.6818181818182
70294;2023;3;3;0;100;0;213966.666666667;2194.33333333333;95
70295;2023;2;2;0;100;0;71875;995;87.5
70296;2023;4;4;0;100;0;174250;1527.25;113.75
70297;2023;1;1;0;100;0;52500;861;61
70298;2023;1;1;0;100;0;42000;412;102
70299;2023;2;2;0;100;0;126000;1285.5;101.5
70303;2023;1;1;0;100;0;384000;1347;285
70306;2023;4;4;0;100;0;227025;1784.5;118.25
70307;2023;1;1;0;100;0;144300;902;160
70308;2023;3;3;0;100;0;126020;1340.66666666667;88.3333333333333
70309;2023;4;4;0;100;0;170250;1772.5;99.75
70310;2023;70;48;22;68.5714285714286;31.4285714285714;110466.485714286;1216.32857142857;89.7714285714286
70311;2023;93;36;57;38.7096774193548;61.2903225806452;80523.4838709677;1011.35483870968;79.3763440860215
70312;2023;14;14;0;100;0;166153.571428571;1619.35714285714;103.785714285714
70313;2023;2;2;0;100;0;119750;1411.5;84.5
70315;2023;4;4;0;100;0;110647;1136.75;94.5
70317;2023;1;1;0;100;0;209700;1398;150
70318;2023;5;5;0;100;0;139764;1105.6;134.8
70321;2023;10;10;0;100;0;217967.5;1828.1;118.7
70322;2023;4;4;0;100;0;80812.5;1172.5;67.25
70323;2023;1;1;0;100;0;65000;481;135
70324;2023;8;8;0;100;0;166006.25;1461.875;110.5
70325;2023;4;4;0;100;0;112675;1753.25;74.75
70326;2023;1;1;0;100;0;170000;1650;103
70327;2023;4;4;0;100;0;236370;1950;131.75
70328;2023;5;5;0;100;0;125300;1200;115
70331;2023;6;6;0;100;0;88916.6666666667;907.333333333333;99.8333333333333
70332;2023;1;1;0;100;0;106000;815;130
70334;2023;12;11;1;91.6666666666667;8.33333333333333;212736.666666667;1888.91666666667;110.583333333333
70336;2023;2;2;0;100;0;109600;1157;95
70338;2023;3;3;0;100;0;177675;1554;113.333333333333
70339;2023;12;11;1;91.6666666666667;8.33333333333333;154655.833333333;1522.66666666667;102.25
70340;2023;4;4;0;100;0;76925;1103;66
70341;2023;4;4;0;100;0;134412.5;1155.25;114
70342;2023;1;1;0;100;0;62400;975;64
70343;2023;4;4;0;100;0;99975;1150.75;89.5
70344;2023;3;3;0;100;0;109000;820.666666666667;135
70347;2023;3;3;0;100;0;112900;1208.66666666667;90.3333333333333
70348;2023;4;4;0;100;0;236662.5;1689.75;117.5
70349;2023;1;1;0;100;0;190000;1462;130
70350;2023;2;2;0;100;0;97500;838.5;116.5
70351;2023;1;1;0;100;0;50000;833;60
70352;2023;3;3;0;100;0;83333.3333333333;1390.33333333333;70.6666666666667
70353;2023;4;4;0;100;0;194812.5;1848;111.75
70355;2023;1;1;0;100;0;140000;1273;110
70356;2023;4;4;0;100;0;133250;1274.5;104.25
70357;2023;6;4;2;66.6666666666667;33.3333333333333;191801.666666667;2494;82.5
70358;2023;2;2;0;100;0;108117;1162.5;92.5
70361;2023;5;5;0;100;0;133450;1333.6;103.8
70362;2023;2;2;0;100;0;57250;659;95
70363;2023;5;5;0;100;0;170770;2038.6;82.4
70364;2023;1;1;0;100;0;244000;1683;145
70366;2023;1;1;0;100;0;158750;1323;120
70367;2023;1;1;0;100;0;101350;1056;96
70368;2023;1;1;0;100;0;177000;1670;106
70369;2023;1;1;0;100;0;92200;726;127
70371;2023;1;1;0;100;0;143000;1644;87
70372;2023;1;1;0;100;0;170000;1037;164
70373;2023;1;1;0;100;0;80000;593;135
70376;2023;2;2;0;100;0;95800;1003;96
70378;2023;13;10;3;76.9230769230769;23.0769230769231;125630.769230769;1478.23076923077;84.4615384615385
70380;2023;2;2;0;100;0;107500;1040.5;106.5
70381;2023;1;1;0;100;0;205000;1737;118
70383;2023;2;2;0;100;0;242975;2594;93
70384;2023;1;1;0;100;0;107000;1372;78
70386;2023;1;1;0;100;0;110000;1264;87
70387;2023;8;8;0;100;0;110975;1136.25;101.375
70388;2023;11;10;1;90.9090909090909;9.09090909090909;149585.727272727;1590;95.7272727272727
70389;2023;1;1;0;100;0;80000;777;103
70390;2023;3;3;0;100;0;136000;1133;134.333333333333
70392;2023;1;1;0;100;0;130000;1646;79
70393;2023;8;8;0;100;0;210962.5;1707.125;125.5
70395;2023;1;1;0;100;0;150000;1415;106
70398;2023;2;2;0;100;0;147135;980.5;151.5
70399;2023;2;2;0;100;0;41805;500;84
70401;2023;2;2;0;100;0;174420;701.5;204.5
70402;2023;3;3;0;100;0;102073.333333333;867.666666666667;115
70403;2023;1;1;0;100;0;285800;2443;117
70404;2023;3;3;0;100;0;94100;1094.66666666667;91.6666666666667
70405;2023;2;2;0;100;0;149500;1218.5;122.5
70406;2023;1;1;0;100;0;94000;913;103
70407;2023;1;1;0;100;0;201300;2119;95
70408;2023;13;12;1;92.3076923076923;7.69230769230769;171046.153846154;1559.76923076923;113.769230769231
70409;2023;1;1;0;100;0;70000;560;125
70410;2023;5;4;1;80;20;159660;1880.2;84.6
70413;2023;19;18;1;94.7368421052632;5.26315789473684;146770.526315789;1402.31578947368;114.684210526316
70414;2023;13;12;1;92.3076923076923;7.69230769230769;104220.769230769;1135.61538461538;96.2307692307692
70415;2023;3;3;0;100;0;73666.6666666667;702;110
70416;2023;1;1;0;100;0;82650;1033;80
70418;2023;4;4;0;100;0;74700;604.5;121.25
70419;2023;2;2;0;100;0;74437.5;841.5;88.5
70421;2023;34;31;3;91.1764705882353;8.82352941176471;156081.617647059;1393.79411764706;106.735294117647
70422;2023;3;2;1;66.6666666666667;33.3333333333333;115000;1514.66666666667;74
70425;2023;1;1;0;100;0;2,00E+05;2174;92
70426;2023;2;2;0;100;0;99000;602.5;162
70427;2023;5;5;0;100;0;65200;694.2;94.2
70428;2023;13;12;1;92.3076923076923;7.69230769230769;205386.153846154;1961;108.384615384615
70429;2023;6;6;0;100;0;195000;1966.16666666667;100.333333333333
70430;2023;2;2;0;100;0;80750;937;127
70431;2023;2;2;0;100;0;204750;1594;132.5
70432;2023;3;3;0;100;0;189833.333333333;1731.33333333333;122
70433;2023;16;15;1;93.75;6.25;199265.625;1471.375;127.9375
70435;2023;4;4;0;100;0;150112.5;1193.5;123.25
70436;2023;3;3;0;100;0;135100;1147.33333333333;120
70438;2023;4;4;0;100;0;145250;1236.25;114.5
70439;2023;3;3;0;100;0;101250;1252;88
70440;2023;1;1;0;100;0;1,00E+05;877;114
70441;2023;2;2;0;100;0;117500;983;136
70442;2023;2;2;0;100;0;121500;1050.5;120
70443;2023;1;1;0;100;0;121000;1315;92
70445;2023;3;3;0;100;0;231656.666666667;2162.33333333333;101
70446;2023;9;9;0;100;0;163755.555555556;1258.44444444444;131.111111111111
70447;2023;9;8;1;88.8888888888889;11.1111111111111;209048.222222222;1951.22222222222;104.666666666667
70448;2023;1;1;0;100;0;42000;1050;40
70449;2023;3;3;0;100;0;189750;1224.33333333333;129.666666666667
70451;2023;27;26;1;96.2962962962963;3.7037037037037;132655.740740741;1286;106.111111111111
70452;2023;3;3;0;100;0;144866.666666667;1357;106
70454;2023;1;1;0;100;0;160940;1341;120
70455;2023;9;8;1;88.8888888888889;11.1111111111111;172822.222222222;1713.44444444444;96.6666666666667
70456;2023;1;1;0;100;0;112000;1120;100
70457;2023;1;1;0;100;0;85000;944;90
70459;2023;7;7;0;100;0;151114.285714286;1361.85714285714;105.857142857143
70460;2023;6;6;0;100;0;98783.3333333333;1205.83333333333;83.3333333333333
70464;2023;13;12;1;92.3076923076923;7.69230769230769;136033;1330.92307692308;107.538461538462
70467;2023;18;17;1;94.4444444444444;5.55555555555556;86838.8888888889;962;88.5555555555556
70469;2023;2;2;0;100;0;315500;2393;121
70472;2023;6;6;0;100;0;99816.6666666667;1103.83333333333;97.8333333333333
70473;2023;19;18;1;94.7368421052632;5.26315789473684;144097.105263158;1372.10526315789;105.315789473684
70474;2023;1;1;0;100;0;136500;1241;110
70476;2023;1;1;0;100;0;1,00E+05;667;150
70477;2023;5;5;0;100;0;84640;956.2;86.6
70478;2023;9;9;0;100;0;190912.222222222;1601;135.888888888889
70481;2023;2;2;0;100;0;64465;673;93
70482;2023;4;4;0;100;0;96102.5;1142.5;81.75
70483;2023;3;3;0;100;0;75333.3333333333;695.666666666667;109.333333333333
70485;2023;2;2;0;100;0;79633.5;856.5;92
70486;2023;2;2;0;100;0;83075;631;131.5
70488;2023;1;1;0;100;0;140420;802;175
70489;2023;9;9;0;100;0;181230;1650;108.111111111111
70490;2023;1;1;0;100;0;330000;3000;110
70491;2023;2;2;0;100;0;132505;1284;99
70492;2023;12;12;0;100;0;134866.75;1162.41666666667;121.416666666667
70493;2023;2;2;0;100;0;277900;2439.5;114
70494;2023;2;2;0;100;0;157425;1502.5;102
70498;2023;6;6;0;100;0;153166.666666667;1641.66666666667;100.833333333333
70499;2023;3;3;0;100;0;88766.6666666667;708.666666666667;124.666666666667
70500;2023;5;5;0;100;0;112060;1335.2;84
70501;2023;2;2;0;100;0;201000;1168;185
70502;2023;1;1;0;100;0;88500;1475;60
70504;2023;4;4;0;100;0;100937.5;1023;100.75
70505;2023;2;2;0;100;0;231625;1849.5;125
70506;2023;4;4;0;100;0;204275;1997.75;106.5
70507;2023;3;3;0;100;0;229400;1677;139
70509;2023;1;1;0;100;0;161000;1660;97
70511;2023;1;1;0;100;0;133520;1734;77
70512;2023;7;7;0;100;0;69130;819.857142857143;85.2857142857143
70513;2023;19;18;1;94.7368421052632;5.26315789473684;187450;1846.57894736842;100.684210526316
70514;2023;6;6;0;100;0;209628.333333333;1212.33333333333;164
70515;2023;1;1;0;100;0;165000;2895;57
70516;2023;1;1;0;100;0;148500;911;163
70517;2023;3;3;0;100;0;277333.333333333;2091.33333333333;135
70518;2023;1;1;0;100;0;55000;887;62
70520;2023;1;1;0;100;0;78100;758;103
70521;2023;2;2;0;100;0;122200;1289.5;96.5
70523;2023;1;1;0;100;0;115000;719;160
70524;2023;1;1;0;100;0;47000;560;84
70525;2023;4;4;0;100;0;86075;962;102
70526;2023;6;5;1;83.3333333333333;16.6666666666667;48250;526.5;92.1666666666667
70528;2023;5;4;1;80;20;135180;1127.2;123.6
70529;2023;6;6;0;100;0;88116.6666666667;863.833333333333;96.8333333333333
70530;2023;1;1;0;100;0;105000;1312;80
70531;2023;1;1;0;100;0;183000;1777;103
70532;2023;7;7;0;100;0;150664.285714286;1449.85714285714;102.857142857143
70533;2023;1;1;0;100;0;212500;1446;147
70535;2023;1;1;0;100;0;20000;1053;19
70537;2023;3;3;0;100;0;133666.666666667;1897;94.6666666666667
70539;2023;3;3;0;100;0;50513.3333333333;613;86
70541;2023;2;2;0;100;0;141475;1388;106
70542;2023;1;1;0;100;0;149000;828;180
70546;2023;2;2;0;100;0;156950;1750.5;90
70550;2023;193;41;152;21.2435233160622;78.7564766839378;100536.233160622;1375.60103626943;74.0932642487047
70552;2023;1;1;0;100;0;140000;1197;117
70553;2023;1;1;0;100;0;131500;1164;113
70554;2023;3;3;0;100;0;68408.3333333333;570;121
70555;2023;2;2;0;100;0;113675;1116;112
70559;2023;2;2;0;100;0;147500;1400.5;108
70560;2023;1;1;0;100;0;244000;2346;104
70561;2023;12;12;0;100;0;162307.5;1442.25;111.5
70563;2023;5;4;1;80;20;157360;1483.6;105.4
70564;2023;1;0;1;0;100;42000;583;72
70566;2023;1;1;0;100;0;152200;1710;89
70568;2023;1;1;0;100;0;89200;686;130
70571;2023;1;1;0;100;0;1,00E+05;826;121
70573;2023;2;2;0;100;0;201100;2317.5;81
70575;2023;8;7;1;87.5;12.5;196512.5;1813.5;108.125
70576;2023;1;1;0;100;0;125000;962;130
70577;2023;5;4;1;80;20;133400;1345;97
70578;2023;2;2;0;100;0;305300;2390;135
70579;2023;4;4;0;100;0;291475;2089.25;138
70580;2023;1;1;0;100;0;107900;1079;100
70581;2023;7;7;0;100;0;184528.571428571;1766.71428571429;104.714285714286
70582;2023;2;2;0;100;0;68750;663.5;95
70583;2023;2;2;0;100;0;101650;1475;76.5
71001;2023;15;15;0;100;0;187016.666666667;1652.4;97.8
71002;2023;11;11;0;100;0;149000;1432.81818181818;103.545454545455
71003;2023;7;7;0;100;0;136124.714285714;1572.57142857143;89
71004;2023;8;8;0;100;0;208867.5;1995.25;107.875
71005;2023;1;1;0;100;0;300200;2114;142
71006;2023;1;1;0;100;0;3,00E+05;1667;180
71007;2023;2;2;0;100;0;105000;656;160
71008;2023;1;1;0;100;0;220400;1837;120
71009;2023;19;19;0;100;0;100013.684210526;1101.94736842105;96.6842105263158
71010;2023;9;9;0;100;0;124092.222222222;1505.77777777778;84.2222222222222
71011;2023;6;6;0;100;0;79420.8333333333;918.5;93.3333333333333
71012;2023;4;4;0;100;0;114075;1615;77.5
71013;2023;3;3;0;100;0;1,00E+05;1390;66.3333333333333
71014;2023;158;89;69;56.3291139240506;43.6708860759494;117973.449367089;1275.05696202532;89.4303797468354
71015;2023;6;6;0;100;0;155738.333333333;1454.66666666667;104.5
71016;2023;7;7;0;100;0;267500;2261.14285714286;117.428571428571
71018;2023;9;9;0;100;0;117333.333333333;1293.22222222222;87.3333333333333
71019;2023;1;1;0;100;0;265300;1951;136
71020;2023;3;3;0;100;0;63666.6666666667;903.666666666667;78.3333333333333
71021;2023;2;2;0;100;0;157500;2247.5;77.5
71022;2023;6;6;0;100;0;149793.666666667;1443.66666666667;106.833333333333
71023;2023;14;14;0;100;0;163405.714285714;1660.21428571429;105.071428571429
71024;2023;1;1;0;100;0;195000;1950;100
71025;2023;3;3;0;100;0;171300;1847;92.6666666666667
71026;2023;2;2;0;100;0;110000;1006.5;123.5
71027;2023;10;10;0;100;0;176657.3;1587;122.4
71028;2023;2;2;0;100;0;255470;1807;142
71029;2023;10;10;0;100;0;118750;1445.9;92.4
71030;2023;1;1;0;100;0;215000;964;223
71031;2023;1;1;0;100;0;235000;3357;70
71032;2023;6;6;0;100;0;207241.666666667;2116.66666666667;87.5
71033;2023;8;8;0;100;0;173481.25;1746.625;109.375
71034;2023;3;3;0;100;0;222033.333333333;1781;110.333333333333
71035;2023;5;5;0;100;0;198800;2008.8;106
71036;2023;1;1;0;100;0;48000;738;65
71037;2023;1;1;0;100;0;155000;2039;76
71038;2023;13;13;0;100;0;151883.461538462;1463.23076923077;107.923076923077
71040;2023;46;42;4;91.304347826087;8.69565217391304;126492.108695652;1313.76086956522;96.3913043478261
71041;2023;3;3;0;100;0;104183.333333333;1300;73.6666666666667
71042;2023;6;6;0;100;0;245666.666666667;2538.16666666667;91.8333333333333
71043;2023;4;4;0;100;0;124375;1609.5;84
71044;2023;2;2;0;100;0;138175;1037;115.5
71045;2023;1;1;0;100;0;475000;2065;230
71046;2023;2;2;0;100;0;55000;1028;62.5
71047;2023;54;50;4;92.5925925925926;7.40740740740741;97697.9444444444;1120.18518518519;83.7962962962963
71048;2023;1;1;0;100;0;1,00E+05;1000;100
71050;2023;3;3;0;100;0;176666.666666667;1614;122.333333333333
71051;2023;3;3;0;100;0;231083.333333333;2261;104.666666666667
71052;2023;7;7;0;100;0;239857.142857143;2085.28571428571;110.571428571429
71054;2023;6;6;0;100;0;141455;1586.16666666667;81.8333333333333
71056;2023;28;28;0;100;0;148438.571428571;1569.25;97.9642857142857
71058;2023;2;2;0;100;0;228000;3609.5;69.5
71059;2023;24;24;0;100;0;145448.666666667;1553;92.3333333333333
71060;2023;5;5;0;100;0;170600;1475.6;117.8
71061;2023;6;6;0;100;0;140833.333333333;1527;90.1666666666667
71062;2023;4;4;0;100;0;192000;1837.5;112.25
71063;2023;11;11;0;100;0;151200.909090909;1304.45454545455;109.636363636364
71064;2023;13;13;0;100;0;125661.538461538;1568.84615384615;84.0769230769231
71065;2023;3;3;0;100;0;118066.666666667;1341.33333333333;89
71066;2023;1;1;0;100;0;259000;2590;100
71067;2023;3;3;0;100;0;112970;1297.66666666667;87
71068;2023;1;1;0;100;0;49836;509;98
71069;2023;7;7;0;100;0;381671.428571429;2611.85714285714;144.857142857143
71070;2023;22;19;3;86.3636363636364;13.6363636363636;174284.863636364;1708;102.772727272727
71071;2023;6;6;0;100;0;179866.666666667;1343;126.333333333333
71072;2023;1;1;0;100;0;64000;653;98
71073;2023;53;41;12;77.3584905660377;22.6415094339623;149682.358490566;1826.15094339623;82.0566037735849
71074;2023;5;4;1;80;20;206260;2068.4;104
71075;2023;8;7;1;87.5;12.5;80237.5;1397.125;57
71076;2023;718;95;623;13.2311977715877;86.7688022284123;107288.250696379;1512.88718662953;69.8133704735376
71077;2023;5;5;0;100;0;128640;1450.2;92.2
71079;2023;4;4;0;100;0;153250;1447;102.75
71080;2023;3;3;0;100;0;106896;1707.66666666667;65.6666666666667
71081;2023;25;18;7;72;28;190550.24;2166.48;92
71082;2023;1;1;0;100;0;750000;2930;256
71084;2023;7;7;0;100;0;195414.285714286;1961.85714285714;106.714285714286
71085;2023;2;2;0;100;0;114500;1115;103
71086;2023;2;2;0;100;0;132500;1823;70
71087;2023;2;1;1;50;50;311000;4737;65
71088;2023;1;1;0;100;0;90500;862;105
71089;2023;4;4;0;100;0;256050;1817.5;124.75
71090;2023;31;24;7;77.4193548387097;22.5806451612903;252860.322580645;2469.12903225806;99.3225806451613
71091;2023;3;3;0;100;0;264333.333333333;2282.33333333333;119
71092;2023;6;6;0;100;0;309983.333333333;1984.83333333333;154.833333333333
71093;2023;14;14;0;100;0;114468.5;1387.64285714286;87.1428571428571
71094;2023;2;2;0;100;0;315900;1888.5;167
71095;2023;7;7;0;100;0;124942.857142857;1165.14285714286;112.714285714286
71096;2023;1;1;0;100;0;75000;987;76
71097;2023;14;14;0;100;0;113515.785714286;1327.71428571429;87.8571428571429
71098;2023;2;2;0;100;0;159375.5;2373;65.5
71100;2023;3;3;0;100;0;198000;1683.33333333333;109.333333333333
71101;2023;6;6;0;100;0;134775;1240.83333333333;131.166666666667
71102;2023;4;4;0;100;0;206787.5;1928;110.25
71103;2023;4;4;0;100;0;122298;1178.5;100
71104;2023;4;4;0;100;0;179587.5;2060.25;87
71105;2023;94;43;51;45.7446808510638;54.2553191489362;209959.893617021;2430.75531914894;84.1170212765958
71106;2023;30;22;8;73.3333333333333;26.6666666666667;131348.366666667;1373;98.2
71107;2023;3;3;0;100;0;241833.333333333;2757.66666666667;95
71110;2023;3;3;0;100;0;143333.333333333;1194.33333333333;111.333333333333
71111;2023;6;6;0;100;0;110833.333333333;1136.5;96.6666666666667
71112;2023;3;3;0;100;0;196933.333333333;2054.33333333333;92.6666666666667
71113;2023;1;1;0;100;0;70000;438;160
71117;2023;17;16;1;94.1176470588235;5.88235294117647;262057.647058824;2221.41176470588;114.823529411765
71118;2023;69;47;22;68.1159420289855;31.8840579710145;166215.217391304;1813.08695652174;88.8260869565217
71119;2023;4;4;0;100;0;285462.5;2388;120.5
71120;2023;59;48;11;81.3559322033898;18.6440677966102;128103.881355932;1477.28813559322;84.9661016949153
71121;2023;6;6;0;100;0;166008.333333333;1984.5;82.6666666666667
71122;2023;5;5;0;100;0;196200;1631.8;123.8
71123;2023;1;1;0;100;0;20000;400;50
71124;2023;2;2;0;100;0;166000;2276;71
71126;2023;5;5;0;100;0;355895;2961.2;120.8
71127;2023;2;2;0;100;0;103050;1506.5;61.5
71129;2023;2;2;0;100;0;50500;470.5;106
71130;2023;5;5;0;100;0;109846;1454;71.4
71131;2023;8;8;0;100;0;125970;1628.875;78.625
71132;2023;27;23;4;85.1851851851852;14.8148148148148;93802.1481481481;1004.18518518519;98.9259259259259
71133;2023;23;12;11;52.1739130434783;47.8260869565217;104021.739130435;1199.65217391304;85.9130434782609
71134;2023;4;4;0;100;0;88000;1080.25;85.25
71135;2023;6;6;0;100;0;272064.166666667;2667.16666666667;104.5
71136;2023;7;7;0;100;0;141890;1427.85714285714;100.571428571429
71137;2023;37;24;13;64.8648648648649;35.1351351351351;229187.837837838;2622.78378378378;96.9189189189189
71139;2023;3;3;0;100;0;102666.666666667;1328;85
71140;2023;1;1;0;100;0;148460;1314;113
71141;2023;6;6;0;100;0;141566.666666667;1541;91.3333333333333
71142;2023;2;2;0;100;0;258600;2862.5;145.5
71143;2023;8;8;0;100;0;158124.375;1950.5;86.125
71144;2023;2;2;0;100;0;135000;1424.5;95
71145;2023;9;9;0;100;0;116469.888888889;1875.44444444444;74.1111111111111
71146;2023;2;2;0;100;0;295150;2443.5;120
71147;2023;5;5;0;100;0;114500;1315;89.2
71148;2023;10;10;0;100;0;133220;1053.9;129.3
71149;2023;15;14;1;93.3333333333333;6.66666666666667;107654.666666667;1461.86666666667;77.4666666666667
71150;2023;24;20;4;83.3333333333333;16.6666666666667;223519.875;2403.41666666667;95.125
71151;2023;1;1;0;100;0;48000;706;68
71152;2023;3;3;0;100;0;74724.3333333333;1377.33333333333;61.3333333333333
71153;2023;209;111;98;53.11004784689;46.88995215311;93528.7368421053;1310.28229665072;74.8373205741627
71154;2023;25;25;0;100;0;176470;1799.24;99.16
71155;2023;5;5;0;100;0;137940;1249.6;107.4
71156;2023;4;4;0;100;0;187648;2038.25;93
71157;2023;14;14;0;100;0;134650;1524.21428571429;85.5714285714286
71158;2023;21;17;4;80.9523809523809;19.047619047619;148377.142857143;1628.28571428571;88.1904761904762
71159;2023;3;3;0;100;0;233133.333333333;2082.33333333333;112
71160;2023;1;1;0;100;0;196000;1903;103
71161;2023;4;4;0;100;0;128875;1368.25;96
71162;2023;7;7;0;100;0;120317.142857143;1370.28571428571;92.8571428571429
71163;2023;1;1;0;100;0;275000;1964;140
71164;2023;1;1;0;100;0;167300;1115;150
71165;2023;13;13;0;100;0;102319.230769231;1162.23076923077;89.9230769230769
71166;2023;4;4;0;100;0;85000;997;91.75
71167;2023;7;7;0;100;0;182070;1893.14285714286;100.571428571429
71168;2023;2;1;1;50;50;76590;1577.5;61
71169;2023;4;4;0;100;0;263000;2734.5;102
71170;2023;12;11;1;91.6666666666667;8.33333333333333;240554.166666667;2278.08333333333;110.916666666667
71172;2023;1;1;0;100;0;101500;1269;80
71173;2023;6;6;0;100;0;143625.833333333;1614.66666666667;85.1666666666667
71174;2023;3;3;0;100;0;1,00E+05;1139.33333333333;90.3333333333333
71175;2023;2;2;0;100;0;422150;4593;109.5
71176;2023;90;56;34;62.2222222222222;37.7777777777778;84560.7777777778;1071.05555555556;77.2222222222222
71177;2023;8;8;0;100;0;119187.5;1342;93.25
71178;2023;6;6;0;100;0;170406.833333333;1696.83333333333;117.5
71182;2023;13;13;0;100;0;306646.153846154;2309.38461538462;135.615384615385
71183;2023;5;5;0;100;0;105474;1395.6;76.6
71184;2023;2;2;0;100;0;102500;1151.5;85.5
71185;2023;6;6;0;100;0;109699.666666667;1167.33333333333;95.1666666666667
71186;2023;1;1;0;100;0;73000;640;114
71187;2023;18;15;3;83.3333333333333;16.6666666666667;148285.555555556;1509.44444444444;96.4444444444444
71189;2023;16;15;1;93.75;6.25;241516.875;2065.5;110.1875
71190;2023;22;22;0;100;0;95933.1818181818;996.5;101.227272727273
71191;2023;3;3;0;100;0;104000;1117.66666666667;96
71192;2023;22;22;0;100;0;121024.545454545;1205.5;103.318181818182
71193;2023;9;9;0;100;0;272901.333333333;2634.77777777778;111.888888888889
71194;2023;5;5;0;100;0;240472;2313;101.4
71195;2023;1;1;0;100;0;150000;1667;90
71196;2023;12;12;0;100;0;265166.666666667;2481.33333333333;114.416666666667
71198;2023;1;1;0;100;0;145000;1160;125
71199;2023;2;2;0;100;0;162250;1481;115.5
71200;2023;12;12;0;100;0;226908.333333333;1686.83333333333;135.083333333333
71202;2023;18;15;3;83.3333333333333;16.6666666666667;221104.722222222;2296.61111111111;95.3333333333333
71203;2023;1;1;0;100;0;110000;1170;94
71204;2023;10;10;0;100;0;196163;1634.3;117.6
71205;2023;8;8;0;100;0;142600;1322.375;106.25
71206;2023;1;1;0;100;0;270000;2700;100
71207;2023;2;2;0;100;0;147236;1614.5;95.5
71208;2023;6;6;0;100;0;98475;1142.16666666667;86.8333333333333
71209;2023;11;11;0;100;0;155954.545454545;1391.90909090909;114.636363636364
71210;2023;3;3;0;100;0;416600;3046;137.333333333333
71212;2023;15;13;2;86.6666666666667;13.3333333333333;86616.6666666667;1080.73333333333;88.2
71213;2023;5;5;0;100;0;116600;1282.6;86.6
71214;2023;9;9;0;100;0;152758.888888889;2376.11111111111;79
71215;2023;13;13;0;100;0;163450;1651.30769230769;98.6153846153846
71216;2023;1;1;0;100;0;40000;482;83
71217;2023;1;1;0;100;0;218300;3358;65
71218;2023;9;8;1;88.8888888888889;11.1111111111111;124654.444444444;1614.55555555556;83.2222222222222
71219;2023;2;2;0;100;0;176000;2276;77.5
71220;2023;5;5;0;100;0;97530;1063;95
71221;2023;38;36;2;94.7368421052632;5.26315789473684;300374.263157895;2551.07894736842;113.868421052632
71222;2023;8;8;0;100;0;155698;1669.25;91
71223;2023;11;11;0;100;0;120577.272727273;1523;76.9090909090909
71224;2023;2;2;0;100;0;197725;1480;142.5
71225;2023;6;6;0;100;0;220598.333333333;2584.16666666667;99.6666666666667
71226;2023;1;1;0;100;0;176335;3094;57
71227;2023;12;12;0;100;0;81893;1169.41666666667;70.5
71228;2023;4;4;0;100;0;201275;1875.5;106.75
71229;2023;5;5;0;100;0;64800;888.4;71
71230;2023;59;53;6;89.8305084745763;10.1694915254237;105265.305084746;1145.54237288136;90.8474576271186
71231;2023;8;8;0;100;0;151965;1339.5;107
71232;2023;3;3;0;100;0;361316.666666667;2106.33333333333;161.666666666667
71234;2023;5;5;0;100;0;235020;1688.4;128.8
71235;2023;19;18;1;94.7368421052632;5.26315789473684;271212.368421053;2465.15789473684;114.736842105263
71236;2023;6;6;0;100;0;237085;2134.83333333333;108
71237;2023;4;4;0;100;0;109562.5;1044.5;92.75
71238;2023;17;17;0;100;0;190617.352941176;1532.76470588235;119.294117647059
71239;2023;13;12;1;92.3076923076923;7.69230769230769;112995.769230769;1261;83.3846153846154
71240;2023;7;7;0;100;0;266590;2279;104.285714285714
71241;2023;2;2;0;100;0;210400;2007.5;92.5
71242;2023;6;5;1;83.3333333333333;16.6666666666667;134266.666666667;1475.16666666667;92.1666666666667
71243;2023;5;5;0;100;0;105400;1109;97.8
71244;2023;8;8;0;100;0;150050;1530.5;99
71245;2023;1;1;0;100;0;195000;1931;101
71246;2023;5;5;0;100;0;162600;1997.6;74.6
71247;2023;4;4;0;100;0;155750;2179;72.75
71248;2023;9;9;0;100;0;146996.666666667;1503;100.222222222222
71249;2023;8;8;0;100;0;169446.25;1541.5;98
71250;2023;9;9;0;100;0;272702.222222222;2244.33333333333;123.666666666667
71251;2023;4;4;0;100;0;77250;817.75;98
71252;2023;4;4;0;100;0;217200;1824;138.25
71253;2023;12;12;0;100;0;237149.166666667;2156;112.166666666667
71254;2023;3;3;0;100;0;104333.333333333;1152.33333333333;93.3333333333333
71255;2023;3;3;0;100;0;95666.6666666667;1159;79
71256;2023;4;4;0;100;0;111250;1213.5;92.75
71257;2023;7;7;0;100;0;190528.571428571;2159.71428571429;91.2857142857143
71258;2023;3;3;0;100;0;290822.666666667;2497.33333333333;128.333333333333
71259;2023;4;4;0;100;0;178300;1595.25;110.25
71261;2023;7;7;0;100;0;158551.428571429;1808.42857142857;88.2857142857143
71263;2023;89;76;13;85.3932584269663;14.6067415730337;160734.921348315;1690.34831460674;98.2359550561798
71264;2023;4;4;0;100;0;134425;1144.75;95.25
71266;2023;5;5;0;100;0;87853.6;1066.8;80.2
71267;2023;7;6;1;85.7142857142857;14.2857142857143;229842.857142857;1922.28571428571;124.571428571429
71268;2023;3;3;0;100;0;167958.333333333;1618;105.666666666667
71269;2023;35;16;19;45.7142857142857;54.2857142857143;145208.8;1778.34285714286;79.3714285714286
71270;2023;434;115;319;26.4976958525346;73.5023041474654;146545.582949309;1924.13594470046;74.6566820276498
71271;2023;1;1;0;100;0;255000;2198;116
71272;2023;1;1;0;100;0;168000;2127;79
71273;2023;3;3;0;100;0;107000;1348.66666666667;83
71274;2023;7;7;0;100;0;150478.857142857;1390;110.142857142857
71275;2023;20;17;3;85;15;138966.95;1239.3;107.55
71276;2023;3;3;0;100;0;154666.666666667;1428.66666666667;107
71277;2023;4;4;0;100;0;181350;1438.5;113
71279;2023;10;10;0;100;0;162652.5;1511.6;103.6
71280;2023;1;1;0;100;0;105000;795;132
71281;2023;3;3;0;100;0;226666.666666667;1916.66666666667;127
71282;2023;10;9;1;90;10;114899;1089.2;96.9
71283;2023;3;3;0;100;0;174666.666666667;1808.33333333333;96
71284;2023;3;3;0;100;0;95000;1227.66666666667;83.3333333333333
71285;2023;4;4;0;100;0;145408.75;1692.75;90.5
71286;2023;3;3;0;100;0;214545;2243;96
71287;2023;5;5;0;100;0;189200;2093.2;84.4
71289;2023;6;6;0;100;0;193416.666666667;1298.83333333333;174.5
71290;2023;5;5;0;100;0;99400;1653.6;66.8
71291;2023;19;19;0;100;0;140080.315789474;1469.63157894737;102.210526315789
71292;2023;8;8;0;100;0;281548.875;2441.75;119.5
71293;2023;7;7;0;100;0;155438.571428571;1589.57142857143;99
71294;2023;11;10;1;90.9090909090909;9.09090909090909;180056.636363636;2029.90909090909;94.0909090909091
71295;2023;13;13;0;100;0;110396.153846154;1129.61538461538;102.769230769231
71296;2023;11;11;0;100;0;187497.272727273;1880.45454545455;97.8181818181818
71297;2023;10;9;1;90;10;81492.5;1144.3;70.3
71299;2023;3;3;0;100;0;295000;2295.66666666667;129
71300;2023;9;9;0;100;0;160294.444444444;1600;102.444444444444
71301;2023;3;3;0;100;0;134000;1422.33333333333;94.6666666666667
71302;2023;1;1;0;100;0;333600;1853;180
71303;2023;9;9;0;100;0;163966.666666667;1917.77777777778;88.3333333333333
71305;2023;10;9;1;90;10;186880;1684.5;127.4
71306;2023;182;141;41;77.4725274725275;22.5274725274725;97357.7417582418;1140.3956043956;85.6593406593407
71307;2023;4;4;0;100;0;102125;1041.5;95.25
71308;2023;1;1;0;100;0;112000;2240;50
71309;2023;23;20;3;86.9565217391304;13.0434782608696;124670;1353.4347826087;88.2173913043478
71310;2023;33;27;6;81.8181818181818;18.1818181818182;122199.303030303;1434.27272727273;84.6060606060606
71311;2023;1;1;0;100;0;1,00E+05;1587;63
71312;2023;3;3;0;100;0;251116.666666667;2485.66666666667;140.333333333333
71313;2023;1;1;0;100;0;120000;1412;85
71314;2023;4;4;0;100;0;137500;1405.5;107.75
71316;2023;6;6;0;100;0;221666.666666667;1472.66666666667;172.833333333333
71317;2023;4;4;0;100;0;204000;1646.25;125
71318;2023;18;18;0;100;0;127871.777777778;1284.16666666667;102.555555555556
71319;2023;7;7;0;100;0;180457.142857143;1741.71428571429;99.1428571428571
71320;2023;3;2;1;66.6666666666667;33.3333333333333;162866.666666667;2050;85
71322;2023;2;2;0;100;0;199500;2035.5;99.5
71323;2023;2;2;0;100;0;107925;1458.5;77.5
71324;2023;7;7;0;100;0;265308.857142857;2096.14285714286;131.857142857143
71325;2023;1;1;0;100;0;154000;1363;113
71326;2023;3;3;0;100;0;174156.666666667;1265;140
71328;2023;5;5;0;100;0;212400;1790.2;103.6
71329;2023;8;8;0;100;0;121353.625;984;118.25
71330;2023;6;6;0;100;0;116487.5;1022.83333333333;119.833333333333
71331;2023;1;1;0;100;0;410000;4059;101
71332;2023;4;4;0;100;0;129943.75;2406.5;61.5
71333;2023;13;13;0;100;0;183040;1827.69230769231;97.2307692307692
71334;2023;4;4;0;100;0;122750;1014.75;137.75
71335;2023;6;6;0;100;0;141117.833333333;1074.5;129
71336;2023;31;30;1;96.7741935483871;3.2258064516129;191003.387096774;1740.48387096774;107.838709677419
71337;2023;3;3;0;100;0;194288;1406.33333333333;147.333333333333
71338;2023;1;1;0;100;0;142000;1420;100
71339;2023;5;5;0;100;0;156194;1112.2;138.4
71340;2023;16;16;0;100;0;85934.375;923;94.6875
71341;2023;1;1;0;100;0;389000;2683;145
71342;2023;133;77;56;57.8947368421053;42.1052631578947;121537.947368421;1510.90977443609;81.2255639097744
71343;2023;8;8;0;100;0;171400;1809.5;98.375
71344;2023;2;2;0;100;0;173500;2688.5;66.5
71345;2023;10;9;1;90;10;245798;2320.8;111.9
71346;2023;15;15;0;100;0;98908.5333333333;1100.6;89.4
71347;2023;2;2;0;100;0;129000;1486.5;88
71348;2023;1;1;0;100;0;25000;926;27
71350;2023;8;8;0;100;0;236225;2276.5;102
71351;2023;29;27;2;93.1034482758621;6.89655172413793;139117.793103448;1554.34482758621;94.8620689655172
71352;2023;3;3;0;100;0;223746.666666667;1403;157
71354;2023;2;2;0;100;0;118000;1078;108.5
71355;2023;3;3;0;100;0;122983.333333333;2168.66666666667;57
71356;2023;9;9;0;100;0;162355.555555556;1532.66666666667;113.888888888889
71357;2023;3;3;0;100;0;130000;1339.33333333333;89.3333333333333
71358;2023;2;2;0;100;0;267000;2450;135
71359;2023;9;9;0;100;0;137560;1372.77777777778;100.555555555556
71360;2023;8;8;0;100;0;265425;2286.875;111.75
71361;2023;2;2;0;100;0;182972.5;1930;91.5
71362;2023;3;3;0;100;0;317611.666666667;2018.66666666667;153
71363;2023;1;1;0;100;0;65000;508;128
71364;2023;1;1;0;100;0;246625;1551;159
71365;2023;10;10;0;100;0;141480.5;1501.9;99.6
71366;2023;5;5;0;100;0;163200;2214.4;81
71367;2023;6;6;0;100;0;128683.333333333;1251.33333333333;99.6666666666667
71368;2023;2;2;0;100;0;148550;1650.5;90
71369;2023;3;3;0;100;0;178716.666666667;2143;85.6666666666667
71370;2023;8;7;1;87.5;12.5;109825;1303.625;88
71371;2023;14;13;1;92.8571428571429;7.14285714285714;283531.928571429;2627.35714285714;106.142857142857
71372;2023;25;24;1;96;4;253669;2330.72;111.4
71373;2023;27;27;0;100;0;147645.925925926;1567.44444444444;96.2962962962963
71374;2023;3;3;0;100;0;150666.666666667;2552;58.3333333333333
71376;2023;4;4;0;100;0;61250;766;81
71377;2023;4;4;0;100;0;136087.5;1586;85.75
71378;2023;10;9;1;90;10;178602.4;2114.8;88.9
71379;2023;14;14;0;100;0;168066.785714286;1782.57142857143;99.0714285714286
71380;2023;10;10;0;100;0;230780;2011.1;115.5
71382;2023;10;10;0;100;0;154342.6;1582.2;108.8
71383;2023;4;4;0;100;0;219835;1400.25;149.25
71384;2023;4;4;0;100;0;231250;2040;122.75
71385;2023;7;7;0;100;0;183000;2375;81.7142857142857
71387;2023;6;6;0;100;0;173500;1940.5;81.8333333333333
71388;2023;7;7;0;100;0;154258.857142857;1251.57142857143;131.571428571429
71389;2023;4;4;0;100;0;120000;1082.5;108.5
71390;2023;10;10;0;100;0;111716.9;1289.7;86.9
71391;2023;8;8;0;100;0;105561.25;1425.375;73.375
71392;2023;5;5;0;100;0;112310;1221;98.8
71393;2023;4;4;0;100;0;198000;1844;109.5
71394;2023;11;11;0;100;0;104881.818181818;982.636363636364;109.181818181818
71395;2023;1;1;0;100;0;260000;2626;99
71396;2023;11;11;0;100;0;133372.727272727;1279.90909090909;126.454545454545
71397;2023;4;4;0;100;0;138125;1414.25;99.25
71398;2023;8;8;0;100;0;123312.5;1461.25;93.625
71399;2023;7;7;0;100;0;118071.428571429;1426.14285714286;93.1428571428571
71400;2023;1;1;0;100;0;553800;4733;117
71401;2023;12;12;0;100;0;134721.666666667;1467.33333333333;97.9166666666667
71402;2023;9;9;0;100;0;200900;1707.11111111111;123.555555555556
71403;2023;4;4;0;100;0;181000;1475.5;113.25
71404;2023;6;5;1;83.3333333333333;16.6666666666667;180995;1720.33333333333;107.666666666667
71407;2023;1;1;0;100;0;110000;1122;98
71408;2023;3;3;0;100;0;121000;1061;105.333333333333
71409;2023;3;3;0;100;0;328583.333333333;1736.33333333333;163.666666666667
71410;2023;12;12;0;100;0;158369.166666667;1599;102.666666666667
71411;2023;1;1;0;100;0;173000;1730;100
71412;2023;16;16;0;100;0;124979.375;1472.4375;86.9375
71413;2023;2;2;0;100;0;106000;1165;92
71414;2023;6;6;0;100;0;106533.333333333;1059;104.5
71416;2023;10;9;1;90;10;253655;2678;109
71417;2023;7;7;0;100;0;118600;1180.57142857143;105.714285714286
71419;2023;31;28;3;90.3225806451613;9.67741935483871;164920;1586.61290322581;101.516129032258
71420;2023;23;21;2;91.304347826087;8.69565217391304;185377.826086957;1879.30434782609;103.086956521739
71421;2023;2;2;0;100;0;127075;1746;81
71422;2023;3;3;0;100;0;176166.666666667;1073;164.333333333333
71423;2023;3;3;0;100;0;253450;2038.66666666667;126.666666666667
71424;2023;4;4;0;100;0;124327.5;1162.75;90.25
71425;2023;5;5;0;100;0;182740;1727.8;102.2
71426;2023;6;6;0;100;0;182416.666666667;1610;116.5
71427;2023;1;1;0;100;0;249200;4153;60
71428;2023;4;4;0;100;0;134875;1255.5;102.25
71430;2023;4;4;0;100;0;280025;3949.25;91.25
71431;2023;5;5;0;100;0;152100;1531.4;101.8
71433;2023;8;8;0;100;0;134343.75;1233.75;107.875
71434;2023;6;6;0;100;0;201916.666666667;1469.83333333333;137.833333333333
71435;2023;5;5;0;100;0;113600;927.2;111
71436;2023;4;2;2;50;50;101275;1174.25;83.75
71437;2023;7;7;0;100;0;276347.142857143;1982.85714285714;133.714285714286
71438;2023;9;8;1;88.8888888888889;11.1111111111111;134240;1237;108.222222222222
71439;2023;4;4;0;100;0;224375;1754.5;132.25
71440;2023;9;8;1;88.8888888888889;11.1111111111111;104472.222222222;1162.66666666667;88.1111111111111
71441;2023;3;3;0;100;0;88166.6666666667;963.333333333333;98.3333333333333
71442;2023;13;13;0;100;0;146646.153846154;1481.53846153846;104.461538461538
71443;2023;18;17;1;94.4444444444444;5.55555555555556;228488.666666667;2104.77777777778;119.722222222222
71444;2023;9;9;0;100;0;174795;1710.11111111111;106.555555555556
71445;2023;58;44;14;75.8620689655172;24.1379310344828;164658.448275862;1805.8275862069;89.0344827586207
71446;2023;1;1;0;100;0;132500;1472;90
71447;2023;6;6;0;100;0;199083.333333333;1330.5;151.833333333333
71448;2023;21;19;2;90.4761904761905;9.52380952380952;194924.285714286;2006.04761904762;96.1428571428571
71449;2023;3;3;0;100;0;315200;2602.33333333333;129.666666666667
71450;2023;2;2;0;100;0;92000;1122;82
71451;2023;2;2;0;100;0;109000;1453;76
71452;2023;5;5;0;100;0;152000;1614;94.8
71453;2023;5;5;0;100;0;320970;2297.8;140.6
71454;2023;2;2;0;100;0;282500;2747.5;111.5
71455;2023;2;2;0;100;0;2,00E+05;1948.5;106
71456;2023;15;15;0;100;0;145005.666666667;1543.8;95
71459;2023;3;2;1;66.6666666666667;33.3333333333333;136833.333333333;2143.33333333333;61.3333333333333
71460;2023;8;8;0;100;0;278806.25;2788.125;102.375
71461;2023;1;1;0;100;0;210000;2100;100
71462;2023;8;8;0;100;0;181887.5;1400.5;124
71463;2023;6;6;0;100;0;189333.333333333;1474.33333333333;145.5
71464;2023;2;2;0;100;0;99000;1081.5;95.5
71465;2023;1;1;0;100;0;50000;714;70
71466;2023;1;1;0;100;0;180000;1059;170
71468;2023;9;9;0;100;0;167166.666666667;1400;122.888888888889
71469;2023;5;5;0;100;0;200695;1622.6;123.8
71470;2023;2;2;0;100;0;138750;1059.5;133
71472;2023;8;8;0;100;0;139468.375;1594.5;81.625
71473;2023;1;1;0;100;0;95000;969;98
71474;2023;1;1;0;100;0;15000;417;36
71475;2023;58;48;10;82.7586206896552;17.2413793103448;170509.844827586;1862.77586206897;90.5862068965517
71477;2023;6;6;0;100;0;143200;1225.66666666667;118.333333333333
71479;2023;14;13;1;92.8571428571429;7.14285714285714;129421.428571429;1387;89.2142857142857
71480;2023;10;10;0;100;0;107149.1;1330.9;78.9
71481;2023;11;11;0;100;0;287566.363636364;2735.09090909091;113.363636363636
71482;2023;6;6;0;100;0;123601;1541.66666666667;82
71483;2023;7;7;0;100;0;111734.285714286;1165.28571428571;92.1428571428571
71484;2023;23;22;1;95.6521739130435;4.34782608695652;173016.434782609;1668.86956521739;106.086956521739
71485;2023;3;3;0;100;0;223666.666666667;2892.33333333333;74.3333333333333
71486;2023;86;85;1;98.8372093023256;1.16279069767442;120367.162790698;1268.45348837209;91.1860465116279
71487;2023;1;1;0;100;0;110000;991;111
71488;2023;4;4;0;100;0;145875;1671.25;91
71489;2023;4;4;0;100;0;228005;2012.25;113
71490;2023;7;7;0;100;0;203715.428571429;1694.85714285714;121.142857142857
71491;2023;6;6;0;100;0;178870.5;1966.83333333333;104.666666666667
71492;2023;1;1;0;100;0;148000;1947;76
71493;2023;6;6;0;100;0;129455.333333333;1350.16666666667;99.3333333333333
71494;2023;6;5;1;83.3333333333333;16.6666666666667;272078.333333333;2935.16666666667;98.8333333333333
71495;2023;11;11;0;100;0;111824.545454545;1247.18181818182;94.1818181818182
71496;2023;1;1;0;100;0;225000;2045;110
71497;2023;14;11;3;78.5714285714286;21.4285714285714;290578.571428571;2581.14285714286;110.857142857143
71498;2023;2;2;0;100;0;142000;2346;62
71499;2023;33;33;0;100;0;132187.272727273;1276.90909090909;103.242424242424
71501;2023;1;1;0;100;0;145000;1883;77
71502;2023;4;4;0;100;0;192375;1721.25;122.75
71503;2023;1;1;0;100;0;563940;3133;180
71504;2023;1;1;0;100;0;72000;720;100
71505;2023;1;1;0;100;0;160000;1333;120
71506;2023;9;9;0;100;0;169647.222222222;1633.44444444444;110.111111111111
71508;2023;7;7;0;100;0;135371.428571429;1718.85714285714;80.7142857142857
71509;2023;4;4;0;100;0;127050;1002.25;119.25
71510;2023;7;7;0;100;0;158023.571428571;1406.85714285714;108.857142857143
71512;2023;37;32;5;86.4864864864865;13.5135135135135;162911.027027027;1819.35135135135;87.6486486486486
71513;2023;13;13;0;100;0;189946.923076923;2190.15384615385;86.7692307692308
71514;2023;5;5;0;100;0;147982;1671.8;93
71516;2023;4;4;0;100;0;146250;1986;77.75
71517;2023;2;2;0;100;0;136000;2139;70
71518;2023;6;6;0;100;0;203883.333333333;1865.66666666667;115.5
71519;2023;2;2;0;100;0;130500;1090.5;116
71520;2023;6;6;0;100;0;223783.333333333;1814.33333333333;118.166666666667
71521;2023;4;4;0;100;0;165432.5;1383;112
71522;2023;18;18;0;100;0;143064.5;1229.5;112.166666666667
71523;2023;14;14;0;100;0;131521.428571429;1425.64285714286;99.3571428571429
71524;2023;2;2;0;100;0;346600;1900;210
71525;2023;6;6;0;100;0;168500;2525.16666666667;70.6666666666667
71526;2023;3;3;0;100;0;199500;2141.66666666667;84
71527;2023;3;3;0;100;0;102733.333333333;1229.66666666667;88.6666666666667
71528;2023;17;17;0;100;0;201885.294117647;2032.58823529412;102
71529;2023;2;2;0;100;0;158250;1877;84
71530;2023;6;6;0;100;0;94000;896.333333333333;99.6666666666667
71531;2023;6;6;0;100;0;99250;1047.83333333333;91.8333333333333
71532;2023;1;1;0;100;0;130000;1970;66
71533;2023;4;3;1;75;25;140475;2153;71.25
71534;2023;2;2;0;100;0;47500;851.5;55.5
71535;2023;6;6;0;100;0;126981.666666667;1420.33333333333;88.8333333333333
71537;2023;3;3;0;100;0;129083.333333333;1340.33333333333;96.6666666666667
71538;2023;2;2;0;100;0;132870;1652.5;97
71539;2023;1;1;0;100;0;95000;950;100
71540;2023;10;9;1;90;10;125215;1150.8;110.6
71541;2023;10;10;0;100;0;166918;1621.5;110.1
71542;2023;17;14;3;82.3529411764706;17.6470588235294;85323.8235294118;1082.11764705882;77
71543;2023;74;43;31;58.1081081081081;41.8918918918919;173403.783783784;1806.48648648649;90.8108108108108
71544;2023;6;6;0;100;0;169262.5;1750.33333333333;109.666666666667
71545;2023;9;9;0;100;0;152858.888888889;1763.22222222222;89.7777777777778
71546;2023;7;7;0;100;0;136521.428571429;1391.71428571429;102.571428571429
71547;2023;3;3;0;100;0;195666.666666667;1671;109
71548;2023;3;3;0;100;0;158933.333333333;1705.33333333333;94.6666666666667
71549;2023;3;3;0;100;0;86666.6666666667;1340.33333333333;70.3333333333333
71550;2023;13;12;1;92.3076923076923;7.69230769230769;152684.846153846;1582.69230769231;102.615384615385
71551;2023;1;1;0;100;0;160000;1345;119
71552;2023;8;8;0;100;0;117387.5;1262.125;89.125
71553;2023;5;5;0;100;0;264520;2534.4;86.4
71554;2023;1;1;0;100;0;80000;964;83
71555;2023;11;11;0;100;0;227186.363636364;2168.81818181818;107
71556;2023;7;5;2;71.4285714285714;28.5714285714286;316922.428571429;2404.57142857143;130.571428571429
71557;2023;9;8;1;88.8888888888889;11.1111111111111;141557.222222222;1656.33333333333;77.8888888888889
71558;2023;15;13;2;86.6666666666667;13.3333333333333;121540;1450.33333333333;79.1333333333333
71559;2023;4;4;0;100;0;214500;1699.5;134.5
71561;2023;2;2;0;100;0;126500;1361;90
71563;2023;2;2;0;100;0;95882.5;1040.5;89
71564;2023;7;7;0;100;0;106243.142857143;1243;82.8571428571429
71565;2023;6;6;0;100;0;124483.333333333;1194.5;105.166666666667
71566;2023;9;7;2;77.7777777777778;22.2222222222222;114204.444444444;1307.22222222222;88.6666666666667
71570;2023;5;5;0;100;0;117750;1927.6;54.6
71571;2023;9;9;0;100;0;174118;1884.77777777778;96.8888888888889
71572;2023;2;2;0;100;0;139000;1566.5;89.5
71573;2023;3;3;0;100;0;92016.6666666667;1400;67
71574;2023;4;4;0;100;0;172512.5;2027.75;84.5
71576;2023;6;6;0;100;0;146833.333333333;1771.5;86.3333333333333
71578;2023;4;4;0;100;0;96473;1083.75;92.75
71579;2023;1;1;0;100;0;125000;1190;105
71580;2023;5;5;0;100;0;171050;1419.4;109.8
71581;2023;1;1;0;100;0;140000;1474;95
71582;2023;7;7;0;100;0;164571.428571429;1810.71428571429;90
71583;2023;12;12;0;100;0;348968.5;2698.25;121.166666666667
71584;2023;21;21;0;100;0;209693.19047619;2001;107.52380952381
71585;2023;4;2;2;50;50;221017.5;1727.75;114
71586;2023;2;2;0;100;0;135350;1099.5;123.5
71588;2023;6;6;0;100;0;187125;1837.83333333333;125.5
71589;2023;4;4;0;100;0;74500;950.75;74.5
71590;2023;3;3;0;100;0;280750;2589.66666666667;108.666666666667
71591;2023;5;5;0;100;0;153284;1437.4;98.8
72001;2023;13;13;0;100;0;220748.461538462;1980.38461538462;117.461538461538
72003;2023;80;52;28;65;35;128378.2125;1687.1;75.725
72004;2023;7;7;0;100;0;167992.857142857;1603;106
72005;2023;5;5;0;100;0;95400;1272.2;70.6
72006;2023;25;25;0;100;0;169454;1708.84;103.84
72007;2023;4;4;0;100;0;152000;1549.25;98.75
72008;2023;67;67;0;100;0;186550.686567164;2018.55223880597;94.6119402985075
72009;2023;4;4;0;100;0;160620.75;1369.25;134.75
72010;2023;5;5;0;100;0;116700;1172.6;96.2
72011;2023;11;11;0;100;0;98869.7272727273;1326;94.0909090909091
72012;2023;6;6;0;100;0;101333.333333333;1102.66666666667;90.8333333333333
72013;2023;33;33;0;100;0;102971.636363636;1153.21212121212;90.4242424242424
72015;2023;1;1;0;100;0;66000;1138;58
72016;2023;19;19;0;100;0;154464.736842105;1427.63157894737;114.210526315789
72017;2023;1;1;0;100;0;143000;1212;118
72018;2023;1;1;0;100;0;51000;689;74
72019;2023;7;7;0;100;0;87363.1428571429;1130.85714285714;87.2857142857143
72020;2023;5;5;0;100;0;113994.6;1350.6;82.4
72021;2023;10;10;0;100;0;127933;1484.7;91.4
72022;2023;6;6;0;100;0;113166.666666667;1330;85.6666666666667
72023;2023;35;35;0;100;0;123270.457142857;1356.25714285714;92.5428571428571
72024;2023;47;46;1;97.8723404255319;2.12765957446809;223444.680851064;2190.82978723404;105.085106382979
72025;2023;28;28;0;100;0;167812.571428571;1670.28571428571;98.8571428571429
72026;2023;19;19;0;100;0;147165.263157895;1693.68421052632;87.7368421052632
72027;2023;6;6;0;100;0;154683.333333333;1306.16666666667;116.5
72028;2023;9;9;0;100;0;182205;1409.77777777778;128.222222222222
72029;2023;27;27;0;100;0;128300;1422.74074074074;94.8518518518518
72031;2023;8;8;0;100;0;135358.75;1326.5;103.375
72032;2023;8;8;0;100;0;92792.125;1277.375;76.75
72034;2023;4;4;0;100;0;231500;1924.75;120.5
72035;2023;37;33;4;89.1891891891892;10.8108108108108;91669.1891891892;1179.75675675676;80.8108108108108
72036;2023;6;6;0;100;0;132166.666666667;1431.33333333333;97.8333333333333
72037;2023;3;3;0;100;0;139133.333333333;1145.33333333333;115
72038;2023;10;10;0;100;0;145601;1646.4;84.4
72039;2023;68;64;4;94.1176470588235;5.88235294117647;110921.617647059;1319.85294117647;84.7058823529412
72040;2023;2;2;0;100;0;192500;1799.5;98.5
72041;2023;3;3;0;100;0;132500;1275;103.666666666667
72042;2023;30;27;3;90;10;147102.4;1595.2;99.7666666666667
72043;2023;4;4;0;100;0;112525;1453.5;78.75
72044;2023;6;6;0;100;0;129865;1131;111
72045;2023;3;3;0;100;0;214166.666666667;1880.66666666667;116.666666666667
72046;2023;23;23;0;100;0;137356.826086957;1321.86956521739;99.695652173913
72047;2023;12;12;0;100;0;190750;1838.41666666667;102.75
72048;2023;3;3;0;100;0;114400;1256.66666666667;83
72049;2023;2;2;0;100;0;60000;879.5;69
72050;2023;15;14;1;93.3333333333333;6.66666666666667;157000;1647.26666666667;101.666666666667
72051;2023;34;34;0;100;0;166552.794117647;1643.35294117647;103.647058823529
72052;2023;13;13;0;100;0;110280;1018.76923076923;110.923076923077
72053;2023;2;2;0;100;0;133500;1622;79.5
72054;2023;24;24;0;100;0;195129.166666667;1872.04166666667;106.375
72056;2023;15;15;0;100;0;162866.666666667;1789.2;94.6666666666667
72057;2023;1;1;0;100;0;287290;3831;75
72058;2023;63;62;1;98.4126984126984;1.58730158730159;288980.158730159;2291.26984126984;125.746031746032
72059;2023;9;9;0;100;0;149588.888888889;1131;124.555555555556
72060;2023;2;2;0;100;0;65000;804.5;85
72061;2023;16;16;0;100;0;160585.9375;1475.4375;107
72062;2023;5;5;0;100;0;168910;1731.4;99.4
72064;2023;3;3;0;100;0;99500;1275.33333333333;86.3333333333333
72065;2023;29;27;2;93.1034482758621;6.89655172413793;199654.896551724;2193.55172413793;91.8620689655172
72066;2023;7;7;0;100;0;193142.857142857;1879.42857142857;106.857142857143
72067;2023;17;17;0;100;0;148323.529411765;1438;106.529411764706
72068;2023;30;29;1;96.6666666666667;3.33333333333333;101300.033333333;1149.2;90.1
72070;2023;1;1;0;100;0;174000;1977;88
72071;2023;85;82;3;96.4705882352941;3.52941176470588;105065.082352941;1319.95294117647;82.9529411764706
72072;2023;1;1;0;100;0;250000;1479;169
72073;2023;12;12;0;100;0;201366.833333333;2034.08333333333;101.833333333333
72074;2023;4;4;0;100;0;165750;1468.5;108.25
72075;2023;5;5;0;100;0;189500;1530.8;118.4
72076;2023;4;4;0;100;0;235750;1823.25;129.75
72077;2023;3;3;0;100;0;112333.333333333;1319;86
72078;2023;4;4;0;100;0;111875;1217.25;99.5
72079;2023;2;2;0;100;0;292500;2102.5;146.5
72080;2023;24;24;0;100;0;189270.833333333;1720.33333333333;114.791666666667
72083;2023;4;4;0;100;0;150000;1784.25;103.25
72084;2023;16;16;0;100;0;161968.75;1713.25;96.9375
72085;2023;6;6;0;100;0;87500;1037;77.5
72087;2023;6;6;0;100;0;54083.3333333333;764.666666666667;70.5
72088;2023;6;6;0;100;0;130008.333333333;1135.83333333333;112.666666666667
72089;2023;36;36;0;100;0;149749.305555556;1674;93.9444444444444
72090;2023;49;49;0;100;0;123009.244897959;1506.79591836735;83.0204081632653
72091;2023;2;2;0;100;0;187500;1432.5;125
72093;2023;8;8;0;100;0;151750;1362.625;117
72094;2023;10;10;0;100;0;119900;1140.5;106.4
72095;2023;57;38;19;66.6666666666667;33.3333333333333;195813.98245614;2049.49122807018;94
72096;2023;14;14;0;100;0;162189.285714286;1744;96.1428571428571
72098;2023;4;4;0;100;0;141750;1247.75;120.75
72099;2023;11;11;0;100;0;149681.818181818;1558.72727272727;102.454545454545
72100;2023;3;3;0;100;0;90666.6666666667;1375.66666666667;69.3333333333333
72101;2023;11;11;0;100;0;110159.090909091;1446.18181818182;78.3636363636364
72103;2023;9;8;1;88.8888888888889;11.1111111111111;78594.4444444444;916.888888888889;85.3333333333333
72104;2023;7;7;0;100;0;104285.714285714;910.571428571429;106.285714285714
72105;2023;6;6;0;100;0;78833.3333333333;958.166666666667;82.5
72106;2023;5;5;0;100;0;138515.6;1491.6;91.8
72107;2023;2;2;0;100;0;110100;1376;96
72109;2023;4;4;0;100;0;95752.5;1339;71.25
72110;2023;9;9;0;100;0;155777.777777778;1414.88888888889;108.444444444444
72111;2023;3;3;0;100;0;146166.666666667;1284.33333333333;127
72112;2023;10;10;0;100;0;114900;1361.3;83.9
72113;2023;5;5;0;100;0;184600;1528.2;118.4
72114;2023;1;1;0;100;0;1,00E+05;1667;60
72115;2023;16;16;0;100;0;128195.8125;1266.5;105.375
72118;2023;12;12;0;100;0;86875;1176.08333333333;83.5833333333333
72119;2023;24;24;0;100;0;167235.416666667;1553;105.375
72120;2023;2;2;0;100;0;150500;1519.5;101.5
72121;2023;5;5;0;100;0;112520;1226;89.4
72122;2023;5;5;0;100;0;165000;1941;91
72124;2023;50;47;3;94;6;163391.4;1625.28;102.88
72125;2023;1;1;0;100;0;61344;697;88
72126;2023;1;1;0;100;0;40000;449;89
72127;2023;15;15;0;100;0;155850;1848.06666666667;85.6666666666667
72128;2023;1;1;0;100;0;55000;561;98
72129;2023;9;9;0;100;0;193833.333333333;1828.33333333333;108.888888888889
72130;2023;10;10;0;100;0;228700;2024.8;110
72131;2023;11;11;0;100;0;124743.636363636;2057.63636363636;67.5454545454545
72132;2023;109;81;28;74.3119266055046;25.6880733944954;147398.449541284;1667.64220183486;87.9908256880734
72133;2023;11;11;0;100;0;195818.181818182;1904.45454545455;101.818181818182
72134;2023;12;12;0;100;0;84000;1008.91666666667;87.5833333333333
72135;2023;7;7;0;100;0;156314.285714286;1371.28571428571;96.7142857142857
72136;2023;5;5;0;100;0;206513.6;1317.4;175.8
72137;2023;20;20;0;100;0;162633.6;1587.7;109.15
72138;2023;41;40;1;97.5609756097561;2.4390243902439;115616.146341463;1250.65853658537;91.6829268292683
72139;2023;10;10;0;100;0;126500;1095.9;124.7
72141;2023;9;9;0;100;0;99444.4444444444;855.222222222222;102.222222222222
72142;2023;3;3;0;100;0;142500;1123;121.666666666667
72143;2023;23;23;0;100;0;127268.260869565;1149.82608695652;100.217391304348
72144;2023;11;11;0;100;0;120385.909090909;1100.45454545455;99.7272727272727
72146;2023;31;31;0;100;0;203823.387096774;1934.67741935484;108.806451612903
72147;2023;12;12;0;100;0;163333.333333333;1546.41666666667;105.166666666667
72148;2023;2;2;0;100;0;150000;954;162
72149;2023;4;4;0;100;0;110475;1393;82.25
72150;2023;17;17;0;100;0;183051.352941176;1761.17647058824;106.470588235294
72151;2023;9;9;0;100;0;172677.777777778;1486;111
72152;2023;4;4;0;100;0;131625;1535.75;85.5
72153;2023;13;13;0;100;0;128384.615384615;1259.53846153846;110.230769230769
72154;2023;167;147;20;88.0239520958084;11.9760479041916;172325.874251497;1803.19760479042;98.6047904191617
72155;2023;19;19;0;100;0;172441.578947368;1905.05263157895;94.6315789473684
72156;2023;9;9;0;100;0;133777.777777778;1348.88888888889;99.2222222222222
72157;2023;10;10;0;100;0;288314;2053.1;138.2
72158;2023;15;15;0;100;0;111420;1422.53333333333;76.3333333333333
72160;2023;7;7;0;100;0;122000;1715.57142857143;77.4285714285714
72161;2023;18;18;0;100;0;106194.5;1345.27777777778;77.8888888888889
72163;2023;8;8;0;100;0;183364.375;1768.25;102.625
72164;2023;1;1;0;100;0;459850;2299;200
72165;2023;26;26;0;100;0;189800;1698;113.5
72166;2023;7;7;0;100;0;130808.571428571;1529.57142857143;87.5714285714286
72167;2023;10;10;0;100;0;132000;1325.6;101.6
72168;2023;40;40;0;100;0;110042.25;1264.725;86.575
72169;2023;9;9;0;100;0;143588.888888889;1933.77777777778;79.2222222222222
72170;2023;3;3;0;100;0;164000;1463;101.666666666667
72171;2023;2;2;0;100;0;143000;1182;121
72172;2023;34;34;0;100;0;140329.411764706;1584.91176470588;90.4117647058823
72173;2023;12;12;0;100;0;125629.166666667;1454.25;86.1666666666667
72174;2023;2;2;0;100;0;120975;953.5;126
72175;2023;19;19;0;100;0;128930.631578947;1426.63157894737;90.2631578947368
72176;2023;69;69;0;100;0;121397.391304348;1285.05797101449;90.5797101449275
72177;2023;11;11;0;100;0;162081.818181818;1354;110.727272727273
72178;2023;1;1;0;100;0;50000;407;123
72179;2023;29;29;0;100;0;134430.793103448;1428.03448275862;92.1724137931034
72180;2023;85;79;6;92.9411764705882;7.05882352941176;94779.8235294118;1057.83529411765;87.8941176470588
72181;2023;2225;1061;1164;47.685393258427;52.314606741573;155148.575730337;2136.73842696629;72.7613483146067
72182;2023;24;24;0;100;0;105210;1334.79166666667;78.25
72183;2023;12;12;0;100;0;138050;1291.91666666667;106.25
72184;2023;1;1;0;100;0;192000;1730;111
72185;2023;7;7;0;100;0;89860;1230.14285714286;68.8571428571429
72186;2023;10;10;0;100;0;111099;1366.5;79.8
72187;2023;20;20;0;100;0;151462.1;1538.65;97.1
72188;2023;2;2;0;100;0;203500;1578;118.5
72189;2023;35;35;0;100;0;101228.857142857;1118.62857142857;90
72190;2023;2;2;0;100;0;133000;1076;106.5
72191;2023;41;41;0;100;0;147737.073170732;1534.82926829268;100.073170731707
72193;2023;7;7;0;100;0;81700;1019.42857142857;78.5714285714286
72194;2023;2;2;0;100;0;127500;991.5;131
72195;2023;20;20;0;100;0;128618.65;1417.45;93.7
72196;2023;14;13;1;92.8571428571429;7.14285714285714;116628.571428571;1239.07142857143;92.5
72197;2023;10;10;0;100;0;172000;1604.6;111.3
72198;2023;27;27;0;100;0;271104.296296296;2487;110.666666666667
72199;2023;4;4;0;100;0;83175;1399;72.25
72200;2023;33;33;0;100;0;206611.424242424;2020.06060606061;104.393939393939
72201;2023;3;3;0;100;0;101000;935.666666666667;106.666666666667
72202;2023;3;3;0;100;0;158666.666666667;2554.66666666667;67
72204;2023;9;9;0;100;0;112966.666666667;1257.44444444444;91.8888888888889
72205;2023;28;27;1;96.4285714285714;3.57142857142857;189803.571428571;1770.32142857143;106.678571428571
72208;2023;6;6;0;100;0;141833.333333333;1649.66666666667;79
72209;2023;7;7;0;100;0;101371.428571429;902.857142857143;113.571428571429
72210;2023;7;7;0;100;0;132471.428571429;1277.57142857143;98.2857142857143
72211;2023;7;7;0;100;0;109061.428571429;1087;97.8571428571429
72212;2023;7;7;0;100;0;122335.714285714;1744.71428571429;70.1428571428571
72213;2023;54;52;2;96.2962962962963;3.7037037037037;189099.074074074;2200.62962962963;92.3148148148148
72215;2023;12;12;0;100;0;89291.6666666667;1131.16666666667;78.1666666666667
72216;2023;5;5;0;100;0;151300;2096.4;82.2
72217;2023;22;22;0;100;0;248268.863636364;2601.18181818182;103.909090909091
72218;2023;5;5;0;100;0;149662;1621;95
72219;2023;4;4;0;100;0;134750;1167;111.25
72220;2023;16;16;0;100;0;167062;1646.1875;101.5
72221;2023;5;5;0;100;0;79670;1033;92.2
72222;2023;3;3;0;100;0;115000;983;113
72223;2023;33;33;0;100;0;106664.545454545;1354.93939393939;82.4848484848485
72224;2023;3;3;0;100;0;131000;1470.66666666667;93
72225;2023;4;4;0;100;0;171912.5;2924.5;95.75
72226;2023;16;16;0;100;0;155972.625;1598.125;96.0625
72228;2023;27;27;0;100;0;140855.555555556;1770.37037037037;87.2592592592593
72229;2023;3;3;0;100;0;98666.6666666667;716.666666666667;136.333333333333
72230;2023;10;10;0;100;0;141460;1422.4;103
72231;2023;50;50;0;100;0;185653.8;1873.8;101
72232;2023;5;5;0;100;0;152800;1508.4;99
72233;2023;1;1;0;100;0;74370;1180;63
72234;2023;5;5;0;100;0;80093.4;1087.8;104.8
72235;2023;3;3;0;100;0;147333.333333333;1681.33333333333;91.3333333333333
72236;2023;3;3;0;100;0;153333.333333333;1155.66666666667;125.666666666667
72237;2023;3;3;0;100;0;141833.333333333;1653.66666666667;77.3333333333333
72238;2023;1;1;0;100;0;87000;1000;87
72239;2023;2;2;0;100;0;123722.5;903;133.5
72241;2023;33;33;0;100;0;156806.060606061;1708.78787878788;91.0909090909091
72243;2023;19;19;0;100;0;144812.736842105;1322.89473684211;102.368421052632
72244;2023;42;32;10;76.1904761904762;23.8095238095238;121239.047619048;1645.45238095238;75.0476190476191
72245;2023;8;8;0;100;0;137437.5;1535;87.75
72246;2023;5;5;0;100;0;126500;1548.8;84.2
72247;2023;9;9;0;100;0;249132.777777778;2798.66666666667;93.7777777777778
72248;2023;11;11;0;100;0;162727.272727273;1501.72727272727;117.272727272727
72249;2023;10;10;0;100;0;170250;1736.5;99.1
72250;2023;4;4;0;100;0;102250;1140.25;92.75
72251;2023;5;5;0;100;0;123400;1396;88.4
72252;2023;8;8;0;100;0;143523.75;1453.875;103.5
72253;2023;20;20;0;100;0;136190.5;1531.55;88.15
72254;2023;4;4;0;100;0;131046.75;1487.5;87.25
72255;2023;7;7;0;100;0;80311.4285714286;1080.42857142857;75.5714285714286
72256;2023;7;7;0;100;0;63982.1428571429;904.714285714286;70.1428571428571
72257;2023;16;16;0;100;0;359065.4375;2657.375;132.8125
72259;2023;3;3;0;100;0;94333.3333333333;1167.33333333333;80
72260;2023;37;34;3;91.8918918918919;8.10810810810811;213204.189189189;2066.7027027027;106.324324324324
72261;2023;3;3;0;100;0;128333.333333333;1332;99
72262;2023;34;33;1;97.0588235294118;2.94117647058824;118840.735294118;1433.67647058824;83.4117647058823
72264;2023;111;94;17;84.6846846846847;15.3153153153153;119529.630630631;1491.42342342342;83.3153153153153
72265;2023;5;5;0;100;0;101200;858;112
72266;2023;12;12;0;100;0;135100;1535;91.75
72267;2023;11;11;0;100;0;135490.909090909;1542.63636363636;92.2727272727273
72268;2023;8;7;1;87.5;12.5;166625;1530.5;103.75
72269;2023;45;44;1;97.7777777777778;2.22222222222222;84715.7777777778;1134.86666666667;77.5777777777778
72270;2023;1;1;0;100;0;140000;1053;133
72271;2023;15;15;0;100;0;143533.333333333;1429.86666666667;99.6666666666667
72272;2023;6;6;0;100;0;114333.333333333;1235.33333333333;100
72273;2023;2;2;0;100;0;168000;1681.5;100
72274;2023;1;1;0;100;0;160000;1379;116
72275;2023;15;15;0;100;0;196556.533333333;1930.73333333333;102
72276;2023;38;38;0;100;0;128016.184210526;1343.78947368421;93.5789473684211
72277;2023;1;1;0;100;0;130000;1548;84
72278;2023;15;15;0;100;0;97450.1333333333;1085.66666666667;95.0666666666667
72279;2023;3;3;0;100;0;135000;1272;92
72280;2023;15;14;1;93.3333333333333;6.66666666666667;211070;2183.2;97.4666666666667
72281;2023;7;7;0;100;0;114571.428571429;1482.28571428571;76
72282;2023;14;14;0;100;0;93846.4285714286;1013.78571428571;90.7857142857143
72283;2023;5;5;0;100;0;177400;1400.4;119.6
72286;2023;5;5;0;100;0;150200;1462.6;98.6
72287;2023;11;11;0;100;0;205804.545454545;2073.18181818182;101.454545454545
72289;2023;20;20;0;100;0;145618;1549.2;94.9
72290;2023;24;24;0;100;0;144865.833333333;1431.45833333333;100.166666666667
72291;2023;13;13;0;100;0;122969.461538462;1208.92307692308;101.538461538462
72292;2023;5;5;0;100;0;193600;1655.4;94
72293;2023;11;11;0;100;0;109954.545454545;1226.09090909091;87
72294;2023;8;8;0;100;0;65996.25;1051.875;66.5
72295;2023;4;4;0;100;0;114437.25;1321.25;84.75
72296;2023;12;12;0;100;0;120545.833333333;1362;87
72297;2023;6;6;0;100;0;169983.333333333;1648.5;104.833333333333
72298;2023;4;4;0;100;0;198300;1199.75;139.25
72299;2023;24;24;0;100;0;132819.666666667;1383.16666666667;96.875
72300;2023;30;30;0;100;0;148413.666666667;1713.63333333333;89.3666666666667
72303;2023;17;17;0;100;0;119144.588235294;1331.94117647059;88.3529411764706
72305;2023;13;13;0;100;0;137829.230769231;1282.15384615385;92.6153846153846
72306;2023;12;12;0;100;0;173479.166666667;1505.08333333333;119.333333333333
72307;2023;3;3;0;100;0;167166.666666667;1343.66666666667;127.333333333333
72308;2023;29;29;0;100;0;194718.137931034;1766.72413793103;107.586206896552
72309;2023;2;2;0;100;0;245395;1590;146.5
72310;2023;18;18;0;100;0;261630.555555556;2369.94444444444;114.388888888889
72311;2023;7;7;0;100;0;71714.2857142857;974.571428571429;76.1428571428571
72312;2023;3;3;0;100;0;130000;1182.33333333333;111
72313;2023;4;4;0;100;0;124750;1427;86.25
72314;2023;3;3;0;100;0;81453.3333333333;901.666666666667;91
72315;2023;10;10;0;100;0;85718.4;1066.9;78.7
72316;2023;8;8;0;100;0;150093.75;1186;126
72317;2023;5;5;0;100;0;160841.6;1297.8;117.4
72319;2023;10;10;0;100;0;186405;1833.3;105.2
72320;2023;18;18;0;100;0;259103.277777778;2237.5;117.888888888889
72321;2023;7;7;0;100;0;126285.714285714;1322.85714285714;95.4285714285714
72322;2023;4;4;0;100;0;104650;1311.25;82
72323;2023;5;5;0;100;0;152454.4;1272;123.6
72324;2023;4;4;0;100;0;55000;984.5;58
72325;2023;12;12;0;100;0;116955;1237.5;97.8333333333333
72326;2023;1;1;0;100;0;249500;2935;85
72327;2023;3;3;0;100;0;126666.666666667;1200.33333333333;105
72328;2023;41;41;0;100;0;255436.341463415;2369.58536585366;107.414634146341
72329;2023;30;30;0;100;0;178449.666666667;2023.73333333333;88.8333333333333
72330;2023;4;4;0;100;0;112250;1635.5;70
72331;2023;8;8;0;100;0;149106.875;1535.5;96
72332;2023;4;4;0;100;0;102250;853.75;114.75
72333;2023;9;9;0;100;0;86496.8888888889;980.222222222222;85.6666666666667
72334;2023;28;27;1;96.4285714285714;3.57142857142857;103998.214285714;1014.07142857143;100.5
72335;2023;13;13;0;100;0;190628.230769231;1809.46153846154;106.307692307692
72336;2023;18;18;0;100;0;158511.111111111;1512.11111111111;108.888888888889
72337;2023;17;17;0;100;0;134048.411764706;1394.23529411765;103.705882352941
72338;2023;7;7;0;100;0;224857.142857143;1949;119.571428571429
72339;2023;10;10;0;100;0;172000;1653.3;110.7
72340;2023;6;6;0;100;0;141816.666666667;1481;98.3333333333333
72341;2023;11;11;0;100;0;256818.181818182;2146;119.818181818182
72342;2023;1;1;0;100;0;149500;1738;86
72343;2023;3;3;0;100;0;99566.6666666667;1220;80
72344;2023;30;30;0;100;0;220970;2078.43333333333;106.266666666667
72345;2023;3;3;0;100;0;67666.6666666667;1062.33333333333;68
72346;2023;51;46;5;90.1960784313726;9.80392156862745;153081.568627451;1723.52941176471;86.4117647058823
72347;2023;5;5;0;100;0;135800;1237;107
72348;2023;4;4;0;100;0;179362.5;1334;126.25
72349;2023;8;8;0;100;0;115812.5;1325.5;85.75
72350;2023;29;29;0;100;0;191327.586206897;1904.8275862069;100.068965517241
72351;2023;13;13;0;100;0;128053.846153846;1285.84615384615;96.3076923076923
72352;2023;1;1;0;100;0;45000;692;65
72353;2023;5;5;0;100;0;208000;1867;113.6
72354;2023;2;2;0;100;0;93500;1123.5;83
72355;2023;2;2;0;100;0;196250;2610.5;92
72356;2023;6;6;0;100;0;146833.333333333;1233.83333333333;135.333333333333
72357;2023;11;11;0;100;0;150090.909090909;1423.54545454545;104
72358;2023;18;18;0;100;0;162250;1560.16666666667;105.333333333333
72359;2023;16;16;0;100;0;172327.5;1497.75;113.4375
72360;2023;11;11;0;100;0;332789.363636364;2374.54545454545;135.090909090909
72361;2023;7;7;0;100;0;88000;1294.71428571429;70.4285714285714
72363;2023;26;25;1;96.1538461538462;3.84615384615385;175317.846153846;1606.61538461538;107.461538461538
72364;2023;26;26;0;100;0;103410.461538462;1329.38461538462;78.1923076923077
72366;2023;8;8;0;100;0;69000;1055.375;72.75
72367;2023;7;7;0;100;0;158585.714285714;1180.28571428571;122.714285714286
72368;2023;7;7;0;100;0;70280;897.571428571429;79.1428571428571
72369;2023;8;8;0;100;0;142062.625;1329.75;112.375
72370;2023;4;4;0;100;0;98636.75;1081.75;103.5
72372;2023;1;1;0;100;0;60000;822;73
72373;2023;32;31;1;96.875;3.125;113120.3125;1457.96875;82.25
72374;2023;3;3;0;100;0;116233.333333333;1229;84.6666666666667
72375;2023;6;6;0;100;0;136583.333333333;1384.66666666667;104.833333333333
72376;2023;8;8;0;100;0;112421.25;1241.375;85.625
72377;2023;11;11;0;100;0;148136.363636364;1635.81818181818;92.1818181818182
72378;2023;12;12;0;100;0;163750;1620.5;102.166666666667
72379;2023;1;1;0;100;0;160000;2222;72
72380;2023;11;11;0;100;0;149072.727272727;1412.90909090909;101.818181818182
72381;2023;12;12;0;100;0;209833.333333333;1692.33333333333;127.25
72382;2023;7;7;0;100;0;175857.142857143;1594.71428571429;112.285714285714
72383;2023;1;1;0;100;0;170000;1453;117
72385;2023;35;35;0;100;0;159078.857142857;1654.91428571429;100.457142857143
72386;2023;45;45;0;100;0;253981.111111111;2132.8;121.577777777778
73001;2023;2;2;0;100;0;512397.5;3392;158.5
73003;2023;32;17;15;53.125;46.875;232641.25;2878.84375;82.625
73004;2023;26;6;20;23.0769230769231;76.9230769230769;102500.192307692;2339.23076923077;41.8846153846154
73005;2023;1;0;1;0;100;101250;596;170
73006;2023;118;28;90;23.728813559322;76.271186440678;196566.56779661;4211.60169491525;49.0338983050847
73007;2023;15;13;2;86.6666666666667;13.3333333333333;240665.333333333;2606.26666666667;91.8666666666667
73008;2023;601;76;525;12.6455906821963;87.3544093178037;264944.397670549;4513.35274542429;60.216306156406
73010;2023;60;40;20;66.6666666666667;33.3333333333333;320314.833333333;3648.81666666667;92.0333333333333
73011;2023;307;41;266;13.3550488599349;86.6449511400651;161880.61237785;2349.74918566775;70.3615635179153
73012;2023;2;2;0;100;0;234055;4028.5;57
73013;2023;28;5;23;17.8571428571429;82.1428571428571;140878.035714286;3043.39285714286;47.1071428571429
73014;2023;2;2;0;100;0;395750;3127;126.5
73015;2023;126;9;117;7.14285714285714;92.8571428571429;518773.952380952;10169.8015873016;49.7698412698413
73017;2023;2;2;0;100;0;174550;2386;70.5
73018;2023;4;2;2;50;50;249250;2917.5;82
73019;2023;8;8;0;100;0;154856.5;1860.25;92.5
73020;2023;5;5;0;100;0;360917;3691.8;94.6
73021;2023;8;7;1;87.5;12.5;218506.25;2381;93.875
73022;2023;6;6;0;100;0;286819.166666667;2661.33333333333;113.333333333333
73023;2023;25;2;23;8;92;147115.2;3745.52;38.8
73024;2023;67;9;58;13.4328358208955;86.5671641791045;199347.089552239;5016.38805970149;40
73025;2023;9;9;0;100;0;240972.222222222;2715.55555555556;96.6666666666667
73026;2023;2;2;0;100;0;256650;2667;90.5
73027;2023;4;4;0;100;0;330670;3469.5;96.5
73028;2023;1;1;0;100;0;110000;1571;70
73029;2023;39;15;24;38.4615384615385;61.5384615384615;306752.358974359;3760.05128205128;81.4358974358974
73030;2023;42;8;34;19.047619047619;80.9523809523809;252302.071428571;3520.19047619048;73.0238095238095
73031;2023;56;15;41;26.7857142857143;73.2142857142857;304864.232142857;3791.5;79.8214285714286
73032;2023;20;17;3;85;15;216135.65;2379.05;91.45
73033;2023;7;7;0;100;0;297017.714285714;2484.71428571429;118.857142857143
73034;2023;39;13;26;33.3333333333333;66.6666666666667;302624;5411.17948717949;58.6666666666667
73036;2023;2;2;0;100;0;316500;3927.5;78
73039;2023;2;2;0;100;0;279450;2309;121.5
73040;2023;3;0;3;0;100;184000;4390.33333333333;40.6666666666667
73041;2023;1;1;0;100;0;279880;1666;168
73042;2023;3;3;0;100;0;479760;4225.66666666667;114.333333333333
73043;2023;26;20;6;76.9230769230769;23.0769230769231;390968.461538462;3916.96153846154;101.5
73047;2023;4;3;1;75;25;372872.5;7594.75;53.5
73048;2023;4;4;0;100;0;180515;1610;102.5
73049;2023;1;1;0;100;0;44600;2973;15
73050;2023;9;6;3;66.6666666666667;33.3333333333333;543425.666666667;5766.44444444444;95.5555555555556
73051;2023;40;7;33;17.5;82.5;315034.8;4471.825;66.025
73052;2023;3;3;0;100;0;163883.333333333;2422;63.3333333333333
73053;2023;5;5;0;100;0;339522;2969.8;113.8
73054;2023;245;21;224;8.57142857142857;91.4285714285714;216380.412244898;5218.17959183673;42.265306122449
73055;2023;29;11;18;37.9310344827586;62.0689655172414;397726.517241379;5279.58620689655;76.1724137931034
73057;2023;43;1;42;2.32558139534884;97.6744186046512;133179.697674419;4031.72093023256;32.8604651162791
73058;2023;20;15;5;75;25;219007.5;2386.95;98.75
73059;2023;29;23;6;79.3103448275862;20.6896551724138;497463.862068966;5224.51724137931;93.6896551724138
73061;2023;3;2;1;66.6666666666667;33.3333333333333;215716.666666667;2324.33333333333;102.333333333333
73063;2023;6;6;0;100;0;146988.333333333;2360;68.8333333333333
73064;2023;59;25;34;42.3728813559322;57.6271186440678;330563.423728814;4043.59322033898;81.7627118644068
73065;2023;826;83;743;10.0484261501211;89.9515738498789;211761.489104116;3159.13801452784;68.3268765133172
73067;2023;15;8;7;53.3333333333333;46.6666666666667;222299.666666667;2340.93333333333;96.6
73068;2023;3;3;0;100;0;208900;3866.66666666667;53
73069;2023;13;12;1;92.3076923076923;7.69230769230769;262998.461538462;2616;103.307692307692
73070;2023;3;3;0;100;0;210070;2033.33333333333;103.333333333333
73071;2023;29;5;24;17.2413793103448;82.7586206896552;243744.275862069;5536.68965517241;44.6206896551724
73073;2023;9;9;0;100;0;257965.111111111;4124;99.6666666666667
73074;2023;6;6;0;100;0;142333.333333333;1597;90.3333333333333
73075;2023;7;7;0;100;0;410678.571428571;3189.28571428571;131.857142857143
73076;2023;5;4;1;80;20;434632;4415.4;98.4
73077;2023;7;7;0;100;0;422864.285714286;3808.42857142857;109.428571428571
73078;2023;1;1;0;100;0;30000;625;48
73079;2023;11;11;0;100;0;293020;3017;95.5454545454545
73081;2023;13;9;4;69.2307692307692;30.7692307692308;298414.384615385;3300.53846153846;88.3846153846154
73082;2023;6;3;3;50;50;251564.166666667;3190;79.3333333333333
73083;2023;4;4;0;100;0;178000;2723.25;84.5
73084;2023;3;2;1;66.6666666666667;33.3333333333333;300933;2474;130
73085;2023;22;13;9;59.0909090909091;40.9090909090909;342607.409090909;3246.40909090909;109.363636363636
73086;2023;3;3;0;100;0;294327.333333333;2196.33333333333;127.666666666667
73087;2023;72;13;59;18.0555555555556;81.9444444444444;236773.527777778;3145.88888888889;77.2916666666667
73088;2023;14;2;12;14.2857142857143;85.7142857142857;305762.857142857;5375.85714285714;55.3571428571429
73089;2023;11;10;1;90.9090909090909;9.09090909090909;275409.090909091;2531.81818181818;109.090909090909
73090;2023;3;3;0;100;0;103063.333333333;1809.66666666667;56.6666666666667
73091;2023;1;1;0;100;0;425000;7870;54
73092;2023;3;3;0;100;0;256633.333333333;2492.33333333333;99.6666666666667
73094;2023;14;6;8;42.8571428571429;57.1428571428571;513972.857142857;6850.78571428571;72.5
73095;2023;4;4;0;100;0;226031.25;2330.25;88.25
73096;2023;9;9;0;100;0;238902.222222222;3199.11111111111;74.3333333333333
73097;2023;6;4;2;66.6666666666667;33.3333333333333;378798.333333333;4212.16666666667;98
73098;2023;29;14;15;48.2758620689655;51.7241379310345;300475.137931034;4832.37931034483;65.6206896551724
73099;2023;2;2;0;100;0;224400;4251;69.5
73100;2023;17;16;1;94.1176470588235;5.88235294117647;260332.941176471;2231.41176470588;117.176470588235
73101;2023;2;2;0;100;0;153000;1549;96.5
73103;2023;32;20;12;62.5;37.5;438470.46875;4602.71875;98.25
73104;2023;11;9;2;81.8181818181818;18.1818181818182;240763.636363636;2047.63636363636;114.272727272727
73105;2023;13;5;8;38.4615384615385;61.5384615384615;144494.615384615;1769.92307692308;81.6153846153846
73106;2023;3;3;0;100;0;96333.3333333333;1273.33333333333;93.6666666666667
73107;2023;7;5;2;71.4285714285714;28.5714285714286;117188.571428571;2092.71428571429;58
73109;2023;8;6;2;75;25;156350;1978.625;81.25
73110;2023;3;2;1;66.6666666666667;33.3333333333333;155866.666666667;2076.33333333333;82.6666666666667
73114;2023;21;2;19;9.52380952380952;90.4761904761905;188387.047619048;3832.95238095238;46.8571428571429
73116;2023;73;8;65;10.958904109589;89.041095890411;131861.863013699;3540.16438356164;36.6164383561644
73117;2023;7;0;7;0;100;72307.1428571429;1047.14285714286;71.1428571428571
73119;2023;2;1;1;50;50;216300;1649;128.5
73120;2023;9;9;0;100;0;247035.555555556;2964.22222222222;96.2222222222222
73121;2023;16;7;9;43.75;56.25;218291.875;2308.75;92
73122;2023;5;5;0;100;0;372218;3301;116
73123;2023;18;3;15;16.6666666666667;83.3333333333333;237136;4791.94444444444;52.7222222222222
73124;2023;28;21;7;75;25;315619.392857143;2812.82142857143;113.714285714286
73128;2023;34;20;14;58.8235294117647;41.1764705882353;417272.794117647;4046.79411764706;102.529411764706
73129;2023;17;15;2;88.2352941176471;11.7647058823529;199047.823529412;2571.88235294118;80.4705882352941
73130;2023;16;15;1;93.75;6.25;253242.8125;2560.3125;95.625
73131;2023;5;5;0;100;0;329602;2685.2;140.4
73132;2023;68;4;64;5.88235294117647;94.1176470588235;279071.75;7107.17647058824;39.1029411764706
73133;2023;3;3;0;100;0;362000;3326.33333333333;108.666666666667
73135;2023;18;15;3;83.3333333333333;16.6666666666667;153094.444444444;2036.05555555556;80.3333333333333
73137;2023;36;4;32;11.1111111111111;88.8888888888889;245721.833333333;4031.22222222222;61.6944444444444
73138;2023;5;5;0;100;0;342040.2;3639.8;91.2
73139;2023;2;2;0;100;0;157310;4102.5;39
73140;2023;1;1;0;100;0;20000;400;50
73141;2023;5;5;0;100;0;184166;2266;80
73142;2023;20;3;17;15;85;330419.6;5623.75;59.45
73145;2023;3;3;0;100;0;343210;3463.66666666667;96.6666666666667
73146;2023;8;5;3;62.5;37.5;297610.625;3275;90.625
73147;2023;2;2;0;100;0;164000;2654;62
73149;2023;4;4;0;100;0;254123.75;2463.5;114
73150;2023;286;27;259;9.44055944055944;90.5594405594406;180928.800699301;4932.58391608392;37.9160839160839
73151;2023;29;22;7;75.8620689655172;24.1379310344828;355700.344827586;3860.20689655172;90.8965517241379
73152;2023;3;3;0;100;0;349350;3237.33333333333;111
73153;2023;9;7;2;77.7777777777778;22.2222222222222;315201.888888889;2997.66666666667;106.888888888889
73154;2023;35;22;13;62.8571428571429;37.1428571428571;354278.742857143;3661;100.714285714286
73155;2023;22;6;16;27.2727272727273;72.7272727272727;378192.863636364;4568.27272727273;80.8181818181818
73157;2023;100;2;98;2;98;82350.57;2158.97;43.76
73159;2023;4;4;0;100;0;241515.5;2028.75;117.25
73160;2023;12;9;3;75;25;441440.583333333;3820.25;121.916666666667
73161;2023;5;5;0;100;0;208009;2514.2;84
73162;2023;2;2;0;100;0;458207.5;2804;147
73164;2023;6;6;0;100;0;487516.666666667;4155.16666666667;122.333333333333
73168;2023;5;5;0;100;0;121800;1874.6;62.4
73170;2023;2;2;0;100;0;162257.5;1640.5;74.5
73171;2023;42;8;34;19.047619047619;80.9523809523809;217652.738095238;2566.54761904762;86.0476190476191
73173;2023;5;3;2;60;40;107400;1476.8;79.4
73175;2023;8;8;0;100;0;144547.875;2508.5;64.875
73176;2023;65;9;56;13.8461538461538;86.1538461538462;262142.292307692;5708.43076923077;49.2769230769231
73177;2023;1;1;0;100;0;556300;3612;154
73178;2023;3;3;0;100;0;218410;2335.33333333333;91.3333333333333
73179;2023;105;26;79;24.7619047619048;75.2380952380952;295106.161904762;3762.99047619048;78.0857142857143
73180;2023;7;7;0;100;0;231288.857142857;2469;98.1428571428571
73181;2023;43;6;37;13.953488372093;86.046511627907;152785.023255814;2114.88372093023;78.0697674418605
73182;2023;18;16;2;88.8888888888889;11.1111111111111;571215.611111111;4898.66666666667;117.888888888889
73183;2023;15;8;7;53.3333333333333;46.6666666666667;334814.466666667;4346;82
73184;2023;3;3;0;100;0;332666.666666667;3819.33333333333;85.6666666666667
73186;2023;35;3;32;8.57142857142857;91.4285714285714;203951.6;5239.14285714286;39.7428571428571
73187;2023;34;19;15;55.8823529411765;44.1176470588235;133156.823529412;2550.44117647059;60.3529411764706
73188;2023;5;5;0;100;0;138000;1980.2;64.6
73189;2023;5;4;1;80;20;293296;2954.8;104.4
73190;2023;10;6;4;60;40;177416;2655.1;66.7
73191;2023;16;12;4;75;25;274510.3125;3090.875;88.4375
73192;2023;3;3;0;100;0;305543.333333333;3886.66666666667;82
73193;2023;2;2;0;100;0;2,00E+05;3142;63.5
73194;2023;34;4;30;11.7647058823529;88.2352941176471;95818.6764705882;2631.67647058824;40.2058823529412
73196;2023;8;7;1;87.5;12.5;290431.25;2830.75;98
73197;2023;29;8;21;27.5862068965517;72.4137931034483;435117;5453.68965517241;75.2068965517241
73200;2023;5;4;1;80;20;311830;3305.2;94.2
73201;2023;10;5;5;50;50;184856.5;2331.8;77.6
73202;2023;1;1;0;100;0;265000;3442;77
73204;2023;29;12;17;41.3793103448276;58.6206896551724;165345.344827586;1920.55172413793;84.2758620689655
73206;2023;23;7;16;30.4347826086957;69.5652173913043;372237.391304348;5370.47826086957;60.5217391304348
73207;2023;3;3;0;100;0;167933.333333333;2507.33333333333;56.6666666666667
73208;2023;14;13;1;92.8571428571429;7.14285714285714;748336.428571429;4631.5;151.571428571429
73210;2023;2;2;0;100;0;290800;2972;93
73211;2023;16;13;3;81.25;18.75;314517.5625;3977.875;85.125
73212;2023;20;14;6;70;30;159308.65;1956.15;82.25
73213;2023;100;27;73;27;73;290181.57;3657.48;79.09
73214;2023;4;4;0;100;0;301450;2908.75;98.25
73215;2023;51;32;19;62.7450980392157;37.2549019607843;192918.294117647;2380.96078431373;84.4313725490196
73216;2023;7;7;0;100;0;156214.285714286;2271.57142857143;73.8571428571429
73217;2023;5;5;0;100;0;283275.4;3124.4;93.8
73218;2023;6;5;1;83.3333333333333;16.6666666666667;175391.666666667;2568.33333333333;69.5
73219;2023;5;4;1;80;20;448570.4;2964.8;136.8
73220;2023;6;5;1;83.3333333333333;16.6666666666667;146210;3128.16666666667;65.1666666666667
73221;2023;2;2;0;100;0;177350;4279.5;52
73222;2023;62;24;38;38.7096774193548;61.2903225806452;315834.725806452;3837.01612903226;81.7096774193548
73223;2023;10;9;1;90;10;162195;2013.1;88.6
73224;2023;14;9;5;64.2857142857143;35.7142857142857;208132.142857143;2599.35714285714;90.2857142857143
73225;2023;46;19;27;41.304347826087;58.695652173913;324876.260869565;3684.0652173913;89.5
73226;2023;14;13;1;92.8571428571429;7.14285714285714;228550.714285714;2178.64285714286;106.785714285714
73227;2023;108;17;91;15.7407407407407;84.2592592592593;522076.740740741;10135.712962963;53.0648148148148
73228;2023;11;9;2;81.8181818181818;18.1818181818182;423395.454545455;3811;110.545454545455
73229;2023;2;2;0;100;0;279945;2672.5;106
73230;2023;8;3;5;37.5;62.5;143045.25;2500;56.125
73231;2023;12;8;4;66.6666666666667;33.3333333333333;163470.833333333;2122.41666666667;73.3333333333333
73232;2023;26;12;14;46.1538461538462;53.8461538461538;504450.615384615;6177.96153846154;77.4230769230769
73233;2023;3;3;0;100;0;234083.333333333;2321.33333333333;130.666666666667
73234;2023;3;3;0;100;0;189247.666666667;2511.33333333333;80.3333333333333
73235;2023;74;3;71;4.05405405405405;95.9459459459459;111856.094594595;3464.54054054054;32.0810810810811
73236;2023;39;28;11;71.7948717948718;28.2051282051282;213663.58974359;2570.97435897436;88.4871794871795
73237;2023;5;4;1;80;20;235990;2869.4;86.8
73240;2023;3;3;0;100;0;243333.333333333;2107;136
73241;2023;12;12;0;100;0;248395.833333333;2561.08333333333;97.8333333333333
73242;2023;23;2;21;8.69565217391304;91.304347826087;121792.47826087;2751.34782608696;42.2608695652174
73243;2023;15;12;3;80;20;449376.8;4038.2;113.733333333333
73245;2023;9;9;0;100;0;246627.222222222;2473.66666666667;93.8888888888889
73246;2023;4;4;0;100;0;262250;3474.75;84
73247;2023;5;5;0;100;0;286590;3601.4;91.4
73248;2023;83;18;65;21.6867469879518;78.3132530120482;163128.56626506;2071.38554216867;78.8072289156626
73249;2023;27;7;20;25.9259259259259;74.0740740740741;311511.37037037;3836.55555555556;82.2962962962963
73250;2023;8;8;0;100;0;161602.5;1909.5;102
73252;2023;1;1;0;100;0;285700;2116;135
73253;2023;9;6;3;66.6666666666667;33.3333333333333;199688.888888889;2135.33333333333;91.8888888888889
73254;2023;2;2;0;100;0;267700;2613;103
73255;2023;6;6;0;100;0;216481.666666667;2259.33333333333;99.6666666666667
73256;2023;2;2;0;100;0;72500;857.5;71.5
73257;2023;302;24;278;7.94701986754967;92.0529801324503;286888.61589404;7555.78476821192;35.2615894039735
73258;2023;10;10;0;100;0;215220.7;2113.8;99.9
73259;2023;8;7;1;87.5;12.5;271062.5;2991.75;92.625
73261;2023;30;15;15;50;50;157786.333333333;2185.03333333333;80.3333333333333
73262;2023;9;7;2;77.7777777777778;22.2222222222222;227145.555555556;3600.22222222222;79.2222222222222
73263;2023;7;7;0;100;0;367250;3436.14285714286;114.571428571429
73265;2023;6;5;1;83.3333333333333;16.6666666666667;352243.5;3193.66666666667;118.333333333333
73267;2023;5;1;4;20;80;109563;2657.8;39.2
73268;2023;4;2;2;50;50;115215;1885.25;63
73269;2023;2;2;0;100;0;326065;3629;88.5
73270;2023;39;26;13;66.6666666666667;33.3333333333333;202503.307692308;2635.5641025641;83.6923076923077
73272;2023;1;1;0;100;0;230000;1503;153
73273;2023;6;4;2;66.6666666666667;33.3333333333333;193989.666666667;2297.16666666667;84
73274;2023;6;6;0;100;0;173491.666666667;3210.83333333333;66.3333333333333
73275;2023;1;1;0;100;0;125000;2778;45
73276;2023;9;9;0;100;0;206391.111111111;2172.22222222222;103
73278;2023;8;7;1;87.5;12.5;195918.75;2085.5;101
73280;2023;48;4;44;8.33333333333333;91.6666666666667;147777.520833333;3413.33333333333;42.1041666666667
73281;2023;6;5;1;83.3333333333333;16.6666666666667;266183.333333333;2787.66666666667;95.5
73282;2023;11;10;1;90.9090909090909;9.09090909090909;264681.818181818;3159.45454545455;82.5454545454545
73283;2023;4;3;1;75;25;305712.5;3080.5;94.5
73284;2023;15;8;7;53.3333333333333;46.6666666666667;283617.333333333;3349.66666666667;86.3333333333333
73285;2023;29;6;23;20.6896551724138;79.3103448275862;317812.75862069;3911.37931034483;82.7241379310345
73286;2023;17;16;1;94.1176470588235;5.88235294117647;268477.647058824;3524.64705882353;95.2941176470588
73288;2023;12;7;5;58.3333333333333;41.6666666666667;408358.333333333;4320.91666666667;100.166666666667
73289;2023;10;10;0;100;0;166670.8;2179.6;74.8
73290;2023;57;7;50;12.280701754386;87.719298245614;139206.807017544;3509.08771929825;42.3333333333333
73292;2023;2;2;0;100;0;238000;2258;105
73293;2023;3;3;0;100;0;265791.666666667;3138.33333333333;94.6666666666667
73294;2023;5;4;1;80;20;295592;3876.8;88.8
73296;2023;150;5;145;3.33333333333333;96.6666666666667;393146.226666667;8719.77333333333;42.4266666666667
73297;2023;2;2;0;100;0;417050;4023;109
73298;2023;1;1;0;100;0;176000;2444;72
73299;2023;2;2;0;100;0;252250;2864.5;89
73300;2023;42;20;22;47.6190476190476;52.3809523809524;494002.5;5495.16666666667;88.4285714285714
73301;2023;9;5;4;55.5555555555556;44.4444444444444;404606.666666667;5088.66666666667;83
73302;2023;2;2;0;100;0;165610;2545.5;70.5
73303;2023;53;26;27;49.0566037735849;50.9433962264151;182671.150943396;2407.45283018868;77.5660377358491
73304;2023;81;0;81;0;100;445637.950617284;12042.6419753086;35.9876543209877
73306;2023;75;7;68;9.33333333333333;90.6666666666667;229490.826666667;5042.13333333333;44.4266666666667
73307;2023;68;6;62;8.82352941176471;91.1764705882353;123037.191176471;3460.85294117647;36.3088235294118
73308;2023;5;5;0;100;0;267044;3506.2;79.4
73309;2023;1;1;0;100;0;323100;1701;190
73310;2023;5;5;0;100;0;304544;3156.8;96.4
73311;2023;1;1;0;100;0;156000;1228;127
73312;2023;5;4;1;80;20;364160;3764.8;101.6
73313;2023;1;1;0;100;0;120000;1500;80
73314;2023;2;2;0;100;0;330575;2456;135.5
73315;2023;7;6;1;85.7142857142857;14.2857142857143;183637.857142857;1641.57142857143;123.571428571429
73317;2023;17;5;12;29.4117647058824;70.5882352941177;282535.294117647;5406.76470588235;59.2352941176471
73318;2023;88;4;84;4.54545454545455;95.4545454545455;77931.6818181818;2579.875;27.3636363636364
73320;2023;9;5;4;55.5555555555556;44.4444444444444;224477.777777778;2453;92.4444444444444
73322;2023;51;6;45;11.7647058823529;88.2352941176471;134948.196078431;3413.07843137255;38.2352941176471
73323;2023;2;2;0;100;0;483958.5;4041;135
73324;2023;1;1;0;100;0;214000;2432;88
73326;2023;11;10;1;90.9090909090909;9.09090909090909;477497.272727273;4574.09090909091;101.636363636364
73327;2023;2;2;0;100;0;195500;1766;118
73328;2023;27;18;9;66.6666666666667;33.3333333333333;534481.407407407;5499.51851851852;93.962962962963
73329;2023;22;13;9;59.0909090909091;40.9090909090909;368615.681818182;4166.81818181818;92.8636363636364
73330;2023;27;18;9;66.6666666666667;33.3333333333333;179363.888888889;2410.59259259259;76.5925925925926
74001;2023;43;12;31;27.906976744186;72.0930232558139;184182.953488372;3778.06976744186;45.0232558139535
74002;2023;29;18;11;62.0689655172414;37.9310344827586;390751.206896552;4173.20689655172;96.2758620689655
74003;2023;7;6;1;85.7142857142857;14.2857142857143;853207.142857143;6490.71428571429;129.285714285714
74004;2023;1;1;0;100;0;1,00E+05;1724;58
74005;2023;44;33;11;75;25;397599.022727273;4059.97727272727;101.090909090909
74006;2023;30;4;26;13.3333333333333;86.6666666666667;337406.766666667;4783.03333333333;73.2666666666667
74007;2023;29;14;15;48.2758620689655;51.7241379310345;384081.310344828;4215;95.4137931034483
74008;2023;85;7;78;8.23529411764706;91.7647058823529;248062.611764706;3845.69411764706;64.6823529411765
74009;2023;9;7;2;77.7777777777778;22.2222222222222;490122.222222222;4540.77777777778;114.444444444444
74010;2023;1600;132;1468;8.25;91.75;379884.619375;5480.97875;68.903125
74012;2023;560;19;541;3.39285714285714;96.6071428571429;221952.376785714;3470.04642857143;64.9107142857143
74013;2023;26;9;17;34.6153846153846;65.3846153846154;507898.115384615;5495.07692307692;87.7692307692308
74014;2023;162;18;144;11.1111111111111;88.8888888888889;237084.432098765;4995.88271604938;46.5185185185185
74015;2023;5;3;2;60;40;406870;4248.2;95.6
74016;2023;33;13;20;39.3939393939394;60.6060606060606;521987.909090909;5475.15151515152;98.9393939393939
74018;2023;18;13;5;72.2222222222222;27.7777777777778;397025.611111111;4880;82.7222222222222
74019;2023;25;10;15;40;60;610602;6078.84;97.76
74020;2023;12;10;2;83.3333333333333;16.6666666666667;411652.25;3787.16666666667;114
74021;2023;12;8;4;66.6666666666667;33.3333333333333;448260.833333333;3700.83333333333;120.166666666667
74024;2023;11;8;3;72.7272727272727;27.2727272727273;285529.636363636;4558.72727272727;77.9090909090909
74025;2023;15;11;4;73.3333333333333;26.6666666666667;492225;4596.86666666667;107.6
74026;2023;43;16;27;37.2093023255814;62.7906976744186;347685.325581395;4725.76744186046;76.6511627906977
74027;2023;1;0;1;0;100;274700;4226;65
74029;2023;6;6;0;100;0;345940.833333333;3107.33333333333;121.5
74030;2023;5;5;0;100;0;538894;4051.8;129.6
74031;2023;42;16;26;38.0952380952381;61.9047619047619;435162.547619048;5159.88095238095;87.0952380952381
74032;2023;38;9;29;23.6842105263158;76.3157894736842;127923.815789474;2830.39473684211;44.4210526315789
74033;2023;61;18;43;29.5081967213115;70.4918032786885;199697.852459016;3729.80327868852;54.4262295081967
74034;2023;47;4;43;8.51063829787234;91.4893617021277;113962.680851064;2840.40425531915;35.1702127659574
74035;2023;3;3;0;100;0;369200;3191;116.666666666667
74036;2023;4;1;3;25;75;617977.5;6179.5;100.75
74037;2023;22;14;8;63.6363636363636;36.3636363636364;375281.363636364;3997.90909090909;93.4545454545455
74038;2023;24;11;13;45.8333333333333;54.1666666666667;197259.375;3515.08333333333;57.6666666666667
74040;2023;40;23;17;57.5;42.5;385144.575;4542.125;90.175
74041;2023;3;3;0;100;0;338945.666666667;3862.66666666667;84.6666666666667
74042;2023;194;38;156;19.5876288659794;80.4123711340206;214223.963917526;3217.41237113402;66.5360824742268
74043;2023;48;21;27;43.75;56.25;338174.416666667;4113.14583333333;84.8333333333333
74044;2023;14;7;7;50;50;431285.714285714;5004.64285714286;88.2142857142857
74045;2023;3;3;0;100;0;350176.666666667;4791.66666666667;73.6666666666667
74046;2023;1;1;0;100;0;505000;3412;148
74048;2023;4;4;0;100;0;365017.5;4768;81.75
74049;2023;8;8;0;100;0;239800.625;3635.75;76.875
74050;2023;6;6;0;100;0;342971.666666667;5084.83333333333;71.6666666666667
74051;2023;5;4;1;80;20;418389;4495;95.2
74052;2023;5;4;1;80;20;528420;4366.6;121.4
74053;2023;7;6;1;85.7142857142857;14.2857142857143;350414.285714286;4087.71428571429;85.7142857142857
74054;2023;4;3;1;75;25;336372.5;3326.5;109
74055;2023;5;4;1;80;20;298090;3236;98.6
74056;2023;272;43;229;15.8088235294118;84.1911764705882;575842.150735294;9596.65441176471;57.6654411764706
74057;2023;5;4;1;80;20;262296.8;3062.8;87.4
74058;2023;30;4;26;13.3333333333333;86.6666666666667;262930.5;5028.2;49.8
74059;2023;4;4;0;100;0;520100;5347.5;121
74061;2023;10;7;3;70;30;545759.8;5135.5;106.6
74062;2023;11;4;7;36.3636363636364;63.6363636363636;420944.272727273;5105.54545454545;87.4545454545455
74063;2023;111;13;98;11.7117117117117;88.2882882882883;281692.468468468;5611.74774774775;45.1531531531532
74064;2023;9;9;0;100;0;362619;3423.44444444444;104.555555555556
74065;2023;6;6;0;100;0;300644.833333333;3463.5;99.1666666666667
74066;2023;2;2;0;100;0;563825;3997;139.5
74067;2023;16;7;9;43.75;56.25;484543.9375;5172.6875;93.8125
74068;2023;1;1;0;100;0;130000;1048;124
74069;2023;3;1;2;33.3333333333333;66.6666666666667;410000;4708;88
74070;2023;53;13;40;24.5283018867925;75.4716981132076;398983.603773585;4872.01886792453;77.9622641509434
74072;2023;2;2;0;100;0;725785;5083.5;160
74073;2023;8;7;1;87.5;12.5;331928.625;3643.875;92.125
74074;2023;10;7;3;70;30;382391;4330.6;89.2
74075;2023;14;10;4;71.4285714285714;28.5714285714286;355490.5;4024.14285714286;96.9285714285714
74076;2023;8;7;1;87.5;12.5;508001.25;3849.25;132
74077;2023;11;10;1;90.9090909090909;9.09090909090909;345282.454545455;3960.27272727273;94.4545454545455
74078;2023;6;6;0;100;0;315915;3697.83333333333;95.1666666666667
74079;2023;4;1;3;25;75;155908.75;3041;75.25
74080;2023;74;9;65;12.1621621621622;87.8378378378378;579219.256756757;9794.91891891892;54.6351351351351
74081;2023;179;21;158;11.731843575419;88.268156424581;166525.865921788;2307.88268156425;71.1005586592179
74082;2023;65;18;47;27.6923076923077;72.3076923076923;397070.630769231;4733.87692307692;84.8769230769231
74083;2023;82;17;65;20.7317073170732;79.2682926829268;497811.829268293;6035.34146341463;66.9390243902439
74085;2023;66;12;54;18.1818181818182;81.8181818181818;279153.060606061;5677.89393939394;49.0151515151515
74086;2023;8;5;3;62.5;37.5;375439.375;3938;94.25
74087;2023;25;14;11;56;44;394907.64;4237.12;101.36
74088;2023;21;7;14;33.3333333333333;66.6666666666667;420111.904761905;4370.38095238095;98.1904761904762
74089;2023;20;4;16;20;80;318444.6;5679;59.95
74090;2023;9;5;4;55.5555555555556;44.4444444444444;327040.777777778;3435.11111111111;104.777777777778
74091;2023;4;4;0;100;0;630139;8238.25;82
74094;2023;66;48;18;72.7272727272727;27.2727272727273;471967.090909091;4995.28787878788;96.3333333333333
74096;2023;54;23;31;42.5925925925926;57.4074074074074;360778.444444444;4639.2962962963;80.7407407407407
74097;2023;11;11;0;100;0;468339.090909091;3993.90909090909;135.454545454545
74098;2023;12;8;4;66.6666666666667;33.3333333333333;613120.833333333;6016.66666666667;101.583333333333
74099;2023;34;5;29;14.7058823529412;85.2941176470588;613024.735294118;7752.20588235294;57.9411764705882
74100;2023;10;10;0;100;0;338053;3293.5;106.4
74101;2023;6;4;2;66.6666666666667;33.3333333333333;367368.333333333;3514.66666666667;99.5
74102;2023;11;10;1;90.9090909090909;9.09090909090909;631890;5888;112.454545454545
74103;2023;17;10;7;58.8235294117647;41.1764705882353;476629.176470588;4843.35294117647;95.4117647058823
74104;2023;46;18;28;39.1304347826087;60.8695652173913;482190.608695652;5200;91.3260869565217
74105;2023;86;31;55;36.046511627907;63.953488372093;311833.081395349;4338.02325581395;73.3604651162791
74106;2023;6;6;0;100;0;440021.5;4257.83333333333;104.166666666667
74107;2023;1;1;0;100;0;226000;2093;108
74108;2023;7;3;4;42.8571428571429;57.1428571428571;577421.428571429;6069.57142857143;96.8571428571429
74109;2023;10;10;0;100;0;377684.5;3515.8;107.2
74111;2023;2;2;0;100;0;442250;3393.5;129
74112;2023;65;14;51;21.5384615384615;78.4615384615385;420160.615384615;5405.52307692308;76.4769230769231
74114;2023;6;5;1;83.3333333333333;16.6666666666667;741151.666666667;7878.33333333333;101.166666666667
74116;2023;20;15;5;75;25;450148;4337.7;105.65
74117;2023;7;7;0;100;0;477521.428571429;4679.71428571429;107.142857142857
74118;2023;39;13;26;33.3333333333333;66.6666666666667;324542.820512821;4640.10256410256;67.4615384615385
74119;2023;196;27;169;13.7755102040816;86.2244897959184;297502.173469388;4532.19897959184;65.4591836734694
74121;2023;16;11;5;68.75;31.25;378674.75;5117.6875;74.6875
74122;2023;6;4;2;66.6666666666667;33.3333333333333;316735.833333333;2953.83333333333;108.166666666667
74123;2023;87;40;47;45.9770114942529;54.0229885057471;254713.494252874;3393.45977011494;76.551724137931
74124;2023;19;11;8;57.8947368421053;42.1052631578947;458805.263157895;4726.84210526316;102.157894736842
74126;2023;6;6;0;100;0;442664.5;3867.66666666667;110.833333333333
74127;2023;16;14;2;87.5;12.5;360430.625;4456.9375;86.5
74128;2023;38;31;7;81.5789473684211;18.4210526315789;421106.342105263;4714.71052631579;103.473684210526
74129;2023;2;2;0;100;0;155950;2036;74
74130;2023;3;3;0;100;0;347666.666666667;3451;103
74131;2023;20;10;10;50;50;275557.6;3285.55;88
74133;2023;206;28;178;13.5922330097087;86.4077669902913;235929.344660194;3700.31553398058;61.6019417475728
74134;2023;94;20;74;21.2765957446809;78.7234042553192;446967.574468085;7664.74468085106;57.1808510638298
74135;2023;9;3;6;33.3333333333333;66.6666666666667;210264.777777778;3378.22222222222;64.5555555555556
74136;2023;90;7;83;7.77777777777778;92.2222222222222;339028.144444444;6886.48888888889;48.5333333333333
74137;2023;30;17;13;56.6666666666667;43.3333333333333;510324.533333333;5216.5;102.3
74138;2023;18;13;5;72.2222222222222;27.7777777777778;375849.777777778;4477.16666666667;87.2222222222222
74139;2023;6;4;2;66.6666666666667;33.3333333333333;280652.5;3852.66666666667;87.1666666666667
74140;2023;38;9;29;23.6842105263158;76.3157894736842;134525.315789474;3134.57894736842;39.1315789473684
74141;2023;15;13;2;86.6666666666667;13.3333333333333;354630.066666667;4168.73333333333;87.2
74142;2023;10;9;1;90;10;421984.1;4480.1;94.6
74143;2023;115;27;88;23.4782608695652;76.5217391304348;440402.373913043;7372.47826086957;57.5565217391304
74144;2023;8;7;1;87.5;12.5;517643.75;4298.625;135.625
74145;2023;5;3;2;60;40;409726;3652.8;128.8
74146;2023;8;8;0;100;0;482276.625;4573.125;110.375
74147;2023;15;8;7;53.3333333333333;46.6666666666667;474647.866666667;5570.53333333333;90.4
74148;2023;2;0;2;0;100;161075;3928.5;41
74150;2023;18;18;0;100;0;439426.5;4254.88888888889;105.111111111111
74151;2023;5;4;1;80;20;373590;4044.8;92.4
74152;2023;13;6;7;46.1538461538462;53.8461538461538;482482;4639.38461538462;106.846153846154
74153;2023;21;17;4;80.9523809523809;19.047619047619;437205.714285714;5423.80952380952;86.4761904761905
74154;2023;40;19;21;47.5;52.5;305298.35;3944.45;80.975
74155;2023;15;14;1;93.3333333333333;6.66666666666667;287723.333333333;3581.13333333333;81.9333333333333
74156;2023;8;8;0;100;0;427468.75;3953.375;111.375
74157;2023;15;11;4;73.3333333333333;26.6666666666667;414008;3942.13333333333;106.8
74158;2023;13;7;6;53.8461538461538;46.1538461538462;372043.538461538;4474.92307692308;86.3076923076923
74159;2023;34;16;18;47.0588235294118;52.9411764705882;231302.941176471;3410.58823529412;82.1470588235294
74160;2023;44;3;41;6.81818181818182;93.1818181818182;249472.25;5904.79545454545;38.2272727272727
74161;2023;18;12;6;66.6666666666667;33.3333333333333;425576.388888889;4384.83333333333;104
74162;2023;9;7;2;77.7777777777778;22.2222222222222;484798.666666667;4115.88888888889;129.888888888889
74163;2023;22;19;3;86.3636363636364;13.6363636363636;397635.545454545;4433.68181818182;96.5909090909091
74164;2023;47;21;26;44.6808510638298;55.3191489361702;293257.723404255;3716.08510638298;78.6595744680851
74165;2023;2;2;0;100;0;330500;3610;103.5
74166;2023;11;10;1;90.9090909090909;9.09090909090909;417915.454545455;3778.36363636364;127.636363636364
74167;2023;6;6;0;100;0;269964.333333333;3228;82.8333333333333
74168;2023;3;3;0;100;0;513551.666666667;4399.66666666667;113.666666666667
74169;2023;40;19;21;47.5;52.5;244397.35;3378.075;79.25
74170;2023;9;9;0;100;0;360145.222222222;4611.33333333333;92.5555555555556
74171;2023;16;7;9;43.75;56.25;364521.0625;4277.4375;89.5
74172;2023;12;7;5;58.3333333333333;41.6666666666667;519876.583333333;5885.58333333333;90.6666666666667
74173;2023;166;25;141;15.0602409638554;84.9397590361446;767341.759036145;10539.7469879518;69.3313253012048
74174;2023;9;9;0;100;0;286488.888888889;3525.88888888889;102
74175;2023;7;3;4;42.8571428571429;57.1428571428571;288810;3998.28571428571;66.7142857142857
74176;2023;24;14;10;58.3333333333333;41.6666666666667;1033235.95833333;9278.95833333333;110.75
74177;2023;14;14;0;100;0;494978.214285714;3907.28571428571;134.714285714286
74178;2023;13;12;1;92.3076923076923;7.69230769230769;345240.769230769;3210.53846153846;110.307692307692
74179;2023;2;2;0;100;0;508500;5898.5;92
74180;2023;24;19;5;79.1666666666667;20.8333333333333;557830;5190.16666666667;104.708333333333
74183;2023;31;17;14;54.8387096774194;45.1612903225806;226605.032258065;3760.51612903226;63.8709677419355
74184;2023;4;3;1;75;25;356350;3484.5;108.75
74185;2023;19;12;7;63.1578947368421;36.8421052631579;440278.947368421;4763.42105263158;96.7368421052632
74186;2023;4;3;1;75;25;474152.5;4757.5;98
74188;2023;30;11;19;36.6666666666667;63.3333333333333;425381.466666667;6037;68.9333333333333
74189;2023;35;10;25;28.5714285714286;71.4285714285714;162939.485714286;3284.2;51.1142857142857
74190;2023;76;13;63;17.1052631578947;82.8947368421053;179750.539473684;4276.8947368421;44.5921052631579
74191;2023;201;20;181;9.95024875621891;90.0497512437811;355752.825870647;7681.64179104478;44.5422885572139
74192;2023;7;7;0;100;0;335977.142857143;4698.71428571429;77.4285714285714
74193;2023;6;5;1;83.3333333333333;16.6666666666667;381760.833333333;4610.66666666667;96
74194;2023;7;4;3;57.1428571428571;42.8571428571429;384814.285714286;4495.71428571429;87.2857142857143
74195;2023;2;2;0;100;0;364592.5;4174.5;87.5
74196;2023;2;2;0;100;0;394225;2381;174
74197;2023;33;10;23;30.3030303030303;69.6969696969697;253119.393939394;3727.0303030303;67
74198;2023;15;13;2;86.6666666666667;13.3333333333333;630855.733333333;4973.8;122.066666666667
74199;2023;6;5;1;83.3333333333333;16.6666666666667;582583.333333333;4367.33333333333;127.5
74200;2023;49;28;21;57.1428571428571;42.8571428571429;446199.795918367;4682.30612244898;94.1020408163265
74201;2023;23;13;10;56.5217391304348;43.4782608695652;516361.956521739;4971.86956521739;102.95652173913
74202;2023;6;1;5;16.6666666666667;83.3333333333333;430315.833333333;5178;86.8333333333333
74203;2023;5;2;3;40;60;67000;1403.6;48.4
74205;2023;32;12;20;37.5;62.5;236139.96875;4112.3125;53.09375
74206;2023;10;8;2;80;20;267322.5;3359.7;86.2
74208;2023;121;47;74;38.8429752066116;61.1570247933884;286231.73553719;4059.01652892562;71.2644628099174
74209;2023;12;11;1;91.6666666666667;8.33333333333333;463187.5;4392.41666666667;120.833333333333
74210;2023;21;16;5;76.1904761904762;23.8095238095238;366221.523809524;3568.7619047619;102.952380952381
74211;2023;21;18;3;85.7142857142857;14.2857142857143;381326.19047619;3811.66666666667;111.333333333333
74212;2023;22;17;5;77.2727272727273;22.7272727272727;328229.045454545;4459.09090909091;71.7272727272727
74213;2023;85;24;61;28.2352941176471;71.7647058823529;468133.164705882;5557.42352941176;83.2588235294118
74215;2023;88;5;83;5.68181818181818;94.3181818181818;282279.840909091;5553.61363636364;46.8181818181818
74216;2023;10;5;5;50;50;632593;5048.8;136.1
74218;2023;92;49;43;53.2608695652174;46.7391304347826;438703.913043478;5065.86956521739;89.1413043478261
74219;2023;6;3;3;50;50;692970.833333333;5400.33333333333;125.5
74220;2023;73;21;52;28.7671232876712;71.2328767123288;334100.95890411;4032.68493150685;84.4109589041096
74221;2023;8;4;4;50;50;409958.125;3705.75;101.875
74222;2023;3;2;1;66.6666666666667;33.3333333333333;211083.333333333;2846;76.6666666666667
74223;2023;4;3;1;75;25;267107.5;2615.5;101.5
74224;2023;115;32;83;27.8260869565217;72.1739130434783;313203.373913043;3764.77391304348;82.5217391304348
74225;2023;222;61;161;27.4774774774775;72.5225225225225;238592.851351351;3471.46396396396;70.3198198198198
74226;2023;6;4;2;66.6666666666667;33.3333333333333;307585;3796.5;91
74228;2023;2;2;0;100;0;918350;4581.5;250
74229;2023;42;20;22;47.6190476190476;52.3809523809524;340783.238095238;4226.07142857143;81.8571428571429
74231;2023;4;3;1;75;25;280000;3277.5;83
74232;2023;2;2;0;100;0;818142.5;9391.5;102
74233;2023;20;10;10;50;50;308467.75;3657.2;86
74234;2023;6;5;1;83.3333333333333;16.6666666666667;224222.5;4731.33333333333;56.8333333333333
74235;2023;7;7;0;100;0;408122.857142857;4492.28571428571;98.4285714285714
74236;2023;244;47;197;19.2622950819672;80.7377049180328;315936.418032787;5475.94672131148;55.8524590163934
74237;2023;13;3;10;23.0769230769231;76.9230769230769;215963;3918.15384615385;57.3076923076923
74238;2023;54;13;41;24.0740740740741;75.9259259259259;244541.555555556;4006.53703703704;60.7407407407407
74239;2023;28;6;22;21.4285714285714;78.5714285714286;350785.821428571;6106.39285714286;57.8571428571429
74240;2023;7;6;1;85.7142857142857;14.2857142857143;459471.428571429;4023.28571428571;113.571428571429
74241;2023;39;22;17;56.4102564102564;43.5897435897436;235618.948717949;3048.61538461538;80.025641025641
74242;2023;77;33;44;42.8571428571429;57.1428571428571;562607.155844156;6412.5974025974;86.6493506493507
74243;2023;178;17;161;9.55056179775281;90.4494382022472;336236.691011236;4755.20786516854;71.8426966292135
74244;2023;8;5;3;62.5;37.5;381732.5;4279.125;89.25
74249;2023;28;22;6;78.5714285714286;21.4285714285714;383664.285714286;4547.21428571429;91.6428571428571
74250;2023;74;41;33;55.4054054054054;44.5945945945946;332800.648648649;4227.32432432432;83.6081081081081
74252;2023;5;4;1;80;20;514050;5493;100.8
74253;2023;2;2;0;100;0;339775;3619;101
74254;2023;3;3;0;100;0;401436.666666667;4389.66666666667;90
74255;2023;15;12;3;80;20;362001.466666667;3870.4;100.066666666667
74256;2023;237;43;194;18.1434599156118;81.8565400843882;253634.451476793;3761.81434599156;66.8607594936709
74257;2023;5;3;2;60;40;320456.8;3870.8;79
74258;2023;164;31;133;18.9024390243902;81.0975609756098;307567.37804878;5352.79268292683;54.4939024390244
74259;2023;5;5;0;100;0;396700;3994.2;101.4
74260;2023;6;6;0;100;0;453508.333333333;3923.66666666667;125.5
74261;2023;3;2;1;66.6666666666667;33.3333333333333;331921.666666667;2938.66666666667;92.3333333333333
74262;2023;16;5;11;31.25;68.75;316758;3923;77.3125
74263;2023;80;56;24;70;30;475319.8625;4707.9;103.175
74264;2023;96;36;60;37.5;62.5;231159.8125;2795.40625;85.28125
74265;2023;7;6;1;85.7142857142857;14.2857142857143;317942.857142857;4657.85714285714;87.1428571428571
74266;2023;11;4;7;36.3636363636364;63.6363636363636;453953;6647.81818181818;70.1818181818182
74267;2023;52;23;29;44.2307692307692;55.7692307692308;639029.480769231;6958.48076923077;91.3076923076923
74269;2023;36;17;19;47.2222222222222;52.7777777777778;223895.416666667;2719.58333333333;84.9722222222222
74271;2023;7;5;2;71.4285714285714;28.5714285714286;281057.142857143;3970.42857142857;76.8571428571429
74272;2023;52;27;25;51.9230769230769;48.0769230769231;442644.692307692;5216.28846153846;87.2692307692308
74273;2023;12;11;1;91.6666666666667;8.33333333333333;283644;3991.75;72.25
74275;2023;28;13;15;46.4285714285714;53.5714285714286;675640.464285714;6555.71428571429;99.8571428571429
74276;2023;71;19;52;26.7605633802817;73.2394366197183;210748.957746479;4057.6338028169;54.8169014084507
74278;2023;69;23;46;33.3333333333333;66.6666666666667;254129.217391304;3249.10144927536;77.6086956521739
74279;2023;77;14;63;18.1818181818182;81.8181818181818;179021.051948052;3793.45454545455;49.1038961038961
74280;2023;62;20;42;32.258064516129;67.741935483871;363054.903225806;4731.90322580645;80.5967741935484
74281;2023;579;80;499;13.8169257340242;86.1830742659758;267748.86701209;3901.74611398964;69.1001727115717
74282;2023;68;48;20;70.5882352941177;29.4117647058824;466656.382352941;4732.45588235294;100.558823529412
74283;2023;10;8;2;80;20;379798.6;3635.2;96.4
74284;2023;11;6;5;54.5454545454545;45.4545454545455;228907.909090909;2778.81818181818;84.0909090909091
74285;2023;5;4;1;80;20;346225.4;3768.2;89.2
74286;2023;10;7;3;70;30;274412.4;3679.1;77.1
74287;2023;9;6;3;66.6666666666667;33.3333333333333;230583.111111111;3264.11111111111;71.7777777777778
74288;2023;75;26;49;34.6666666666667;65.3333333333333;344535;4278.62666666667;80.08
74289;2023;14;10;4;71.4285714285714;28.5714285714286;356504.285714286;3874.92857142857;92.7142857142857
74290;2023;17;3;14;17.6470588235294;82.3529411764706;333711.764705882;5572.11764705882;60.1176470588235
74291;2023;5;4;1;80;20;386509;3999.8;105
74292;2023;3;3;0;100;0;387810;3599;113.333333333333
74293;2023;69;23;46;33.3333333333333;66.6666666666667;384095.782608696;4431.63768115942;85.3913043478261
74294;2023;29;18;11;62.0689655172414;37.9310344827586;441863.24137931;5215.13793103448;72.8620689655172
74295;2023;2;2;0;100;0;166676.5;1111.5;150
74296;2023;11;8;3;72.7272727272727;27.2727272727273;392246.818181818;4396.09090909091;100
74297;2023;3;3;0;100;0;450193.333333333;4908.33333333333;99
74298;2023;106;32;74;30.188679245283;69.811320754717;340579.858490566;4179.7641509434;80.0943396226415
74299;2023;25;15;10;60;40;1261174.72;10840;113.48
74301;2023;15;8;7;53.3333333333333;46.6666666666667;307319.2;3847.53333333333;82.8
74302;2023;12;7;5;58.3333333333333;41.6666666666667;380615.916666667;5903.83333333333;65.5
74303;2023;28;9;19;32.1428571428571;67.8571428571429;411175.357142857;5492.78571428571;75.7857142857143
74304;2023;7;2;5;28.5714285714286;71.4285714285714;318570;3407.71428571429;95.7142857142857
74305;2023;135;23;112;17.037037037037;82.962962962963;276935.422222222;4133.28888888889;65.762962962963
74306;2023;2;2;0;100;0;491825;3575;137
74307;2023;12;6;6;50;50;402461.5;4264.83333333333;94.6666666666667
74308;2023;9;7;2;77.7777777777778;22.2222222222222;305611.111111111;3951.33333333333;75
74309;2023;67;25;42;37.3134328358209;62.6865671641791;353881.044776119;4578.41791044776;80.3283582089552
74310;2023;7;6;1;85.7142857142857;14.2857142857143;545420;5342.14285714286;103.857142857143
74311;2023;52;36;16;69.2307692307692;30.7692307692308;331878.5;3952.84615384615;86.8846153846154
74312;2023;5;4;1;80;20;285580;3579.6;82.8
74313;2023;8;3;5;37.5;62.5;343248;4186;81.25
74314;2023;19;14;5;73.6842105263158;26.3157894736842;410385.526315789;4305.63157894737;95.1578947368421
74315;2023;10;8;2;80;20;373285;4343.8;91.1
75056;2023;26511;96;26415;0.362113839538305;99.6378861604617;535918.489796688;10200.964769341;51.3548715627475
76001;2023;8;8;0;100;0;201000;1880.125;107.875
76002;2023;5;5;0;100;0;198000;1856.6;111.4
76004;2023;1;1;0;100;0;119000;1983;60
76005;2023;53;33;20;62.2641509433962;37.7358490566038;160198.018867925;2139.7358490566;75.377358490566
76006;2023;2;2;0;100;0;137000;1698;68
76007;2023;7;7;0;100;0;188528.571428571;2042.71428571429;95.2857142857143
76008;2023;5;5;0;100;0;121000;1823.4;70.6
76009;2023;2;2;0;100;0;197500;1781.5;113
76010;2023;3;3;0;100;0;161000;1767.66666666667;99.6666666666667
76011;2023;3;3;0;100;0;173522;1864.33333333333;96
76012;2023;2;2;0;100;0;132500;1341.5;92
76013;2023;15;15;0;100;0;197744.8;1968.2;99.7333333333333
76014;2023;13;10;3;76.9230769230769;23.0769230769231;224169.153846154;2786.30769230769;88.6923076923077
76015;2023;12;12;0;100;0;194291.666666667;1964.58333333333;99.6666666666667
76016;2023;2;2;0;100;0;351400;2542.5;139
76017;2023;2;2;0;100;0;196650;2013.5;96
76018;2023;13;12;1;92.3076923076923;7.69230769230769;168042.307692308;1896.92307692308;93.7692307692308
76019;2023;4;4;0;100;0;231537.5;2212.25;104.75
76020;2023;10;10;0;100;0;192543.9;2175.9;90.6
76021;2023;6;6;0;100;0;196591.666666667;2132.83333333333;98
76022;2023;7;7;0;100;0;189814.285714286;1726.57142857143;115
76023;2023;5;5;0;100;0;139200;1288.2;96.2
76024;2023;2;2;0;100;0;161000;2211;72
76025;2023;6;6;0;100;0;140800;1845.66666666667;85.8333333333333
76026;2023;29;24;5;82.7586206896552;17.2413793103448;150561.724137931;1875.03448275862;79.5862068965517
76029;2023;2;2;0;100;0;75000;619.5;114
76030;2023;5;5;0;100;0;269950;2358.8;118.4
76032;2023;2;2;0;100;0;250750;2289;110.5
76033;2023;5;5;0;100;0;252100;1996;126.6
76034;2023;30;29;1;96.6666666666667;3.33333333333333;160619.333333333;1965.6;87
76035;2023;21;21;0;100;0;121642.857142857;1354.71428571429;90.3809523809524
76036;2023;5;5;0;100;0;201504;1900;107.8
76038;2023;4;4;0;100;0;269575;2292.25;117
76039;2023;14;14;0;100;0;225296.428571429;2120.07142857143;105.714285714286
76040;2023;2;2;0;100;0;151500;2008.5;76
76041;2023;9;9;0;100;0;270712.777777778;2480.55555555556;109.111111111111
76042;2023;4;4;0;100;0;82500;1353.5;65.25
76043;2023;10;10;0;100;0;202324.8;1943.3;107.8
76045;2023;3;3;0;100;0;236666.666666667;2520;93.3333333333333
76046;2023;8;8;0;100;0;254287.5;2237.375;117.5
76047;2023;3;3;0;100;0;140833.333333333;1706.66666666667;81.6666666666667
76048;2023;5;5;0;100;0;238340;2092.2;108.8
76049;2023;5;5;0;100;0;89680;1490;62.8
76050;2023;11;11;0;100;0;169440.909090909;2207.18181818182;75.5454545454545
76051;2023;18;17;1;94.4444444444444;5.55555555555556;187571.944444444;2050.38888888889;93.2222222222222
76052;2023;2;2;0;100;0;120000;1420;74
76053;2023;2;2;0;100;0;1,00E+05;1268.5;86
76054;2023;5;5;0;100;0;145560;1909.8;84.8
76055;2023;2;2;0;100;0;257500;1641;157
76056;2023;5;5;0;100;0;138900;1362.6;107.6
76057;2023;104;95;9;91.3461538461538;8.65384615384615;175743.721153846;2164.80769230769;83.9423076923077
76058;2023;3;3;0;100;0;121500;1582;75
76059;2023;4;4;0;100;0;156525;2025.25;90.75
76060;2023;8;8;0;100;0;168068.75;1814.25;96.75
76062;2023;2;2;0;100;0;85000;1162.5;73.5
76063;2023;6;6;0;100;0;216150;2081.33333333333;104
76064;2023;7;7;0;100;0;235000;2228.28571428571;110.857142857143
76065;2023;6;6;0;100;0;135849.5;1916.33333333333;78
76066;2023;4;4;0;100;0;194625;2282.75;86
76067;2023;9;9;0;100;0;152342.222222222;2338.55555555556;72.8888888888889
76068;2023;16;16;0;100;0;222127.1875;2114.4375;111.375
76069;2023;17;16;1;94.1176470588235;5.88235294117647;295452.941176471;3055;100.235294117647
76070;2023;9;9;0;100;0;107644.444444444;1359.88888888889;81.4444444444444
76071;2023;7;7;0;100;0;147357.142857143;1456.71428571429;100.142857142857
76072;2023;2;2;0;100;0;206710;1893;120
76074;2023;1;1;0;100;0;322500;2481;130
76075;2023;4;4;0;100;0;223550;2120.5;107.25
76076;2023;5;5;0;100;0;191480;2139.4;88.6
76077;2023;4;4;0;100;0;156083.25;1419;111.5
76079;2023;1;1;0;100;0;187000;2078;90
76082;2023;9;9;0;100;0;178994.555555556;1815.33333333333;93.3333333333333
76083;2023;1;1;0;100;0;1,00E+05;952;105
76084;2023;2;2;0;100;0;240000;2170.5;110.5
76085;2023;3;3;0;100;0;175000;1430.66666666667;110.333333333333
76086;2023;1;1;0;100;0;180000;2400;75
76087;2023;4;4;0;100;0;142212.5;1171;132.5
76088;2023;10;10;0;100;0;187804;1772.5;110.7
76090;2023;15;15;0;100;0;226142;2072.06666666667;103.733333333333
76091;2023;1;1;0;100;0;221550;2216;100
76092;2023;11;11;0;100;0;185818.181818182;1954.81818181818;98.8181818181818
76093;2023;4;4;0;100;0;167000;1770.75;88.25
76094;2023;4;4;0;100;0;310000;2841.5;115.75
76095;2023;120;57;63;47.5;52.5;227548.366666667;2388.3;90.725
76096;2023;8;8;0;100;0;232535;1825;124.75
76099;2023;5;5;0;100;0;266400;2395.2;126.6
76100;2023;13;13;0;100;0;241307.692307692;2498.46153846154;98.7692307692308
76101;2023;24;24;0;100;0;144427.5;1633.95833333333;88.7083333333333
76103;2023;104;50;54;48.0769230769231;51.9230769230769;209484.605769231;2507.5;84.9038461538462
76104;2023;4;4;0;100;0;293913;2811;117
76105;2023;2;2;0;100;0;283000;2184;137.5
76106;2023;7;7;0;100;0;355650;2548.42857142857;154.714285714286
76107;2023;3;3;0;100;0;150333.333333333;1321;111
76108;2023;203;124;79;61.0837438423645;38.9162561576355;325660.162561576;3244.04433497537;99.5320197044335
76109;2023;1;1;0;100;0;178500;2318;77
76111;2023;10;10;0;100;0;299800;2332.8;128.5
76113;2023;5;5;0;100;0;169420;1863;108.4
76114;2023;130;111;19;85.3846153846154;14.6153846153846;124293.307692308;1571.92307692308;78.2076923076923
76115;2023;7;7;0;100;0;205020.714285714;1842;116.142857142857
76116;2023;40;40;0;100;0;271111.5;2424.225;114.8
76117;2023;7;7;0;100;0;233114.285714286;3068.85714285714;80.7142857142857
76118;2023;2;2;0;100;0;231500;1694.5;137
76119;2023;1;1;0;100;0;294750;2076;142
76120;2023;6;6;0;100;0;274766.666666667;2723.33333333333;105.833333333333
76121;2023;7;7;0;100;0;142714.285714286;1348.42857142857;103.285714285714
76122;2023;4;4;0;100;0;100412.5;1858.5;61
76123;2023;10;10;0;100;0;342665;2554.2;131.2
76124;2023;6;6;0;100;0;224455.833333333;2264.16666666667;115.166666666667
76125;2023;23;21;2;91.304347826087;8.69565217391304;168334.782608696;1948.73913043478;90.304347826087
76128;2023;8;8;0;100;0;179362.5;1804.25;101.75
76129;2023;2;2;0;100;0;127500;1540;83.5
76130;2023;4;4;0;100;0;126000;1271;102.5
76131;2023;6;5;1;83.3333333333333;16.6666666666667;160525.333333333;2520.5;65.6666666666667
76132;2023;12;12;0;100;0;208116.666666667;1912.25;99.1666666666667
76133;2023;9;9;0;100;0;169975.555555556;1909.44444444444;93.3333333333333
76134;2023;9;9;0;100;0;162821;1883.66666666667;91.3333333333333
76135;2023;10;10;0;100;0;183537.6;1709.2;102.2
76136;2023;11;11;0;100;0;147290.909090909;1680.81818181818;84.5454545454545
76138;2023;2;2;0;100;0;382125;2154.5;179.5
76139;2023;2;2;0;100;0;130000;1038;145
76140;2023;1;1;0;100;0;80000;870;92
76141;2023;11;11;0;100;0;220860.909090909;2306.09090909091;97.9090909090909
76142;2023;5;5;0;100;0;158342;1818;88.2
76143;2023;13;13;0;100;0;247545.384615385;2406.61538461538;108.769230769231
76144;2023;2;2;0;100;0;227500;1714.5;131
76146;2023;36;36;0;100;0;221644.972222222;2160.63888888889;107.277777777778
76147;2023;6;6;0;100;0;180600;1703.33333333333;124
76148;2023;5;5;0;100;0;162260;1888.4;86
76149;2023;5;5;0;100;0;225820;1851.6;133.4
76151;2023;3;3;0;100;0;276100;2158.33333333333;132
76152;2023;10;10;0;100;0;179305;1604.4;111.1
76153;2023;1;1;0;100;0;190900;1527;125
76154;2023;7;7;0;100;0;86672.8571428571;1291.42857142857;67.8571428571429
76155;2023;2;2;0;100;0;236250;2042;112.5
76156;2023;9;9;0;100;0;205111.111111111;2433;97.3333333333333
76157;2023;113;52;61;46.0176991150442;53.9823008849557;141464.769911504;1793.85840707965;79.3274336283186
76158;2023;3;3;0;100;0;220666.666666667;2051;106.666666666667
76159;2023;36;34;2;94.4444444444444;5.55555555555556;159134;1695.61111111111;96.0277777777778
76160;2023;5;5;0;100;0;277540;2412.4;128.4
76162;2023;2;2;0;100;0;155300;1824;85
76163;2023;6;6;0;100;0;310425;2717.83333333333;124.166666666667
76164;2023;64;44;20;68.75;31.25;158137.96875;2016.375;82.640625
76165;2023;105;71;34;67.6190476190476;32.3809523809524;134460.333333333;1640.37142857143;81.5047619047619
76166;2023;3;3;0;100;0;128166.666666667;1387;90.6666666666667
76167;2023;17;17;0;100;0;347044.117647059;2645.52941176471;135.882352941176
76168;2023;3;3;0;100;0;173616.666666667;1505;112
76169;2023;20;20;0;100;0;221072.5;2633.2;89.85
76171;2023;1;1;0;100;0;225000;1731;130
76172;2023;3;3;0;100;0;290406.666666667;2127;128.333333333333
76173;2023;3;3;0;100;0;213453.333333333;1805;118.333333333333
76174;2023;4;4;0;100;0;173597.5;1509.75;116.75
76175;2023;2;2;0;100;0;130500;1285;105.5
76176;2023;5;5;0;100;0;208491;2672;74.8
76177;2023;3;3;0;100;0;228000;2144.33333333333;105.666666666667
76178;2023;30;28;2;93.3333333333333;6.66666666666667;174899.333333333;1937.6;90.8
76179;2023;11;11;0;100;0;222477.272727273;1981;109.090909090909
76180;2023;3;3;0;100;0;177666.666666667;1232;135.333333333333
76181;2023;1;1;0;100;0;72800;809;90
76182;2023;1;1;0;100;0;180000;2400;75
76183;2023;2;2;0;100;0;246000;2107.5;129
76184;2023;2;2;0;100;0;210500;1956;111
76185;2023;3;3;0;100;0;147450;1895;77
76186;2023;2;2;0;100;0;108750;1537;71
76187;2023;1;1;0;100;0;335450;2313;145
76188;2023;6;6;0;100;0;194433.333333333;1877.5;102.666666666667
76189;2023;2;2;0;100;0;165500;1877;88.5
76190;2023;4;4;0;100;0;148132.5;1525.75;97.25
76192;2023;64;48;16;75;25;179764.046875;2555.609375;74.90625
76193;2023;4;4;0;100;0;218937.5;2322.5;97.75
76194;2023;2;2;0;100;0;227500;1257;192
76195;2023;3;3;0;100;0;184166.666666667;1424.66666666667;130.333333333333
76196;2023;27;25;2;92.5925925925926;7.40740740740741;254429.62962963;2660.66666666667;99.4074074074074
76197;2023;3;3;0;100;0;171566.666666667;1650.66666666667;97.3333333333333
76198;2023;10;10;0;100;0;166550;1888;88.7
76199;2023;6;6;0;100;0;142166.666666667;1612.83333333333;86
76200;2023;6;6;0;100;0;306515;2845.83333333333;125.166666666667
76201;2023;3;3;0;100;0;193500;1821;109.333333333333
76202;2023;1;1;0;100;0;182580;1863;98
76203;2023;5;5;0;100;0;179030;2054.2;86.8
76204;2023;2;2;0;100;0;220700;1386;159.5
76205;2023;4;4;0;100;0;121400;1744;75.75
76206;2023;4;4;0;100;0;235655;2172.5;108.25
76207;2023;3;3;0;100;0;79833.3333333333;1641;52
76208;2023;11;11;0;100;0;182211.363636364;1877;101.272727272727
76209;2023;6;6;0;100;0;181333.333333333;1914.16666666667;109.5
76210;2023;5;5;0;100;0;157890;1650;91.4
76211;2023;3;3;0;100;0;103333.333333333;1495.33333333333;66.6666666666667
76212;2023;113;59;54;52.212389380531;47.787610619469;143302.221238938;2218.91150442478;64.5929203539823
76213;2023;1;1;0;100;0;197500;1846;107
76214;2023;1;1;0;100;0;71000;1578;45
76216;2023;155;77;78;49.6774193548387;50.3225806451613;148528.606451613;2121.4;68.9870967741935
76217;2023;511;163;348;31.8982387475538;68.1017612524462;149258.757338552;2449.62035225049;63.4990215264188
76218;2023;3;3;0;100;0;253016.666666667;3339;90
76219;2023;25;24;1;96;4;141588;1586.2;88.12
76220;2023;7;7;0;100;0;212950;2084.14285714286;106.428571428571
76221;2023;5;5;0;100;0;270932;2592.4;98.6
76222;2023;47;36;11;76.5957446808511;23.4042553191489;183042.872340426;2100.06382978723;85.8297872340426
76223;2023;6;6;0;100;0;280650;2684;112.333333333333
76224;2023;6;6;0;100;0;229353.333333333;2740.66666666667;86.1666666666667
76225;2023;5;5;0;100;0;188580;2144.6;90.8
76226;2023;1;1;0;100;0;165000;1650;100
76227;2023;9;9;0;100;0;230422.222222222;2019.33333333333;114.222222222222
76228;2023;3;3;0;100;0;146833.333333333;1699.33333333333;88
76229;2023;1;1;0;100;0;240300;2019;119
76230;2023;2;2;0;100;0;53500;1385;35
76231;2023;136;51;85;37.5;62.5;112353.985294118;1485.02205882353;77.5073529411765
76232;2023;8;8;0;100;0;184625;1833.25;102.625
76233;2023;1;1;0;100;0;28000;933;30
76234;2023;5;5;0;100;0;189090;1765.6;131.4
76235;2023;25;22;3;88;12;169594;1781.08;99.56
76236;2023;6;6;0;100;0;235591.666666667;2230.16666666667;115
76237;2023;7;7;0;100;0;170092.857142857;2078.42857142857;82.2857142857143
76238;2023;20;20;0;100;0;248092.5;2429.7;102.5
76239;2023;9;9;0;100;0;328377.777777778;2502.11111111111;138.333333333333
76240;2023;9;9;0;100;0;234650;2199.22222222222;117.777777777778
76241;2023;2;2;0;100;0;211125;1609.5;115
76242;2023;1;1;0;100;0;326500;2252;145
76243;2023;3;3;0;100;0;195733.333333333;2154.66666666667;91
76244;2023;4;4;0;100;0;255687.5;1806.75;146.25
76245;2023;13;13;0;100;0;187860;2162.92307692308;89.1538461538462
76247;2023;5;5;0;100;0;245200;2381.2;107.4
76249;2023;7;7;0;100;0;257607.142857143;3016.28571428571;94.7142857142857
76250;2023;5;5;0;100;0;246460;2503.4;98
76251;2023;3;3;0;100;0;187000;1931.33333333333;99
76252;2023;11;10;1;90.9090909090909;9.09090909090909;174236.363636364;2001.09090909091;93.0909090909091
76253;2023;7;7;0;100;0;251371.428571429;2142.14285714286;122.285714285714
76254;2023;46;36;10;78.2608695652174;21.7391304347826;229651.326086957;3218.17391304348;76.4565217391304
76255;2023;100;64;36;64;36;153300.91;1901.63;83.16
76257;2023;5;5;0;100;0;152400;1533;108.8
76258;2023;38;36;2;94.7368421052632;5.26315789473684;178777.368421053;2109.15789473684;84.1842105263158
76259;2023;292;174;118;59.5890410958904;40.4109589041096;163447.133561644;2247.91095890411;71.8527397260274
76260;2023;16;16;0;100;0;133084.375;1881.4375;75.4375
76261;2023;3;3;0;100;0;185000;2501.66666666667;74
76262;2023;3;3;0;100;0;149766.666666667;2113.66666666667;71
76263;2023;15;15;0;100;0;145273.333333333;1579.8;95.6666666666667
76264;2023;8;8;0;100;0;236000;1923.875;120.125
76266;2023;7;7;0;100;0;182171.428571429;2167;84.4285714285714
76268;2023;2;2;0;100;0;148500;1523;96.5
76270;2023;35;33;2;94.2857142857143;5.71428571428571;350423.228571429;3322.17142857143;107.771428571429
76271;2023;19;19;0;100;0;225742.105263158;1957.26315789474;115.894736842105
76272;2023;11;11;0;100;0;141250;1550.72727272727;95.4545454545455
76273;2023;6;6;0;100;0;275633.333333333;2193.83333333333;125.333333333333
76275;2023;15;15;0;100;0;307390;2877.26666666667;114.866666666667
76276;2023;51;45;6;88.2352941176471;11.7647058823529;136146.568627451;1569.25490196078;90.1176470588235
76278;2023;5;5;0;100;0;83850;1011.2;80.4
76279;2023;2;2;0;100;0;151500;2202.5;72
76280;2023;2;2;0;100;0;99000;853;122
76281;2023;18;16;2;88.8888888888889;11.1111111111111;179026.111111111;2226.94444444444;83.0555555555556
76282;2023;12;12;0;100;0;177655;2105.16666666667;91.9166666666667
76283;2023;4;4;0;100;0;201050;2254.5;91.75
76284;2023;1;1;0;100;0;234700;2324;101
76285;2023;8;8;0;100;0;266868.75;2058.375;130.25
76286;2023;8;8;0;100;0;114625;1144.625;115.875
76287;2023;12;12;0;100;0;268072.916666667;2293.58333333333;118
76288;2023;2;2;0;100;0;178500;1768.5;99
76289;2023;15;15;0;100;0;174853.333333333;1519.46666666667;117.533333333333
76290;2023;5;5;0;100;0;160160;1545.8;97.8
76291;2023;13;12;1;92.3076923076923;7.69230769230769;197428.461538462;2206.38461538462;90.3076923076923
76292;2023;2;2;0;100;0;214750;2229;97
76293;2023;6;6;0;100;0;170891.666666667;1885.5;96.5
76294;2023;5;5;0;100;0;126666;1729.6;76.2
76295;2023;17;16;1;94.1176470588235;5.88235294117647;79429.4117647059;1059.35294117647;75.7647058823529
76296;2023;24;23;1;95.8333333333333;4.16666666666667;240867.916666667;2435.95833333333;101.625
76297;2023;3;3;0;100;0;114500;1086;99.3333333333333
76298;2023;8;7;1;87.5;12.5;229326.875;2161.5;108
76299;2023;2;2;0;100;0;190500;2629;83
76300;2023;7;7;0;100;0;192142.857142857;1724.71428571429;115.285714285714
76302;2023;32;26;6;81.25;18.75;186589.0625;2343.0625;80.21875
76303;2023;9;9;0;100;0;226900;3021.88888888889;77.5555555555556
76304;2023;1;1;0;100;0;178000;2198;81
76305;2023;59;58;1;98.3050847457627;1.69491525423729;197100.847457627;2245.10169491525;90.3898305084746
76306;2023;1;1;0;100;0;120000;1237;97
76307;2023;17;13;4;76.4705882352941;23.5294117647059;167528.235294118;2252.64705882353;73.4705882352941
76308;2023;3;3;0;100;0;118033.333333333;1817.33333333333;72
76309;2023;2;2;0;100;0;212250;1349.5;183
76311;2023;3;3;0;100;0;157666.666666667;1831.33333333333;84.6666666666667
76312;2023;72;54;18;75;25;132136.097222222;1673.95833333333;80.375
76313;2023;13;11;2;84.6153846153846;15.3846153846154;253088.461538462;2938.84615384615;98.3846153846154
76314;2023;7;7;0;100;0;206001.428571429;2208.14285714286;96.7142857142857
76315;2023;9;9;0;100;0;132111;1581.88888888889;81.7777777777778
76316;2023;4;4;0;100;0;188800;1944.75;105.75
76317;2023;4;4;0;100;0;202627.5;1410.5;161.25
76318;2023;7;7;0;100;0;224591.428571429;2399.57142857143;94.1428571428571
76319;2023;66;63;3;95.4545454545455;4.54545454545455;184638.53030303;2114.57575757576;91.5
76320;2023;4;4;0;100;0;71875;896.75;91.25
76321;2023;19;18;1;94.7368421052632;5.26315789473684;223113.157894737;2245.94736842105;95.4210526315789
76322;2023;126;69;57;54.7619047619048;45.2380952380952;176479.76984127;2284.45238095238;78.4206349206349
76323;2023;2;2;0;100;0;175000;1952.5;89.5
76324;2023;5;5;0;100;0;279800;2548.6;109.2
76325;2023;10;10;0;100;0;171082.5;1606.4;114.5
76327;2023;7;7;0;100;0;173157.142857143;1466.14285714286;107.714285714286
76328;2023;4;4;0;100;0;196925;1997.75;98.25
76329;2023;33;27;6;81.8181818181818;18.1818181818182;155458.666666667;1846.36363636364;85.3030303030303
76330;2023;9;9;0;100;0;241205.555555556;2252.11111111111;120
76331;2023;10;10;0;100;0;205860;2176.9;100.1
76332;2023;6;6;0;100;0;139150;1439.83333333333;98.1666666666667
76333;2023;7;7;0;100;0;142354.285714286;1466;104.428571428571
76334;2023;10;10;0;100;0;179580;1837.2;91.7
76336;2023;4;4;0;100;0;184905;2120.75;83.25
76338;2023;1;1;0;100;0;172500;1816;95
76339;2023;1;1;0;100;0;95000;1011;94
76340;2023;5;5;0;100;0;155800;2207.8;87.4
76341;2023;63;36;27;57.1428571428571;42.8571428571429;162763.968253968;2252.93650793651;72.6825396825397
76342;2023;3;3;0;100;0;180133.333333333;2087.66666666667;87
76343;2023;5;5;0;100;0;120700;1276.6;92.4
76344;2023;7;7;0;100;0;137248.142857143;1346.85714285714;99.8571428571429
76345;2023;5;4;1;80;20;97197;1268.2;83.8
76346;2023;4;4;0;100;0;135800;1345.5;122
76347;2023;4;4;0;100;0;337450;2672.5;131.25
76348;2023;7;7;0;100;0;175457.142857143;1958.42857142857;88.8571428571429
76349;2023;26;23;3;88.4615384615385;11.5384615384615;328005.769230769;3112.5;112.423076923077
76350;2023;4;3;1;75;25;181356.25;1964.5;100.5
76351;2023;2341;724;1617;30.9269542930372;69.0730457069628;165872.238786843;2480.06236651004;66.9205467748825
76352;2023;8;8;0;100;0;186085;2011.375;92.625
76353;2023;4;4;0;100;0;214975;2195;98.5
76354;2023;8;8;0;100;0;249500;2331;106
76355;2023;15;15;0;100;0;147717.333333333;1639.66666666667;90.6
76356;2023;3;3;0;100;0;148866.666666667;1289.33333333333;115.666666666667
76357;2023;2;2;0;100;0;201850;2358.5;86
76358;2023;2;2;0;100;0;152710;1914;86
76359;2023;3;3;0;100;0;220000;1807.33333333333;115.333333333333
76360;2023;11;11;0;100;0;237212.727272727;2148.81818181818;111.818181818182
76361;2023;3;3;0;100;0;253500;2309.33333333333;114.333333333333
76362;2023;5;5;0;100;0;154370;2124.8;83.2
76363;2023;5;5;0;100;0;140860;1403.6;98.2
76364;2023;1;1;0;100;0;205000;2113;97
76366;2023;57;51;6;89.4736842105263;10.5263157894737;153952.98245614;1975.0350877193;78.0877192982456
76367;2023;32;31;1;96.875;3.125;279387.8125;2610.21875;111.15625
76368;2023;2;2;0;100;0;211750;1793;115
76369;2023;7;7;0;100;0;212807.142857143;2083;108.714285714286
76370;2023;3;3;0;100;0;228166.666666667;2033;135.666666666667
76372;2023;2;2;0;100;0;86250;1433.5;59.5
76373;2023;4;4;0;100;0;157937.5;1507.5;112
76374;2023;19;19;0;100;0;112158.421052632;1650.21052631579;68.1052631578947
76375;2023;5;5;0;100;0;228542;2291.4;101.6
76377;2023;38;35;3;92.1052631578947;7.89473684210526;350530.657894737;3140;111.736842105263
76378;2023;18;18;0;100;0;225958.333333333;2905.88888888889;84.6111111111111
76379;2023;2;2;0;100;0;393750;2352.5;165
76381;2023;2;2;0;100;0;157000;1627;96.5
76382;2023;16;15;1;93.75;6.25;157938.9375;1837.4375;90.25
76384;2023;110;86;24;78.1818181818182;21.8181818181818;126666.245454545;1713.00909090909;78.1454545454545
76385;2023;19;19;0;100;0;182657.894736842;1836;103.210526315789
76386;2023;5;5;0;100;0;160700;2072.8;77.2
76387;2023;3;3;0;100;0;135666.666666667;1483.33333333333;87
76388;2023;4;4;0;100;0;157250;2073.5;84
76389;2023;1;1;0;100;0;260000;2737;95
76390;2023;14;13;1;92.8571428571429;7.14285714285714;204760.714285714;2209.07142857143;97.0714285714286
76391;2023;22;22;0;100;0;217851.818181818;2030.5;108.636363636364
76392;2023;13;13;0;100;0;145286.923076923;1606.23076923077;93.6923076923077
76394;2023;7;7;0;100;0;113214.285714286;1508.42857142857;74.5714285714286
76395;2023;3;3;0;100;0;295315;2823;106.333333333333
76396;2023;2;2;0;100;0;230065;2279.5;101.5
76397;2023;16;15;1;93.75;6.25;134684.375;1729.6875;78.375
76398;2023;7;7;0;100;0;215380.714285714;2164.71428571429;99.7142857142857
76399;2023;5;5;0;100;0;138500;1282.4;111.8
76400;2023;26;22;4;84.6153846153846;15.3846153846154;186203.846153846;2090.42307692308;91.3076923076923
76401;2023;31;30;1;96.7741935483871;3.2258064516129;184105.483870968;1935.61290322581;100.387096774194
76402;2023;73;73;0;100;0;212011.904109589;2324.50684931507;92.013698630137
76403;2023;3;3;0;100;0;282566.666666667;1984;155.333333333333
76404;2023;19;19;0;100;0;270227.157894737;2624.68421052632;105.894736842105
76405;2023;3;3;0;100;0;172000;1301.66666666667;127.333333333333
76406;2023;9;3;6;33.3333333333333;66.6666666666667;123314.666666667;1875.55555555556;58
76407;2023;4;4;0;100;0;189930;2391;81
76408;2023;10;10;0;100;0;209400;2169.8;95.5
76409;2023;7;7;0;100;0;287221.428571429;3434.71428571429;91.8571428571429
76410;2023;104;45;59;43.2692307692308;56.7307692307692;129182.355769231;1719.75961538462;77.0096153846154
76411;2023;3;3;0;100;0;137333.333333333;1735.66666666667;81
76412;2023;8;8;0;100;0;235012.5;2027.125;119.375
76413;2023;3;3;0;100;0;240283.333333333;2400.66666666667;100.333333333333
76414;2023;11;11;0;100;0;247848.636363636;2417.63636363636;106
76415;2023;5;5;0;100;0;130815;1168.8;105.8
76416;2023;3;3;0;100;0;156566.666666667;1616.66666666667;96.3333333333333
76417;2023;3;3;0;100;0;141333.333333333;1399;97
76418;2023;9;9;0;100;0;214888.888888889;2165.44444444444;95.8888888888889
76419;2023;4;4;0;100;0;252594.5;2807;89.5
76420;2023;3;3;0;100;0;120500;1080.33333333333;107.666666666667
76421;2023;8;8;0;100;0;256507.75;2223.125;120.375
76422;2023;1;1;0;100;0;159250;1361;117
76423;2023;1;1;0;100;0;550500;2373;232
76425;2023;4;4;0;100;0;236250;2036.75;117.25
76426;2023;1;1;0;100;0;145000;2636;55
76427;2023;5;5;0;100;0;145300;1468.8;101.4
76428;2023;1;1;0;100;0;2,00E+05;1667;120
76429;2023;146;69;77;47.2602739726027;52.7397260273973;252280.643835616;2954.58219178082;84.9383561643836
76430;2023;1;1;0;100;0;117000;1194;98
76431;2023;3;3;0;100;0;108000;1465.33333333333;75
76432;2023;5;5;0;100;0;271150;2140.4;125.4
76433;2023;10;10;0;100;0;217690;2021.1;116.3
76434;2023;7;7;0;100;0;267122;2673.57142857143;109.857142857143
76435;2023;6;6;0;100;0;205987.5;2115.5;106.166666666667
76436;2023;6;6;0;100;0;286996;2214.66666666667;137.166666666667
76437;2023;8;8;0;100;0;198875;1616;119.5
76438;2023;2;2;0;100;0;176450;1870;95
76439;2023;5;5;0;100;0;236120;2001.4;120.2
76440;2023;1;1;0;100;0;80000;2222;36
76441;2023;6;6;0;100;0;147393.333333333;1580.33333333333;94
76442;2023;2;2;0;100;0;254000;1940;128.5
76443;2023;6;6;0;100;0;223700;2272.5;101.333333333333
76445;2023;3;3;0;100;0;187333.333333333;2462;71.3333333333333
76446;2023;16;16;0;100;0;321446.875;2621.25;118.5
76447;2023;168;117;51;69.6428571428571;30.3571428571429;222898.982142857;2656.24404761905;83.3511904761905
76448;2023;14;14;0;100;0;219532.142857143;2142.21428571429;105.571428571429
76449;2023;7;7;0;100;0;186650;1740.71428571429;110.714285714286
76450;2023;1;1;0;100;0;195000;1806;108
76451;2023;309;97;212;31.3915857605178;68.6084142394822;258072.708737864;2717.77669902913;87.9611650485437
76452;2023;53;52;1;98.1132075471698;1.88679245283019;204153.528301887;2252.47169811321;92.0754716981132
76453;2023;18;18;0;100;0;207247.222222222;2130.77777777778;99.6111111111111
76455;2023;7;7;0;100;0;167228.571428571;1787.42857142857;95.8571428571429
76456;2023;9;9;0;100;0;188688.888888889;1991.33333333333;94.3333333333333
76457;2023;7;5;2;71.4285714285714;28.5714285714286;149607.142857143;2002.28571428571;75
76459;2023;5;5;0;100;0;136900;1513.4;88.8
76460;2023;4;4;0;100;0;161500;1387.75;123.75
76461;2023;3;3;0;100;0;263500;1976;136.333333333333
76462;2023;58;48;10;82.7586206896552;17.2413793103448;157783.982758621;1836;89.4137931034483
76463;2023;8;8;0;100;0;201250;2522.875;93.125
76464;2023;22;22;0;100;0;240186.772727273;2431.72727272727;105.590909090909
76465;2023;9;9;0;100;0;187311.111111111;1718.44444444444;112.444444444444
76467;2023;18;18;0;100;0;154548.333333333;1836.16666666667;82.8888888888889
76468;2023;26;26;0;100;0;203425.423076923;1971.96153846154;103.230769230769
76469;2023;3;3;0;100;0;155000;1788.66666666667;86.3333333333333
76470;2023;3;3;0;100;0;130633.333333333;1911;73
76471;2023;11;11;0;100;0;171120.090909091;2041.90909090909;85.8181818181818
76472;2023;12;12;0;100;0;207891;2339.75;89.8333333333333
76473;2023;8;8;0;100;0;197875;1909.375;99.25
76474;2023;95;75;20;78.9473684210526;21.0526315789474;182903.157894737;2359;79.1052631578947
76475;2023;65;62;3;95.3846153846154;4.61538461538462;315102.923076923;2919.01538461538;109.892307692308
76476;2023;108;92;16;85.1851851851852;14.8148148148148;161272.416666667;1823.05555555556;92.1018518518518
76477;2023;3;3;0;100;0;287576.666666667;2410.66666666667;119.333333333333
76478;2023;1;1;0;100;0;153600;2163;71
76479;2023;4;4;0;100;0;108780.5;993;117.25
76480;2023;2;2;0;100;0;159250;1493.5;105.5
76481;2023;51;49;2;96.078431372549;3.92156862745098;444330.607843137;3360.35294117647;137.588235294118
76482;2023;23;22;1;95.6521739130435;4.34782608695652;254147.434782609;2489.69565217391;101.521739130435
76483;2023;4;4;0;100;0;258250;2051.5;131.5
76484;2023;96;95;1;98.9583333333333;1.04166666666667;150273.28125;1890.41666666667;80.6770833333333
76485;2023;2;2;0;100;0;90000;1107;80
76486;2023;8;8;0;100;0;140575;1802.125;79
76487;2023;7;7;0;100;0;164685.714285714;1933.14285714286;93.8571428571429
76488;2023;5;5;0;100;0;165880;1856;109
76489;2023;1;1;0;100;0;230300;3489;66
76490;2023;14;14;0;100;0;161285.714285714;1925.64285714286;88.0714285714286
76491;2023;10;10;0;100;0;208538.8;1798.3;121.9
76492;2023;7;7;0;100;0;174721.428571429;1940.14285714286;102
76493;2023;5;5;0;100;0;141800;1560.4;96
76494;2023;2;2;0;100;0;265000;2490;127.5
76495;2023;55;54;1;98.1818181818182;1.81818181818182;160399.345454545;1877;85.8909090909091
76497;2023;72;50;22;69.4444444444444;30.5555555555556;150516.319444444;1829.13888888889;82.8055555555556
76498;2023;272;164;108;60.2941176470588;39.7058823529412;128685.202205882;1951.3125;67.3639705882353
76499;2023;20;20;0;100;0;155326.85;1695.3;92.85
76500;2023;3;3;0;100;0;117666.666666667;1485.33333333333;79.3333333333333
76502;2023;5;5;0;100;0;276460;2159.8;128.8
76503;2023;10;10;0;100;0;240912;2065.2;123.5
76504;2023;1;1;0;100;0;310000;2199;141
76505;2023;2;2;0;100;0;207500;1344.5;153
76506;2023;5;5;0;100;0;158850;1939.6;85.4
76507;2023;8;8;0;100;0;145260.5;1924.625;79
76508;2023;4;4;0;100;0;208125;2105.25;101.25
76509;2023;14;14;0;100;0;268262;2185.78571428571;126.928571428571
76510;2023;1;1;0;100;0;415000;2150;193
76511;2023;1;1;0;100;0;65000;970;67
76513;2023;4;4;0;100;0;172425;1759.75;96.25
76514;2023;8;8;0;100;0;218225;2611.125;88.25
76515;2023;11;9;2;81.8181818181818;18.1818181818182;199472.727272727;2448.09090909091;87.0909090909091
76516;2023;6;6;0;100;0;173500;1836.33333333333;95.5
76517;2023;20;20;0;100;0;358856;2875.55;127.35
76518;2023;4;4;0;100;0;262375;2133.5;115.75
76519;2023;2;2;0;100;0;122500;1591;77
76520;2023;11;11;0;100;0;125104.545454545;1683.36363636364;74.6363636363636
76521;2023;2;2;0;100;0;99500;1947;48.5
76522;2023;7;7;0;100;0;245728.571428571;2199.14285714286;118.142857142857
76523;2023;1;1;0;100;0;141082;1383;102
76524;2023;6;6;0;100;0;145666.666666667;1407.16666666667;118.666666666667
76526;2023;3;3;0;100;0;157596.666666667;1966.66666666667;79.6666666666667
76527;2023;14;14;0;100;0;145514.285714286;1741.21428571429;86.7142857142857
76528;2023;1;1;0;100;0;175000;1667;105
76529;2023;1;1;0;100;0;195000;1822;107
76530;2023;4;4;0;100;0;207803.5;2041.5;103.25
76531;2023;1;1;0;100;0;185000;2891;64
76532;2023;4;4;0;100;0;180625;1698.75;107.5
76533;2023;13;13;0;100;0;255800;2687.69230769231;98.1538461538462
76534;2023;10;10;0;100;0;223288;2433.6;93.3
76535;2023;4;4;0;100;0;164125;1710;101.25
76536;2023;12;12;0;100;0;272754.166666667;2460.08333333333;112.25
76537;2023;3;3;0;100;0;99563;1769.33333333333;74.3333333333333
76538;2023;5;5;0;100;0;202660;1456.8;136.2
76540;2023;2106;351;1755;16.6666666666667;83.3333333333333;164799.790598291;2871.33523266857;59.3019943019943
76541;2023;13;11;2;84.6153846153846;15.3846153846154;279961.538461538;2132.30769230769;136.923076923077
76542;2023;3;3;0;100;0;134666.666666667;1297.33333333333;104
76543;2023;7;7;0;100;0;245100;2285.85714285714;106.142857142857
76544;2023;4;4;0;100;0;173875;1453.25;126
76545;2023;21;13;8;61.9047619047619;38.0952380952381;150119.047619048;1932.2380952381;76.5714285714286
76546;2023;5;5;0;100;0;168600;1809.4;90.6
76547;2023;6;6;0;100;0;268825;2265.5;128
76548;2023;9;9;0;100;0;235822.222222222;2464.44444444444;101.555555555556
76549;2023;1;1;0;100;0;178500;2412;74
76550;2023;10;10;0;100;0;206305;2180.6;95.9
76551;2023;7;7;0;100;0;169714.285714286;2006;84.2857142857143
76552;2023;110;51;59;46.3636363636364;53.6363636363636;360073.818181818;3774.81818181818;94.0454545454545
76553;2023;2;2;0;100;0;142500;1646;75.5
76554;2023;1;1;0;100;0;262000;1747;150
76555;2023;7;7;0;100;0;239297.142857143;2142.85714285714;111.142857142857
76556;2023;9;9;0;100;0;186600;1847.33333333333;101.222222222222
76557;2023;8;8;0;100;0;198681.25;2072.875;101.125
76558;2023;6;6;0;100;0;283181.666666667;2167.33333333333;131.333333333333
76559;2023;5;5;0;100;0;234520;1895.6;134
76560;2023;7;7;0;100;0;271341.428571429;2363;114.285714285714
76561;2023;104;75;29;72.1153846153846;27.8846153846154;131435.057692308;1743.625;76.5480769230769
76562;2023;11;10;1;90.9090909090909;9.09090909090909;261243.636363636;3151.63636363636;91.0909090909091
76563;2023;19;18;1;94.7368421052632;5.26315789473684;254499.052631579;2080.42105263158;122.736842105263
76564;2023;8;8;0;100;0;288125;2801.875;115.375
76565;2023;12;11;1;91.6666666666667;8.33333333333333;334950;2042.83333333333;171.833333333333
76566;2023;10;10;0;100;0;187428.5;1896.6;103
76568;2023;3;3;0;100;0;251666.666666667;1898;137.666666666667
76569;2023;1;1;0;100;0;335000;2991;112
76571;2023;6;6;0;100;0;194116.666666667;1631.66666666667;125.666666666667
76572;2023;2;2;0;100;0;123220;1677.5;72
76573;2023;4;4;0;100;0;160925;1794.25;89.5
76574;2023;7;7;0;100;0;185608.857142857;1712.71428571429;109.571428571429
76575;2023;260;199;61;76.5384615384615;23.4615384615385;152216.134615385;1904.24615384615;80.3730769230769
76576;2023;7;7;0;100;0;169485.714285714;2766.42857142857;83.5714285714286
76577;2023;4;4;0;100;0;196750;1575.25;127
76578;2023;2;2;0;100;0;252500;3735;98
76580;2023;9;9;0;100;0;205111.111111111;2474.22222222222;85.7777777777778
76581;2023;3;3;0;100;0;143000;1811.66666666667;79
76582;2023;3;3;0;100;0;186336;1567.33333333333;113.333333333333
76583;2023;2;2;0;100;0;152000;1392.5;105.5
76584;2023;2;2;0;100;0;94000;1187.5;66.5
76585;2023;2;2;0;100;0;252000;2388;109
76586;2023;10;10;0;100;0;179251;2076.5;88.8
76587;2023;8;8;0;100;0;231625;2237.625;102.75
76588;2023;6;6;0;100;0;246900;2892.16666666667;93.6666666666667
76589;2023;2;2;0;100;0;170955;2027.5;85.5
76590;2023;4;4;0;100;0;152400;1608.25;100.25
76591;2023;27;27;0;100;0;335337.037037037;2522.14814814815;133.111111111111
76592;2023;3;3;0;100;0;228505.666666667;2748;90
76593;2023;7;7;0;100;0;232500;2229.42857142857;107.285714285714
76594;2023;12;12;0;100;0;249108.333333333;2600.5;97.25
76595;2023;22;22;0;100;0;299195.454545455;2726.45454545455;120.5
76596;2023;19;19;0;100;0;233061;2434.42105263158;98.6315789473684
76597;2023;13;12;1;92.3076923076923;7.69230769230769;110139.461538462;1427.61538461538;78.3846153846154
76598;2023;6;6;0;100;0;119333.333333333;1228.5;95.1666666666667
76599;2023;40;36;4;90;10;196127.85;2377.4;84.45
76600;2023;31;26;5;83.8709677419355;16.1290322580645;190760.64516129;2390;89
76601;2023;6;6;0;100;0;160333.333333333;1927.5;88.5
76602;2023;4;4;0;100;0;150000;1539.25;107.25
76603;2023;5;5;0;100;0;129200;1380;93
76604;2023;3;3;0;100;0;351200;2559.33333333333;133.333333333333
76605;2023;12;11;1;91.6666666666667;8.33333333333333;254867.833333333;2925.41666666667;92.9166666666667
76608;2023;18;18;0;100;0;175419.444444444;2008.61111111111;91.7222222222222
76609;2023;6;6;0;100;0;265750;2709.66666666667;107.5
76610;2023;7;7;0;100;0;216007.142857143;2283.14285714286;101.714285714286
76611;2023;4;4;0;100;0;154500;2090.75;75.25
76612;2023;4;4;0;100;0;129250;1474;99.25
76613;2023;10;10;0;100;0;210813;2154.4;108.9
76614;2023;3;3;0;100;0;268666.666666667;2439;109
76615;2023;5;5;0;100;0;243946;2252.6;109.2
76616;2023;23;23;0;100;0;325517.47826087;2812.65217391304;120.304347826087
76617;2023;15;15;0;100;0;457000;2938.73333333333;151.533333333333
76618;2023;94;94;0;100;0;181947.159574468;2152.01063829787;90.8510638297872
76619;2023;4;4;0;100;0;217375;1634.25;126.75
76620;2023;6;6;0;100;0;153566.666666667;1507.16666666667;109.5
76621;2023;5;5;0;100;0;196830;2012;102
76622;2023;1;1;0;100;0;225000;1875;120
76623;2023;1;1;0;100;0;153000;2318;66
76624;2023;44;44;0;100;0;149071.136363636;1801.72727272727;87.0454545454545
76626;2023;4;4;0;100;0;213125;1998.75;110.75
76627;2023;14;14;0;100;0;246125.714285714;2306.35714285714;114.142857142857
76628;2023;4;4;0;100;0;230800;2244.75;103
76629;2023;3;3;0;100;0;135000;1066;117.333333333333
76631;2023;11;11;0;100;0;175691.090909091;1809.27272727273;95.6363636363636
76632;2023;9;9;0;100;0;184155.555555556;2035.22222222222;89.7777777777778
76634;2023;6;6;0;100;0;176841.666666667;1639.83333333333;106.333333333333
76635;2023;2;2;0;100;0;127500;969;146
76636;2023;16;16;0;100;0;204625;2041.75;102.125
76637;2023;23;23;0;100;0;170509.695652174;1992.21739130435;89.2173913043478
76638;2023;9;9;0;100;0;157001.111111111;1658.44444444444;91.5555555555556
76640;2023;69;50;19;72.463768115942;27.536231884058;158279.710144928;1725.94202898551;93.4782608695652
76641;2023;1;1;0;100;0;188000;2686;70
76642;2023;2;2;0;100;0;212500;2605.5;70
76645;2023;1;1;0;100;0;115000;1691;68
76646;2023;8;8;0;100;0;195781.25;1962.875;103.25
76647;2023;59;45;14;76.271186440678;23.728813559322;210898.644067797;2504.42372881356;85.3559322033898
76648;2023;16;16;0;100;0;116423.125;1721.5625;79.375
76649;2023;8;8;0;100;0;197337.5;2244.625;97
76650;2023;12;12;0;100;0;249124.583333333;2118.66666666667;124.333333333333
76651;2023;1;1;0;100;0;160000;1481;108
76652;2023;8;8;0;100;0;146500;1533.875;96.5
76653;2023;7;7;0;100;0;166928.571428571;2054.85714285714;78.5714285714286
76654;2023;2;2;0;100;0;270000;1796;153.5
76655;2023;94;52;42;55.3191489361702;44.6808510638298;166910.287234043;2268.1170212766;81.1914893617021
76656;2023;6;6;0;100;0;173582.5;1616.5;116.333333333333
76657;2023;8;8;0;100;0;222187.5;2823.25;85.375
76658;2023;4;4;0;100;0;234250;2644.25;94.25
76660;2023;4;4;0;100;0;279625;2498;119.5
76662;2023;1;1;0;100;0;2,00E+05;909;220
76663;2023;14;14;0;100;0;271412.857142857;2188;125.285714285714
76664;2023;6;6;0;100;0;156283.333333333;1452.33333333333;111
76665;2023;6;6;0;100;0;190666.666666667;1746.5;115.666666666667
76666;2023;4;4;0;100;0;89000;1169;79.25
76667;2023;3;3;0;100;0;269966.666666667;1924.33333333333;173
76668;2023;3;3;0;100;0;209716.666666667;1835;120.666666666667
76669;2023;4;4;0;100;0;100750;1460.5;71.75
76670;2023;9;9;0;100;0;161956.666666667;2407.22222222222;82.2222222222222
76671;2023;2;2;0;100;0;242700;2266.5;103.5
76672;2023;14;13;1;92.8571428571429;7.14285714285714;145612.142857143;1847.57142857143;88.2857142857143
76673;2023;8;8;0;100;0;214990;1808.75;131.75
76675;2023;13;13;0;100;0;190700;1967.84615384615;101
76676;2023;3;3;0;100;0;158666.666666667;1386.66666666667;113.333333333333
76677;2023;3;3;0;100;0;88333.3333333333;1466.66666666667;62.6666666666667
76678;2023;14;14;0;100;0;162164.285714286;1592.28571428571;103.928571428571
76679;2023;1;1;0;100;0;301500;1464;206
76680;2023;1;1;0;100;0;222100;2441;91
76681;2023;356;246;110;69.1011235955056;30.8988764044944;162367.025280899;2238.50561797753;73.2949438202247
76682;2023;5;5;0;100;0;237300;2374.6;101.8
76683;2023;3;3;0;100;0;172800;2400.66666666667;78
76684;2023;14;14;0;100;0;202142.142857143;2071.71428571429;101.642857142857
76685;2023;10;10;0;100;0;231725.8;2094.5;111.3
76686;2023;3;3;0;100;0;219333.333333333;2269;96.6666666666667
76688;2023;1;1;0;100;0;172500;2875;60
76689;2023;6;6;0;100;0;202166.666666667;2017.66666666667;101.333333333333
76690;2023;6;6;0;100;0;135500;1593.5;86.8333333333333
76691;2023;3;3;0;100;0;155200;2069.33333333333;89.6666666666667
76692;2023;3;3;0;100;0;253000;2385;105
76693;2023;6;6;0;100;0;249583.333333333;2376.83333333333;116.166666666667
76695;2023;1;1;0;100;0;90000;1579;57
76697;2023;9;9;0;100;0;125377.777777778;1615;81.8888888888889
76698;2023;6;6;0;100;0;164475;1802.5;98.1666666666667
76699;2023;3;3;0;100;0;155233.333333333;1882.66666666667;82.3333333333333
76700;2023;16;15;1;93.75;6.25;144719.375;1618.4375;92.5625
76702;2023;15;15;0;100;0;221447.666666667;2300.86666666667;95.5333333333333
76703;2023;2;2;0;100;0;201530;1219.5;192.5
76705;2023;23;19;4;82.6086956521739;17.3913043478261;175250.130434783;1948.39130434783;92.4782608695652
76706;2023;13;13;0;100;0;207161.538461538;2289.07692307692;95.7692307692308
76707;2023;14;14;0;100;0;176039.285714286;2188.14285714286;88.8571428571429
76708;2023;10;10;0;100;0;194102.7;2160.2;94.9
76709;2023;49;43;6;87.7551020408163;12.2448979591837;131366.93877551;1628.22448979592;83
76710;2023;2;2;0;100;0;146750;1866.5;78.5
76711;2023;104;63;41;60.5769230769231;39.4230769230769;126615.913461538;2395.46153846154;56.6730769230769
76712;2023;9;9;0;100;0;194111.111111111;2014.66666666667;95.7777777777778
76714;2023;6;6;0;100;0;325791.666666667;2664.16666666667;126.5
76715;2023;4;4;0;100;0;164900;1545;117.5
76716;2023;14;14;0;100;0;285366.071428571;2594.71428571429;112.571428571429
76717;2023;9;9;0;100;0;224411.111111111;2284.88888888889;102.444444444444
76718;2023;13;13;0;100;0;340201.461538462;2969.92307692308;112.846153846154
76719;2023;10;10;0;100;0;172235;1595.3;110.4
76720;2023;18;16;2;88.8888888888889;11.1111111111111;224798.611111111;2857.44444444444;99.2777777777778
76723;2023;7;7;0;100;0;156442.857142857;2186.71428571429;66.5714285714286
76724;2023;4;4;0;100;0;1,00E+05;1684.75;63
76725;2023;7;7;0;100;0;278071.428571429;2501.85714285714;120.714285714286
76726;2023;4;4;0;100;0;175250;2880.75;70.5
76727;2023;11;11;0;100;0;191600;2064.18181818182;113.090909090909
76728;2023;12;12;0;100;0;263350;3435.33333333333;104.666666666667
76730;2023;2;2;0;100;0;101250;1100;92
76731;2023;1;1;0;100;0;2,00E+05;1307;153
76732;2023;4;4;0;100;0;231339.25;2266.25;102.25
76733;2023;1;1;0;100;0;160000;3404;47
76734;2023;4;4;0;100;0;331000;2558;140.75
76735;2023;11;8;3;72.7272727272727;27.2727272727273;260603;3741.18181818182;68.9090909090909
76736;2023;7;7;0;100;0;241500;2550.14285714286;91.7142857142857
76737;2023;2;2;0;100;0;164200;2849;58
76738;2023;5;5;0;100;0;264600;2394.6;111.2
76739;2023;4;4;0;100;0;142500;1786;80.75
76740;2023;5;5;0;100;0;253300;1903;133
76741;2023;3;3;0;100;0;241760;2480.66666666667;98
76743;2023;32;31;1;96.875;3.125;176013.9375;1865.09375;93.84375
76744;2023;2;2;0;100;0;138500;1441.5;95
76745;2023;1;1;0;100;0;120000;1481;81
76746;2023;5;5;0;100;0;182494.6;1948.8;99.8
76747;2023;1;1;0;100;0;224500;2004;112
76748;2023;8;8;0;100;0;227843.75;2146.875;108.875
76749;2023;7;7;0;100;0;136971.428571429;1615;90.7142857142857
76750;2023;13;12;1;92.3076923076923;7.69230769230769;195007.692307692;1869.46153846154;97
76751;2023;8;8;0;100;0;191450;1757.5;109.375
76752;2023;28;27;1;96.4285714285714;3.57142857142857;181151.785714286;1740.46428571429;106.321428571429
76753;2023;12;12;0;100;0;235874.166666667;2298.75;102.25
76754;2023;22;21;1;95.4545454545455;4.54545454545455;238314.136363636;3463.54545454545;73
76755;2023;4;4;0;100;0;198226.25;1749.25;118
76756;2023;3;3;0;100;0;271666.666666667;1861.66666666667;148
76757;2023;5;5;0;100;0;126200;1603.6;75.4
76758;2023;163;94;69;57.6687116564417;42.3312883435583;185143.214723926;2216.48466257669;80.0613496932515
76759;2023;3;3;0;100;0;321223.333333333;2540.33333333333;116
77001;2023;15;15;0;100;0;326406.933333333;2779.06666666667;124.2
77002;2023;12;11;1;91.6666666666667;8.33333333333333;209183.333333333;2556;98.75
77003;2023;2;2;0;100;0;267000;1625.5;164
77004;2023;2;2;0;100;0;301500;3055.5;100.5
77005;2023;28;17;11;60.7142857142857;39.2857142857143;288080.178571429;3570.32142857143;84.1785714285714
77006;2023;9;9;0;100;0;452385.555555556;3293;143.222222222222
77007;2023;5;5;0;100;0;274840;3375.6;84.4
77008;2023;7;7;0;100;0;311809.571428571;2901;112.428571428571
77010;2023;9;9;0;100;0;262130;2514.33333333333;109.444444444444
77011;2023;4;4;0;100;0;205038.5;1990;111.5
77012;2023;3;3;0;100;0;161666.666666667;1677;94
77013;2023;5;5;0;100;0;253804;2828.8;136.2
77014;2023;265;46;219;17.3584905660377;82.6415094339623;204398.233962264;3322.03773584906;63.6075471698113
77015;2023;1;1;0;100;0;79000;1215;65
77016;2023;7;7;0;100;0;151857.142857143;2086.28571428571;71.4285714285714
77018;2023;88;40;48;45.4545454545455;54.5454545454545;350928.693181818;4393.45454545455;80.9431818181818
77019;2023;10;10;0;100;0;177699;1845.5;93.8
77020;2023;8;8;0;100;0;213125;2096;101.625
77021;2023;1;1;0;100;0;180000;2647;68
77022;2023;21;17;4;80.9523809523809;19.047619047619;540501.904761905;4992.14285714286;117.857142857143
77023;2023;5;5;0;100;0;246300;2659.6;95.4
77024;2023;1;1;0;100;0;350000;1400;250
77025;2023;15;15;0;100;0;166846.666666667;1906.53333333333;87.8666666666667
77026;2023;4;4;0;100;0;127895;1278.5;95
77027;2023;14;14;0;100;0;156488.571428571;1308.64285714286;121.357142857143
77030;2023;12;12;0;100;0;147907.5;1689.25;92.0833333333333
77031;2023;16;15;1;93.75;6.25;264135.625;2412.5;114.1875
77032;2023;10;10;0;100;0;168550;1935.1;84.6
77033;2023;2;2;0;100;0;187500;2068;89.5
77034;2023;10;10;0;100;0;267720.2;3105.1;92.5
77035;2023;6;6;0;100;0;168500;1441.83333333333;120.833333333333
77036;2023;1;1;0;100;0;2,00E+05;2105;95
77037;2023;69;63;6;91.304347826087;8.69565217391304;436815.217391304;4312.42028985507;105.36231884058
77038;2023;4;4;0;100;0;723125;2907.75;256
77039;2023;13;12;1;92.3076923076923;7.69230769230769;371595.384615385;3536.92307692308;115.923076923077
77040;2023;22;22;0;100;0;317042.5;3231.36363636364;103.681818181818
77041;2023;2;2;0;100;0;236500;3017;79.5
77042;2023;44;44;0;100;0;253141.909090909;2463.43181818182;103.022727272727
77043;2023;2;2;0;100;0;133000;880;152.5
77044;2023;8;8;0;100;0;240571.25;2761.875;86.375
77045;2023;11;11;0;100;0;196409.090909091;1768.45454545455;114.272727272727
77046;2023;5;5;0;100;0;172000;2020.6;86.6
77047;2023;15;14;1;93.3333333333333;6.66666666666667;344135.533333333;3450.2;102.266666666667
77048;2023;33;31;2;93.9393939393939;6.06060606060606;402133.03030303;3307.06060606061;120.363636363636
77049;2023;6;6;0;100;0;277241.666666667;2923.66666666667;94.3333333333333
77050;2023;6;6;0;100;0;216833.333333333;2245.5;107
77051;2023;16;14;2;87.5;12.5;168241.9375;1802.8125;92.625
77052;2023;6;6;0;100;0;247163.333333333;2922.33333333333;108.166666666667
77053;2023;232;87;145;37.5;62.5;254311.051724138;3747.39224137931;70.7327586206897
77054;2023;7;7;0;100;0;246857.142857143;2161.85714285714;120
77055;2023;54;15;39;27.7777777777778;72.2222222222222;276260.37037037;4463.57407407407;63.1111111111111
77056;2023;1;1;0;100;0;192000;2133;90
77057;2023;7;7;0;100;0;193285.714285714;1945.71428571429;103
77058;2023;309;72;237;23.3009708737864;76.6990291262136;304472.339805825;4513.12621359223;69.4142394822006
77059;2023;7;7;0;100;0;401371.428571429;3895.85714285714;104
77060;2023;6;6;0;100;0;249750;2247.5;117.833333333333
77061;2023;32;23;9;71.875;28.125;187226.5625;2426.6875;86.1875
77062;2023;6;5;1;83.3333333333333;16.6666666666667;275000;3092.33333333333;106.166666666667
77063;2023;18;18;0;100;0;239045.555555556;2361.72222222222;108.388888888889
77065;2023;11;11;0;100;0;522093.181818182;3260.18181818182;159
77066;2023;3;3;0;100;0;167400;1460.66666666667;148
77067;2023;107;85;22;79.4392523364486;20.5607476635514;308867.327102804;3237.34579439252;98.0280373831776
77068;2023;5;5;0;100;0;263800;1951.6;145
77069;2023;29;26;3;89.6551724137931;10.3448275862069;339395.551724138;2993.31034482759;112.413793103448
77070;2023;20;19;1;95;5;246143;2498.9;108
77071;2023;12;12;0;100;0;198662.5;1958.41666666667;111.5
77072;2023;12;12;0;100;0;169850;1700.08333333333;100.5
77073;2023;5;5;0;100;0;204000;1814.8;123
77075;2023;14;9;5;64.2857142857143;35.7142857142857;284517.857142857;3527.5;90.4285714285714
77076;2023;13;13;0;100;0;184771.538461538;1972.92307692308;96.2307692307692
77077;2023;11;9;2;81.8181818181818;18.1818181818182;206063.636363636;2556;81.9090909090909
77078;2023;19;19;0;100;0;227177.894736842;2306.68421052632;101.421052631579
77079;2023;77;56;21;72.7272727272727;27.2727272727273;187304.233766234;2644.18181818182;72.2337662337662
77080;2023;3;3;0;100;0;203166.666666667;2142.33333333333;99.3333333333333
77081;2023;12;11;1;91.6666666666667;8.33333333333333;276958.333333333;3235.08333333333;84.0833333333333
77082;2023;11;8;3;72.7272727272727;27.2727272727273;245411.818181818;3596.45454545455;95
77083;2023;188;67;121;35.6382978723404;64.3617021276596;291984.324468085;3734.46276595745;80.75
77084;2023;14;12;2;85.7142857142857;14.2857142857143;233155.714285714;3057.64285714286;81.1428571428571
77085;2023;78;28;50;35.8974358974359;64.1025641025641;306074.448717949;4162.0641025641;74.0512820512821
77086;2023;9;8;1;88.8888888888889;11.1111111111111;209546.666666667;2301.66666666667;95.1111111111111
77087;2023;3;3;0;100;0;193666.666666667;2918;68.6666666666667
77088;2023;23;18;5;78.2608695652174;21.7391304347826;282831.826086957;2537.13043478261;111.130434782609
77089;2023;8;8;0;100;0;223765;2000.375;114.375
77091;2023;1;1;0;100;0;229131;2696;85
77093;2023;2;2;0;100;0;280500;1280;220
77094;2023;5;3;2;60;40;257200;2879.6;119
77095;2023;18;12;6;66.6666666666667;33.3333333333333;282109.888888889;3463.11111111111;86.1666666666667
77096;2023;33;26;7;78.7878787878788;21.2121212121212;329339.393939394;4207.78787878788;83.969696969697
77097;2023;2;2;0;100;0;211500;2113.5;103
77098;2023;2;2;0;100;0;161500;1728.5;98
77099;2023;36;33;3;91.6666666666667;8.33333333333333;156752.055555556;1753.47222222222;93.1666666666667
77100;2023;36;36;0;100;0;259630.416666667;3230.63888888889;87.0555555555556
77101;2023;12;12;0;100;0;190833.333333333;2073.33333333333;93.75
77103;2023;2;2;0;100;0;252500;2683;109
77104;2023;7;7;0;100;0;348514.285714286;3386.14285714286;108.857142857143
77106;2023;14;12;2;85.7142857142857;14.2857142857143;220842.142857143;2055.78571428571;109.928571428571
77107;2023;39;27;12;69.2307692307692;30.7692307692308;275248.769230769;3149.74358974359;88.2051282051282
77108;2023;553;249;304;45.0271247739602;54.9728752260398;266084.94755877;3748.9349005425;73.625678119349
77109;2023;18;17;1;94.4444444444444;5.55555555555556;213552.777777778;2299.27777777778;99.0555555555556
77110;2023;2;2;0;100;0;294930;1930;149
77111;2023;82;20;62;24.390243902439;75.609756097561;345626.902439024;4782.31707317073;75.390243902439
77112;2023;4;4;0;100;0;264375;2644.5;104.5
77113;2023;12;12;0;100;0;253270;2044.66666666667;127.333333333333
77114;2023;43;34;9;79.0697674418605;20.9302325581395;327477.302325581;3442.04651162791;97.3488372093023
77115;2023;8;8;0;100;0;107375;1721.75;67.25
77116;2023;15;15;0;100;0;203298;2245.66666666667;96.3333333333333
77117;2023;13;11;2;84.6153846153846;15.3846153846154;170346.153846154;2147.92307692308;85.2307692307692
77118;2023;143;68;75;47.5524475524476;52.4475524475524;282667.902097902;3821.27272727273;77.4685314685315
77119;2023;2;2;0;100;0;309000;3025;102
77120;2023;6;6;0;100;0;300902.833333333;2976.83333333333;102.333333333333
77121;2023;27;18;9;66.6666666666667;33.3333333333333;388929.62962963;4896.85185185185;81.1481481481482
77122;2023;220;121;99;55;45;247952.954545455;3193.30909090909;78.9090909090909
77123;2023;2;2;0;100;0;256000;2838;85.5
77124;2023;15;15;0;100;0;384793.333333333;3919.66666666667;111.6
77125;2023;21;19;2;90.4761904761905;9.52380952380952;291234.761904762;3770.85714285714;83.2857142857143
77126;2023;26;22;4;84.6153846153846;15.3846153846154;230750.346153846;2816.88461538462;87
77127;2023;20;12;8;60;40;263934.15;3343;93.15
77128;2023;26;23;3;88.4615384615385;11.5384615384615;320065.384615385;3408.57692307692;101.653846153846
77129;2023;2;2;0;100;0;189750;2329.5;88
77130;2023;5;5;0;100;0;318810;2850.6;113.4
77131;2023;166;79;87;47.5903614457831;52.4096385542169;198950.518072289;2786.03012048193;74.7228915662651
77132;2023;36;19;17;52.7777777777778;47.2222222222222;348647.5;3981.33333333333;91.6388888888889
77133;2023;1;1;0;100;0;196000;2253;87
77134;2023;1;1;0;100;0;217000;1938;112
77135;2023;15;15;0;100;0;224468.8;2684.86666666667;93.4
77136;2023;1;1;0;100;0;553000;3072;180
77137;2023;3;3;0;100;0;209000;2107.33333333333;98.6666666666667
77138;2023;4;4;0;100;0;347000;3039.75;117
77139;2023;57;43;14;75.4385964912281;24.5614035087719;311256.49122807;3869.38596491228;84.9473684210526
77140;2023;4;4;0;100;0;225587.5;2270.5;99
77141;2023;5;2;3;40;60;265600;3787;72.8
77142;2023;56;39;17;69.6428571428571;30.3571428571429;282970.714285714;3376.78571428571;91.8392857142857
77143;2023;40;31;9;77.5;22.5;263891.375;3403.4;81
77144;2023;4;4;0;100;0;371250;3551.5;106.25
77145;2023;10;10;0;100;0;245000;3334.3;91.3
77146;2023;15;13;2;86.6666666666667;13.3333333333333;362732.333333333;3661.53333333333;106.333333333333
77147;2023;12;11;1;91.6666666666667;8.33333333333333;193866.666666667;2412.58333333333;81.9166666666667
77148;2023;21;17;4;80.9523809523809;19.047619047619;208250;2333.85714285714;88.0952380952381
77150;2023;6;6;0;100;0;233416.666666667;2274;107
77151;2023;2;2;0;100;0;160500;1616.5;92.5
77152;2023;199;83;116;41.7085427135678;58.2914572864322;193966.854271357;2991.31658291457;67.2110552763819
77153;2023;127;79;48;62.2047244094488;37.7952755905512;278927.362204724;3674.92125984252;79.5748031496063
77154;2023;13;13;0;100;0;248665.923076923;2695.61538461538;95.3846153846154
77155;2023;29;26;3;89.6551724137931;10.3448275862069;353915.448275862;3680.89655172414;98.7586206896552
77156;2023;10;10;0;100;0;272889;2092.4;132.9
77157;2023;4;4;0;100;0;124375;1837;69.25
77158;2023;2;2;0;100;0;293975;2626.5;109
77159;2023;23;20;3;86.9565217391304;13.0434782608696;165521.739130435;2051.47826086957;83.4782608695652
77161;2023;13;13;0;100;0;295089.384615385;2560.15384615385;130.538461538462
77162;2023;9;9;0;100;0;193300;2150.22222222222;89.7777777777778
77163;2023;2;0;2;0;100;106000;3369;29.5
77164;2023;4;4;0;100;0;230677.5;2845.25;81.5
77165;2023;1;1;0;100;0;273500;2486;110
77167;2023;3;3;0;100;0;453293.333333333;2672.66666666667;165
77168;2023;26;23;3;88.4615384615385;11.5384615384615;238605.192307692;2218.65384615385;112.269230769231
77169;2023;51;19;32;37.2549019607843;62.7450980392157;279934.705882353;3672.80392156863;80.3921568627451
77171;2023;92;60;32;65.2173913043478;34.7826086956522;263306.989130435;3749.82608695652;74.2608695652174
77172;2023;9;9;0;100;0;181433.333333333;2515.77777777778;74.4444444444444
77173;2023;8;7;1;87.5;12.5;206648.75;2548;85.625
77174;2023;3;3;0;100;0;208666.666666667;1448.66666666667;145.666666666667
77175;2023;35;31;4;88.5714285714286;11.4285714285714;299997.828571429;3410.88571428571;93.6285714285714
77176;2023;42;39;3;92.8571428571429;7.14285714285714;247530.833333333;2631.54761904762;100.309523809524
77177;2023;21;18;3;85.7142857142857;14.2857142857143;313771.904761905;3444;94.3809523809524
77178;2023;6;4;2;66.6666666666667;33.3333333333333;165833.333333333;1625.5;97
77179;2023;4;4;0;100;0;220625;2095.5;101.25
77180;2023;5;5;0;100;0;462800;3613.4;120
77181;2023;47;13;34;27.6595744680851;72.3404255319149;288722.531914894;4543.1914893617;65.7021276595745
77182;2023;71;37;34;52.112676056338;47.887323943662;133928.873239437;1887.32394366197;70.3239436619718
77183;2023;128;74;54;57.8125;42.1875;183070.0859375;2415.15625;77.4609375
77184;2023;5;4;1;80;20;209830;2802.2;104.8
77185;2023;8;8;0;100;0;483835;4603.375;99.625
77186;2023;255;48;207;18.8235294117647;81.1764705882353;330770.968627451;4918.28235294118;66.7647058823529
77187;2023;5;5;0;100;0;177170;1767.4;101
77188;2023;8;7;1;87.5;12.5;252859.375;2600.75;102
77190;2023;3;3;0;100;0;257480;1871.66666666667;134.666666666667
77191;2023;10;10;0;100;0;232950;2657.7;86.3
77192;2023;49;36;13;73.469387755102;26.530612244898;267104.632653061;3240.79591836735;87.1632653061225
77193;2023;2;1;1;50;50;214000;3182;72
77194;2023;1;1;0;100;0;90000;938;96
77195;2023;6;6;0;100;0;283461.833333333;2265;131
77196;2023;14;13;1;92.8571428571429;7.14285714285714;324646.428571429;3534.92857142857;92.9285714285714
77197;2023;1;1;0;100;0;210000;3281;64
77198;2023;4;4;0;100;0;235250;1961.75;128.5
77199;2023;11;11;0;100;0;292054.545454545;3139.72727272727;102.181818181818
77200;2023;2;2;0;100;0;174884.5;1612.5;107.5
77201;2023;8;6;2;75;25;263643;2849.875;102.5
77202;2023;5;5;0;100;0;254110;2350.4;113.6
77203;2023;18;18;0;100;0;436954.111111111;3257;136.055555555556
77204;2023;6;6;0;100;0;215108.333333333;2399.5;90.6666666666667
77205;2023;1;1;0;100;0;475500;6514;73
77206;2023;1;1;0;100;0;443800;3148;141
77207;2023;1;1;0;100;0;80000;533;150
77208;2023;15;13;2;86.6666666666667;13.3333333333333;162857.533333333;2298.13333333333;83.1333333333333
77209;2023;15;14;1;93.3333333333333;6.66666666666667;418781.066666667;3928.06666666667;109.733333333333
77210;2023;25;22;3;88;12;203719.28;2353.08;90.84
77211;2023;13;13;0;100;0;215476.923076923;2482;93.7692307692308
77212;2023;1;1;0;100;0;3,00E+05;1538;195
77214;2023;5;4;1;80;20;437195.6;3722.4;122.4
77215;2023;87;51;36;58.6206896551724;41.3793103448276;262507.574712644;3512.3908045977;80.2988505747126
77216;2023;17;17;0;100;0;316618.588235294;3070.41176470588;105.529411764706
77217;2023;39;29;10;74.3589743589744;25.6410256410256;328315.512820513;3608.87179487179;100.333333333333
77218;2023;2;2;0;100;0;148600;1965;79
77219;2023;45;45;0;100;0;282094.755555556;3045.11111111111;99.2888888888889
77220;2023;1;1;0;100;0;365300;2706;135
77221;2023;14;12;2;85.7142857142857;14.2857142857143;493192.142857143;4111.78571428571;120.785714285714
77222;2023;48;27;21;56.25;43.75;212900.229166667;2953.375;75.8333333333333
77223;2023;3;3;0;100;0;211271.333333333;1954;111
77225;2023;6;6;0;100;0;222900;2578.83333333333;96.6666666666667
77226;2023;35;32;3;91.4285714285714;8.57142857142857;329248.057142857;3403.57142857143;98.9714285714286
77227;2023;1;1;0;100;0;173531;2479;70
77228;2023;6;6;0;100;0;169416.666666667;1760.66666666667;93.6666666666667
77229;2023;14;14;0;100;0;332585.714285714;3307.85714285714;106
77230;2023;4;4;0;100;0;225000;1585.75;144.25
77231;2023;9;9;0;100;0;242777.777777778;2871.22222222222;91.4444444444444
77232;2023;15;13;2;86.6666666666667;13.3333333333333;300553.333333333;3329.33333333333;95.3333333333333
77233;2023;9;8;1;88.8888888888889;11.1111111111111;220094.555555556;2336.22222222222;100.333333333333
77234;2023;8;6;2;75;25;349247.5;3433.25;103.75
77235;2023;2;2;0;100;0;262000;3261;80.5
77236;2023;7;7;0;100;0;164714.285714286;2238.85714285714;81
77237;2023;7;7;0;100;0;389075.285714286;3441.42857142857;107.571428571429
77238;2023;38;32;6;84.2105263157895;15.7894736842105;217031.578947368;2372.71052631579;91.3684210526316
77239;2023;17;17;0;100;0;238705.882352941;2863.88235294118;89.0588235294118
77240;2023;14;13;1;92.8571428571429;7.14285714285714;157892.142857143;2069.57142857143;85.6428571428571
77241;2023;12;10;2;83.3333333333333;16.6666666666667;331735.333333333;3728.5;89.0833333333333
77242;2023;6;6;0;100;0;202750;1827;121.333333333333
77243;2023;265;99;166;37.3584905660377;62.6415094339623;293003.366037736;4228.30566037736;70.0679245283019
77244;2023;17;17;0;100;0;211862.352941176;2441.58823529412;94
77245;2023;3;3;0;100;0;274283.333333333;2389.66666666667;121
77246;2023;3;3;0;100;0;136780;1440.66666666667;104
77247;2023;9;9;0;100;0;203888.888888889;1921.33333333333;113.444444444444
77248;2023;6;6;0;100;0;266818.333333333;2828.5;105.666666666667
77249;2023;61;59;2;96.7213114754098;3.27868852459016;400204.950819672;3801.03278688525;106.950819672131
77250;2023;2;2;0;100;0;277500;2201.5;132.5
77251;2023;153;48;105;31.3725490196078;68.6274509803922;226009.960784314;3399.16993464052;68.0522875816993
77252;2023;5;5;0;100;0;512231;2906.8;183.2
77253;2023;3;3;0;100;0;252333.333333333;3619;78.6666666666667
77254;2023;15;13;2;86.6666666666667;13.3333333333333;343166.666666667;3413;101.866666666667
77255;2023;25;24;1;96;4;305564.32;3161.56;99.8
77256;2023;4;4;0;100;0;201385;2003.75;102.25
77257;2023;27;20;7;74.0740740740741;25.9259259259259;189086;2365.14814814815;77.9259259259259
77258;2023;98;12;86;12.2448979591837;87.7551020408163;234168.510204082;3589.40816326531;67.7244897959184
77259;2023;13;8;5;61.5384615384615;38.4615384615385;257421;3018.46153846154;89.6153846153846
77260;2023;15;14;1;93.3333333333333;6.66666666666667;192653.333333333;1866.13333333333;105.333333333333
77261;2023;10;10;0;100;0;215853;1891.9;119.5
77262;2023;7;7;0;100;0;142596;1531;93.8571428571429
77263;2023;2;2;0;100;0;116000;940;127
77264;2023;19;19;0;100;0;340305.526315789;2898.73684210526;124.684210526316
77265;2023;14;14;0;100;0;209857.142857143;2145.21428571429;98.5714285714286
77266;2023;5;4;1;80;20;288120;2694.2;112.4
77267;2023;3;3;0;100;0;174333.333333333;1791.33333333333;107
77268;2023;100;48;52;48;52;419165.1;4733.52;93.82
77269;2023;26;22;4;84.6153846153846;15.3846153846154;286250;3091.42307692308;99.9230769230769
77270;2023;5;4;1;80;20;235528.2;2717.6;83
77272;2023;9;9;0;100;0;178777.777777778;1934.55555555556;99.4444444444444
77273;2023;5;5;0;100;0;264600;3006.8;86.6
77274;2023;12;8;4;66.6666666666667;33.3333333333333;236001.75;2950.08333333333;89.1666666666667
77275;2023;1;1;0;100;0;120000;1026;117
77276;2023;29;28;1;96.551724137931;3.44827586206897;315373.827586207;2930.65517241379;114.103448275862
77277;2023;13;12;1;92.3076923076923;7.69230769230769;353307.692307692;2945.07692307692;132.153846153846
77278;2023;5;5;0;100;0;358558;3790.6;96.8
77279;2023;18;17;1;94.4444444444444;5.55555555555556;238251.111111111;2200.33333333333;123.5
77280;2023;12;10;2;83.3333333333333;16.6666666666667;197557.916666667;2472.75;83.1666666666667
77281;2023;7;7;0;100;0;237928.571428571;2689;88.7142857142857
77282;2023;2;2;0;100;0;264000;4007.5;72.5
77283;2023;8;8;0;100;0;250162.5;2182.25;130.625
77284;2023;533;127;406;23.827392120075;76.172607879925;202611.377110694;3115.31894934334;67.5234521575985
77285;2023;171;64;107;37.4269005847953;62.5730994152047;169837.152046784;2269.69590643275;77.1578947368421
77286;2023;4;4;0;100;0;169967;2164;81
77287;2023;7;6;1;85.7142857142857;14.2857142857143;155857.142857143;1787.57142857143;94.2857142857143
77288;2023;468;69;399;14.7435897435897;85.2564102564102;155259.260683761;2833.19871794872;58.724358974359
77289;2023;3;3;0;100;0;125333.333333333;1279.33333333333;96.6666666666667
77290;2023;6;6;0;100;0;85566.6666666667;2344.66666666667;43.6666666666667
77291;2023;3;3;0;100;0;251166.666666667;3581.66666666667;111.333333333333
77292;2023;12;8;4;66.6666666666667;33.3333333333333;269904.166666667;3690.91666666667;80.75
77293;2023;16;16;0;100;0;201861.3125;2450.4375;89.75
77294;2023;148;106;42;71.6216216216216;28.3783783783784;273959.689189189;3684.83108108108;79.0472972972973
77295;2023;17;17;0;100;0;312084.117647059;3220.94117647059;101.117647058824
77296;2023;164;71;93;43.2926829268293;56.7073170731707;222920.56097561;3141.29268292683;72.9085365853659
77297;2023;3;3;0;100;0;150333.333333333;1368.33333333333;117.333333333333
77298;2023;3;3;0;100;0;185166.666666667;1518.33333333333;122
77300;2023;5;5;0;100;0;324200;2771.2;115.4
77301;2023;4;4;0;100;0;123625;1480.5;83.25
77302;2023;27;25;2;92.5925925925926;7.40740740740741;266589.185185185;2505.11111111111;108.407407407407
77305;2023;132;53;79;40.1515151515151;59.8484848484849;142616.439393939;2109.18181818182;70.2651515151515
77306;2023;4;4;0;100;0;344550;2318.75;170.5
77307;2023;199;37;162;18.5929648241206;81.4070351758794;279262.065326633;4734.18090452261;60.9045226130653
77308;2023;9;8;1;88.8888888888889;11.1111111111111;228100;2807.11111111111;87
77309;2023;23;21;2;91.304347826087;8.69565217391304;227974;2870.47826086957;81.7391304347826
77310;2023;3;3;0;100;0;160000;1609.66666666667;106
77311;2023;15;15;0;100;0;234600;2339.8;99
77312;2023;36;34;2;94.4444444444444;5.55555555555556;350798.027777778;3232.41666666667;112
77313;2023;3;3;0;100;0;199333.333333333;1867.66666666667;109.666666666667
77314;2023;3;3;0;100;0;116666.666666667;1268.66666666667;99.6666666666667
77315;2023;43;36;7;83.7209302325581;16.2790697674419;318098.604651163;4044.13953488372;88.8139534883721
77316;2023;160;124;36;77.5;22.5;264334.375;2954.0125;92.15625
77317;2023;57;34;23;59.6491228070175;40.3508771929825;227507.50877193;2583.29824561404;79.3508771929825
77318;2023;16;13;3;81.25;18.75;267955.875;2932.875;98.1875
77320;2023;79;73;6;92.4050632911392;7.59493670886076;246747.594936709;2569.25316455696;97.6455696202532
77321;2023;6;3;3;50;50;102125;1793.5;57.5
77322;2023;35;30;5;85.7142857142857;14.2857142857143;307674.571428571;3529.25714285714;89.5428571428571
77323;2023;15;9;6;60;40;206913.333333333;2945.33333333333;76.3333333333333
77325;2023;3;3;0;100;0;142653.333333333;1589;82
77326;2023;43;33;10;76.7441860465116;23.2558139534884;278970.930232558;3014.93023255814;93.9767441860465
77327;2023;73;57;16;78.0821917808219;21.9178082191781;198376.657534247;2436.95890410959;84.6712328767123
77328;2023;10;10;0;100;0;279050;2935.7;99.2
77329;2023;5;5;0;100;0;333504;2405.2;151.8
77330;2023;72;55;17;76.3888888888889;23.6111111111111;275702.055555556;3168.61111111111;93.5694444444444
77331;2023;7;6;1;85.7142857142857;14.2857142857143;148000;1845.85714285714;79.4285714285714
77332;2023;5;3;2;60;40;283800;2870.6;105.6
77333;2023;119;65;54;54.6218487394958;45.3781512605042;177937.899159664;2528.26890756303;76.1512605042017
77335;2023;29;26;3;89.6551724137931;10.3448275862069;285618;3023.31034482759;98.4137931034483
77336;2023;20;18;2;90;10;359274.5;3319.3;113.4
77337;2023;93;26;67;27.9569892473118;72.0430107526882;253686.139784946;3513.56989247312;75.2150537634409
77338;2023;5;5;0;100;0;198600;2169.2;97.2
77339;2023;35;32;3;91.4285714285714;8.57142857142857;454130.571428571;3412.62857142857;132.142857142857
77340;2023;6;6;0;100;0;501050;4298.66666666667;135.666666666667
77341;2023;5;5;0;100;0;136200;1278;101
77342;2023;1;1;0;100;0;110000;1571;70
77343;2023;5;5;0;100;0;148600;1819.6;87.2
77344;2023;13;8;5;61.5384615384615;38.4615384615385;261991.153846154;3020.15384615385;85.5384615384615
77345;2023;14;14;0;100;0;233867.857142857;1947;131.5
77347;2023;6;6;0;100;0;137241.666666667;1495.66666666667;114.333333333333
77349;2023;48;43;5;89.5833333333333;10.4166666666667;305310.416666667;3282.25;96.5416666666667
77350;2023;203;136;67;66.9950738916256;33.0049261083744;342373.093596059;3977.11822660099;91.2512315270936
77352;2023;25;24;1;96;4;303318.92;2887.72;111.92
77353;2023;7;7;0;100;0;232623.571428571;2367.57142857143;103.142857142857
77354;2023;10;10;0;100;0;306590;2720.7;114.1
77355;2023;2;2;0;100;0;176500;1737.5;101
77357;2023;10;10;0;100;0;287715.8;2334.4;131.5
77358;2023;18;16;2;88.8888888888889;11.1111111111111;350067.222222222;3262.05555555556;108.666666666667
77359;2023;23;21;2;91.304347826087;8.69565217391304;343915.217391304;3427.21739130435;99.2608695652174
77360;2023;3;3;0;100;0;239333.333333333;2106.33333333333;113
77361;2023;3;3;0;100;0;196833.333333333;1866.33333333333;109
77363;2023;22;16;6;72.7272727272727;27.2727272727273;342023.318181818;4278.27272727273;88.0454545454545
77364;2023;2;2;0;100;0;315000;2234;162
77365;2023;8;8;0;100;0;319637.5;3316.125;99.375
77366;2023;4;3;1;75;25;105125;1529;79.25
77368;2023;6;5;1;83.3333333333333;16.6666666666667;260383.333333333;3354;106.166666666667
77369;2023;3;3;0;100;0;322716.666666667;2960;133
77370;2023;10;10;0;100;0;237023.8;2381.8;103.8
77371;2023;51;48;3;94.1176470588235;5.88235294117647;237416.078431373;2737.56862745098;89.7450980392157
77372;2023;39;19;20;48.7179487179487;51.2820512820513;346942.205128205;4246.38461538462;85.0512820512821
77373;2023;360;178;182;49.4444444444444;50.5555555555556;287258.922222222;4115.42777777778;73.2583333333333
77374;2023;43;30;13;69.7674418604651;30.2325581395349;298295.348837209;3626.72093023256;85.2790697674419
77376;2023;3;3;0;100;0;229800;2556.33333333333;77.6666666666667
77377;2023;17;14;3;82.3529411764706;17.6470588235294;313732.529411765;2977.70588235294;104.529411764706
77378;2023;38;19;19;50;50;279160.394736842;3199.84210526316;88.3157894736842
77379;2023;139;55;84;39.568345323741;60.431654676259;177584.913669065;2409.17985611511;76.6546762589928
77380;2023;1;1;0;100;0;255000;2550;100
77381;2023;6;6;0;100;0;208716.666666667;1929.83333333333;105.666666666667
77382;2023;73;59;14;80.8219178082192;19.1780821917808;303883.876712329;3588.94520547945;88.0684931506849
77383;2023;13;13;0;100;0;241346.153846154;2141.61538461538;117
77384;2023;16;14;2;87.5;12.5;292973.3125;4055.25;78.0625
77385;2023;27;27;0;100;0;232920.481481481;2667.59259259259;107.185185185185
77386;2023;19;19;0;100;0;318113;2755.89473684211;113.578947368421
77387;2023;6;6;0;100;0;199833.333333333;2124.33333333333;114.333333333333
77388;2023;15;15;0;100;0;244733.333333333;2656.06666666667;90.4
77389;2023;41;17;24;41.4634146341463;58.5365853658537;275206.097560976;3408.09756097561;87.7560975609756
77390;2023;206;115;91;55.8252427184466;44.1747572815534;292290.90776699;3784.69902912621;79.6504854368932
77391;2023;8;8;0;100;0;167500;1949.875;86.375
77392;2023;11;11;0;100;0;338149.545454545;3661.09090909091;93.3636363636364
77393;2023;28;25;3;89.2857142857143;10.7142857142857;306835.357142857;3172.28571428571;105.464285714286
77394;2023;22;22;0;100;0;327915.681818182;2984.31818181818;113.590909090909
77395;2023;2;2;0;100;0;417500;2657;150
77397;2023;23;22;1;95.6521739130435;4.34782608695652;189491.739130435;2253.21739130435;87.9565217391304
77398;2023;10;10;0;100;0;219850.5;1957.3;116.5
77400;2023;21;21;0;100;0;309204.428571429;3350.95238095238;108
77401;2023;7;7;0;100;0;231857.142857143;2695.14285714286;85.8571428571429
77402;2023;4;4;0;100;0;135000;1366.75;107.75
77403;2023;6;6;0;100;0;305156.5;2130.33333333333;145.833333333333
77404;2023;19;18;1;94.7368421052632;5.26315789473684;175750;1973.47368421053;87.5263157894737
77405;2023;20;20;0;100;0;237462.5;2182.7;108.7
77406;2023;8;8;0;100;0;268975;2633.375;106.25
77407;2023;179;91;88;50.8379888268156;49.1620111731844;255700.636871508;3149.21229050279;83.0279329608938
77408;2023;6;6;0;100;0;226271.5;2271.66666666667;98.3333333333333
77409;2023;20;19;1;95;5;225063.35;2420.05;94.75
77410;2023;5;5;0;100;0;294750;2892;97.8
77411;2023;6;6;0;100;0;182500;1745.83333333333;100.666666666667
77412;2023;5;5;0;100;0;384160;3741.2;106.2
77413;2023;59;50;9;84.7457627118644;15.2542372881356;333104.322033898;3516.23728813559;98.0847457627119
77414;2023;4;4;0;100;0;167312.5;1727;99
77415;2023;16;16;0;100;0;249315.625;2702.8125;100.5
77416;2023;2;2;0;100;0;169500;2997;77
77418;2023;12;11;1;91.6666666666667;8.33333333333333;175683.333333333;1748.5;102.583333333333
77419;2023;34;30;4;88.2352941176471;11.7647058823529;197855.411764706;2441.26470588235;86.3823529411765
77420;2023;46;39;7;84.7826086956522;15.2173913043478;284244.782608696;3392.21739130435;88.6086956521739
77421;2023;6;6;0;100;0;175166.666666667;1857.66666666667;98.5
77423;2023;8;8;0;100;0;166210;1847.625;88.375
77424;2023;2;2;0;100;0;201500;1692.5;117.5
77425;2023;5;5;0;100;0;458000;4016.8;126.4
77426;2023;2;2;0;100;0;278185;2368;116.5
77427;2023;6;5;1;83.3333333333333;16.6666666666667;310250;2720.33333333333;113.166666666667
77428;2023;10;10;0;100;0;271593.2;2770.5;113.3
77429;2023;3;3;0;100;0;144000;1525.33333333333;97.6666666666667
77430;2023;69;63;6;91.304347826087;8.69565217391304;297982.608695652;3165.30434782609;97.7826086956522
77431;2023;60;54;6;90;10;229152.6;2461.81666666667;94.9333333333333
77432;2023;12;12;0;100;0;247375;2293.08333333333;113
77433;2023;29;29;0;100;0;260802.413793103;2626.27586206897;105.034482758621
77434;2023;9;9;0;100;0;155013.333333333;2916.66666666667;59.2222222222222
77435;2023;16;16;0;100;0;458831.875;4127.625;116.875
77436;2023;11;10;1;90.9090909090909;9.09090909090909;205181.818181818;2057.09090909091;99
77437;2023;31;28;3;90.3225806451613;9.67741935483871;276833.741935484;2938.83870967742;96.9354838709677
77438;2023;52;28;24;53.8461538461538;46.1538461538462;312137.461538462;3870.34615384615;81.3461538461538
77439;2023;10;10;0;100;0;191850;2295.1;88.6
77440;2023;8;7;1;87.5;12.5;197162.5;2320.625;95
77441;2023;26;25;1;96.1538461538462;3.84615384615385;384862.692307692;4068.96153846154;110.423076923077
77442;2023;17;15;2;88.2352941176471;11.7647058823529;283726.470588235;3076.76470588235;101.117647058824
77443;2023;10;10;0;100;0;298230;3169.6;98.8
77444;2023;4;4;0;100;0;221125;1795.25;132.5
77445;2023;232;125;107;53.8793103448276;46.1206896551724;228929.392241379;2838.30172413793;82.1034482758621
77446;2023;8;8;0;100;0;182685;1385.375;141.875
77447;2023;14;12;2;85.7142857142857;14.2857142857143;427714.285714286;4142.78571428571;109.071428571429
77448;2023;5;3;2;60;40;207000;2396.6;100.8
77449;2023;99;28;71;28.2828282828283;71.7171717171717;323670.575757576;4757.42424242424;70.6464646464647
77450;2023;39;28;11;71.7948717948718;28.2051282051282;370953.307692308;4035.82051282051;95.5128205128205
77451;2023;8;8;0;100;0;224137.5;2504;98.5
77453;2023;23;23;0;100;0;326788.130434783;2807.04347826087;118.347826086957
77454;2023;6;6;0;100;0;196666.666666667;1663.16666666667;119.5
77455;2023;23;22;1;95.6521739130435;4.34782608695652;327303.913043478;3787.08695652174;90.4782608695652
77456;2023;9;9;0;100;0;219676.111111111;2141.22222222222;105.555555555556
77457;2023;21;19;2;90.4761904761905;9.52380952380952;281639.952380952;3241.52380952381;90.4285714285714
77458;2023;47;43;4;91.4893617021277;8.51063829787234;174752.042553191;1953.68085106383;93.2553191489362
77459;2023;16;16;0;100;0;183094.6875;1725.8125;111.4375
77460;2023;4;4;0;100;0;274750;2267.25;122
77461;2023;4;4;0;100;0;153750;1708;110
77462;2023;6;3;3;50;50;202923.333333333;3207;67.8333333333333
77463;2023;40;34;6;85;15;310725.825;3294.85;98.675
77464;2023;107;57;50;53.2710280373832;46.7289719626168;289589.411214953;3779.36448598131;79.4672897196262
77465;2023;7;7;0;100;0;167571.428571429;2089.14285714286;79
77466;2023;6;6;0;100;0;243733.333333333;2895.66666666667;112.333333333333
77467;2023;2;2;0;100;0;169500;2001.5;83
77468;2023;204;52;152;25.4901960784314;74.5098039215686;241901.333333333;3652.3431372549;69.3725490196078
77469;2023;13;12;1;92.3076923076923;7.69230769230769;260576.923076923;2701.46153846154;100.615384615385
77470;2023;75;43;32;57.3333333333333;42.6666666666667;263887.066666667;3730.85333333333;76.6266666666667
77471;2023;3;3;0;100;0;285600;2378;124
77472;2023;6;6;0;100;0;217333.333333333;1838.66666666667;119.666666666667
77473;2023;4;4;0;100;0;211750;1926.25;113.75
77474;2023;11;10;1;90.9090909090909;9.09090909090909;223542.727272727;2653.90909090909;88.8181818181818
77475;2023;56;48;8;85.7142857142857;14.2857142857143;261324.303571429;3134.96428571429;84.5535714285714
77476;2023;5;5;0;100;0;204780.4;2221.4;94
77477;2023;14;14;0;100;0;332686.071428571;2671.07142857143;118.285714285714
77478;2023;12;12;0;100;0;242387.5;2331.91666666667;105.833333333333
77479;2023;99;44;55;44.4444444444444;55.5555555555556;298719.333333333;4242.79797979798;71.7878787878788
77480;2023;6;4;2;66.6666666666667;33.3333333333333;178575.833333333;1976.66666666667;92.3333333333333
77481;2023;3;3;0;100;0;235835;2603;93
77482;2023;33;29;4;87.8787878787879;12.1212121212121;177483.575757576;2361.51515151515;80.6969696969697
77483;2023;23;17;6;73.9130434782609;26.0869565217391;225486.826086957;2801.91304347826;85.3478260869565
77484;2023;4;4;0;100;0;328937.5;2859.75;117.25
77485;2023;11;11;0;100;0;495742.363636364;4005.81818181818;120.181818181818
77486;2023;10;10;0;100;0;227041.9;2491.1;92.9
77487;2023;110;65;45;59.0909090909091;40.9090909090909;245942.363636364;2774.79090909091;91.1181818181818
77490;2023;9;9;0;100;0;259455.555555556;2164.55555555556;122.111111111111
77492;2023;4;4;0;100;0;227500;1402;162.5
77493;2023;21;20;1;95.2380952380952;4.76190476190476;263061.904761905;2781.38095238095;99.5238095238095
77494;2023;28;26;2;92.8571428571429;7.14285714285714;226921.428571429;2605.21428571429;97.25
77495;2023;98;81;17;82.6530612244898;17.3469387755102;278196.969387755;3242.51020408163;89.6020408163265
77496;2023;2;2;0;100;0;260000;1369.5;170
77498;2023;4;4;0;100;0;297518.75;3574.75;89.5
77500;2023;4;4;0;100;0;254250;2094.75;114.5
77501;2023;11;11;0;100;0;217409.090909091;2330.27272727273;95.3636363636364
77504;2023;9;8;1;88.8888888888889;11.1111111111111;279388.888888889;2684.55555555556;101.888888888889
77505;2023;3;3;0;100;0;305763.333333333;3291.33333333333;92.6666666666667
77506;2023;5;5;0;100;0;192036;1543.6;142.8
77507;2023;4;4;0;100;0;169500;1765.75;100.75
77508;2023;19;18;1;94.7368421052632;5.26315789473684;360834.631578947;3438.89473684211;109.526315789474
77509;2023;8;8;0;100;0;248250;2385.5;102.125
77510;2023;13;6;7;46.1538461538462;53.8461538461538;330077.384615385;3550.38461538462;101.769230769231
77511;2023;10;8;2;80;20;234897;2613.8;92.5
77512;2023;13;13;0;100;0;120846.153846154;1661.76923076923;82.2307692307692
77513;2023;53;23;30;43.3962264150943;56.6037735849057;219961.132075472;3374.79245283019;66.4905660377358
77514;2023;278;131;147;47.1223021582734;52.8776978417266;235450.129496403;3522.09712230216;69.3956834532374
77515;2023;8;8;0;100;0;300687.5;3354.75;101.5
77516;2023;10;9;1;90;10;185782;1774.9;112.3
77517;2023;22;20;2;90.9090909090909;9.09090909090909;398141.590909091;3427.09090909091;126.954545454545
77518;2023;2;2;0;100;0;427474;3604.5;118.5
77519;2023;14;10;4;71.4285714285714;28.5714285714286;143683.071428571;1595.35714285714;87.9285714285714
77520;2023;9;9;0;100;0;456071.444444444;3781.55555555556;118.333333333333
77521;2023;22;21;1;95.4545454545455;4.54545454545455;285227.272727273;3936.77272727273;84.4090909090909
77522;2023;3;3;0;100;0;102766.666666667;1388;75.3333333333333
77524;2023;5;5;0;100;0;195530;2014;100
77525;2023;5;5;0;100;0;336580;2719.6;117.8
77526;2023;6;6;0;100;0;189750;1959.5;97.8333333333333
77527;2023;5;5;0;100;0;253490;2797.2;93.6
77528;2023;10;10;0;100;0;315750;3381.7;95.6
77529;2023;19;19;0;100;0;317410.684210526;3745.31578947368;89.4736842105263
77530;2023;2;2;0;100;0;253500;1954;123.5
77531;2023;25;24;1;96;4;165173;2043.72;86.28
77533;2023;17;16;1;94.1176470588235;5.88235294117647;344281.294117647;3380.88235294118;100.529411764706
77534;2023;7;6;1;85.7142857142857;14.2857142857143;286442.857142857;2987.85714285714;98
78003;2023;46;39;7;84.7826086956522;15.2173913043478;237568.97826087;2623.9347826087;93.3478260869565
78005;2023;156;62;94;39.7435897435897;60.2564102564103;268934.769230769;4038.35256410256;68.6987179487179
78006;2023;9;9;0;100;0;399209.666666667;3597.44444444444;118.666666666667
78007;2023;7;7;0;100;0;752185.428571429;4338.85714285714;176.714285714286
78009;2023;6;6;0;100;0;214180.5;2469.33333333333;93.8333333333333
78010;2023;6;6;0;100;0;651348.333333333;4057.66666666667;164.833333333333
78015;2023;172;81;91;47.093023255814;52.9069767441861;313403.081395349;3599.15697674419;87.7267441860465
78020;2023;11;11;0;100;0;340250;2756.63636363636;125.727272727273
78029;2023;99;42;57;42.4242424242424;57.5757575757576;215375.696969697;2846.88888888889;76.3838383838384
78030;2023;20;16;4;80;20;368987.75;4011.1;95.1
78031;2023;3;3;0;100;0;298333.333333333;3403;94.6666666666667
78033;2023;17;16;1;94.1176470588235;5.88235294117647;340376.470588235;2987.76470588235;115.882352941176
78034;2023;10;10;0;100;0;503073.1;3853.7;138.1
78036;2023;7;7;0;100;0;336430;3320.28571428571;111
78043;2023;38;14;24;36.8421052631579;63.1578947368421;465765.763157895;4880.07894736842;96.6315789473684
78048;2023;13;13;0;100;0;405406.230769231;2879.92307692308;137.384615384615
78049;2023;16;15;1;93.75;6.25;428203.125;3605.5625;120.375
78050;2023;8;8;0;100;0;970335.375;5108.75;184.75
78053;2023;1;1;0;100;0;475000;4750;100
78057;2023;26;26;0;100;0;212507.692307692;2429.46153846154;94.6153846153846
78062;2023;108;68;40;62.962962962963;37.037037037037;288788.083333333;3423.99074074074;87.037037037037
78068;2023;6;6;0;100;0;318044.5;2749.83333333333;117.666666666667
78070;2023;5;5;0;100;0;364634;3232;121.6
78071;2023;8;8;0;100;0;240593.625;2482.5;98.75
78072;2023;2;2;0;100;0;357500;2704;133
78073;2023;187;49;138;26.2032085561497;73.7967914438503;282639.101604278;3778.2192513369;73.048128342246
78077;2023;9;9;0;100;0;274272.222222222;3104.55555555556;94
78082;2023;2;2;0;100;0;253500;2354.5;108
78084;2023;7;7;0;100;0;477692.857142857;3679.57142857143;148.857142857143
78087;2023;24;19;5;79.1666666666667;20.8333333333333;302867.083333333;3257.95833333333;95.2083333333333
78089;2023;48;39;9;81.25;18.75;189564.291666667;2572.27083333333;78.7083333333333
78090;2023;25;21;4;84;16;309633;3566.36;90.36
78092;2023;88;16;72;18.1818181818182;81.8181818181818;369631.284090909;4938.11363636364;74.3181818181818
78096;2023;3;3;0;100;0;536916.666666667;3029.33333333333;180.333333333333
78104;2023;6;6;0;100;0;431666.666666667;2589.33333333333;167.333333333333
78107;2023;16;13;3;81.25;18.75;256810.5625;2739.4375;104.5625
78108;2023;10;9;1;90;10;357863.8;3137.1;112.8
78113;2023;6;6;0;100;0;366596.666666667;2530;138.333333333333
78117;2023;65;30;35;46.1538461538462;53.8461538461538;498190.323076923;5651.09230769231;88.5230769230769
78118;2023;29;23;6;79.3103448275862;20.6896551724138;271390.689655172;3342.86206896552;86.6551724137931
78120;2023;23;19;4;82.6086956521739;17.3913043478261;291191.260869565;3285.04347826087;94.6086956521739
78123;2023;179;61;118;34.0782122905028;65.9217877094972;247195.30726257;3847.75977653631;66.3240223463687
78124;2023;131;54;77;41.2213740458015;58.7786259541985;442602.72519084;5386.56488549618;82.7175572519084
78125;2023;6;6;0;100;0;444336.666666667;3535.16666666667;126.5
78126;2023;142;34;108;23.943661971831;76.056338028169;448641.154929577;4901.07042253521;86.4084507042254
78128;2023;17;16;1;94.1176470588235;5.88235294117647;370605.941176471;3527.23529411765;110.235294117647
78133;2023;71;18;53;25.3521126760563;74.6478873239437;404495.352112676;4548.42253521127;85.6478873239437
78138;2023;67;42;25;62.6865671641791;37.3134328358209;240331.119402985;2923.13432835821;82.4626865671642
78140;2023;14;14;0;100;0;374149.714285714;3804.42857142857;104.857142857143
78143;2023;15;11;4;73.3333333333333;26.6666666666667;465501.6;4941.2;93.5333333333333
78146;2023;343;93;250;27.1137026239067;72.8862973760933;477588.16909621;5786.91836734694;79.9883381924198
78147;2023;7;7;0;100;0;296263.428571429;2262.42857142857;142
78152;2023;16;15;1;93.75;6.25;641682.1875;4440.25;158
78158;2023;156;45;111;28.8461538461538;71.1538461538462;601704.012820513;6888.35256410256;84.2435897435897
78160;2023;66;41;25;62.1212121212121;37.8787878787879;420330.333333333;4760.74242424242;90.6818181818182
78162;2023;6;6;0;100;0;916555.5;4066.33333333333;222.333333333333
78163;2023;3;3;0;100;0;182000;1990.33333333333;90.6666666666667
78164;2023;12;12;0;100;0;719900;4522.66666666667;149.583333333333
78165;2023;179;74;105;41.340782122905;58.659217877095;279851.910614525;3815.65921787709;76.0558659217877
78168;2023;34;24;10;70.5882352941177;29.4117647058824;311066.411764706;3956.97058823529;83.9411764705882
78171;2023;18;16;2;88.8888888888889;11.1111111111111;348500.444444444;3197.44444444444;113.388888888889
78172;2023;440;228;212;51.8181818181818;48.1818181818182;298535.234090909;4039.29545454545;75.0363636363636
78185;2023;4;4;0;100;0;350500;2534;153.25
78188;2023;5;5;0;100;0;370024;2280.4;167.2
78189;2023;25;24;1;96;4;541821.6;4480.76;121.64
78190;2023;87;32;55;36.7816091954023;63.2183908045977;639711.689655172;6717.80459770115;93.4597701149425
78192;2023;15;15;0;100;0;328704.733333333;2781.26666666667;126.866666666667
78193;2023;7;6;1;85.7142857142857;14.2857142857143;448659;4386.28571428571;132.428571428571
78194;2023;1;1;0;100;0;102950;1287;80
78196;2023;1;1;0;100;0;1133000;4358;260
78202;2023;3;3;0;100;0;356666.666666667;3903.33333333333;88.6666666666667
78206;2023;65;47;18;72.3076923076923;27.6923076923077;260602.446153846;3301.50769230769;81.3538461538461
78208;2023;309;116;193;37.5404530744337;62.4595469255663;243102.54368932;3167.71844660194;78.6763754045307
78209;2023;9;9;0;100;0;381011.111111111;3362.33333333333;113.222222222222
78217;2023;75;61;14;81.3333333333333;18.6666666666667;281972.506666667;3274.88;90.4133333333333
78220;2023;76;54;22;71.0526315789474;28.9473684210526;332806.934210526;3521.5;99.6447368421053
78224;2023;55;35;20;63.6363636363636;36.3636363636364;679285.472727273;5685.96363636364;118.872727272727
78227;2023;6;6;0;100;0;274369.166666667;2550;100
78230;2023;4;4;0;100;0;311750;3240.5;96.25
78231;2023;1;1;0;100;0;177500;4329;41
78233;2023;31;31;0;100;0;703998.096774194;5085.35483870968;141.612903225806
78234;2023;3;3;0;100;0;338000;3362;100.333333333333
78236;2023;5;5;0;100;0;424120;4955.4;101.2
78237;2023;1;1;0;100;0;263600;2312;114
78238;2023;18;16;2;88.8888888888889;11.1111111111111;318669.444444444;3826.33333333333;92.3333333333333
78239;2023;22;20;2;90.9090909090909;9.09090909090909;254559.090909091;2664.77272727273;109.363636363636
78242;2023;93;19;74;20.4301075268817;79.5698924731183;251260.021505376;3678.48387096774;70.2150537634409
78246;2023;11;8;3;72.7272727272727;27.2727272727273;245627.272727273;2642.81818181818;93.1818181818182
78255;2023;45;40;5;88.8888888888889;11.1111111111111;209232.222222222;2539.93333333333;86.6888888888889
78261;2023;4;1;3;25;75;180250;2949;61.5
78262;2023;11;9;2;81.8181818181818;18.1818181818182;463353.636363636;3941.18181818182;118.181818181818
78263;2023;27;26;1;96.2962962962963;3.7037037037037;507605.37037037;3670.85185185185;139.851851851852
78264;2023;1;1;0;100;0;4,00E+05;2667;150
78265;2023;27;26;1;96.2962962962963;3.7037037037037;403713.148148148;3943.33333333333;114.333333333333
78267;2023;82;69;13;84.1463414634146;15.8536585365854;245358.231707317;3134.62195121951;81.1585365853659
78269;2023;12;11;1;91.6666666666667;8.33333333333333;374394.166666667;3170.5;118.916666666667
78276;2023;3;3;0;100;0;157066.666666667;3269.33333333333;48
78278;2023;1;1;0;100;0;140000;14000;10
78281;2023;6;6;0;100;0;288233.333333333;2641.16666666667;106.333333333333
78283;2023;4;4;0;100;0;317057.25;3226;101.25
78285;2023;6;6;0;100;0;367478.333333333;3165.16666666667;122
78289;2023;8;8;0;100;0;891192.375;5265.75;174.25
78290;2023;18;17;1;94.4444444444444;5.55555555555556;206494.444444444;2527.77777777778;83.1666666666667
78291;2023;30;26;4;86.6666666666667;13.3333333333333;283361.2;3082.8;95.6
78296;2023;4;3;1;75;25;322750;3780.5;84.5
78297;2023;200;45;155;22.5;77.5;303588.175;4051.555;77.23
78299;2023;25;20;5;80;20;287765.2;3084.68;95.32
78300;2023;4;3;1;75;25;326989;2671.5;136.5
78302;2023;7;7;0;100;0;666371.714285714;4070.28571428571;155.285714285714
78307;2023;10;10;0;100;0;294000;2975.8;101.3
78310;2023;51;24;27;47.0588235294118;52.9411764705882;264099.960784314;3507.03921568627;75.9803921568627
78311;2023;406;171;235;42.1182266009852;57.8817733990148;368303.219211823;5274.80295566502;70.7857142857143
78314;2023;48;41;7;85.4166666666667;14.5833333333333;255000.583333333;2856.85416666667;89.7083333333333
78317;2023;7;6;1;85.7142857142857;14.2857142857143;257407.142857143;2567.14285714286;104.142857142857
78320;2023;5;5;0;100;0;329610;2641.6;122.4
78321;2023;68;52;16;76.4705882352941;23.5294117647059;400195.441176471;4037.35294117647;101.779411764706
78322;2023;55;25;30;45.4545454545455;54.5454545454545;440052.981818182;4978.54545454545;91.6363636363636
78324;2023;6;6;0;100;0;328905;2888.5;122.666666666667
78325;2023;8;8;0;100;0;258814.125;2448;109.125
78327;2023;45;37;8;82.2222222222222;17.7777777777778;265615.888888889;3116.2;88.8444444444444
78329;2023;4;4;0;100;0;286925;2577.25;113.5
78334;2023;24;24;0;100;0;430873.875;3977.83333333333;115.458333333333
78335;2023;127;77;50;60.6299212598425;39.3700787401575;201210.622047244;2621.29921259843;78.0629921259843
78337;2023;17;17;0;100;0;243368.352941176;2614.05882352941;97.2941176470588
78343;2023;12;11;1;91.6666666666667;8.33333333333333;832541.25;6113.33333333333;139.583333333333
78344;2023;2;2;0;100;0;387500;2611;149
78346;2023;13;12;1;92.3076923076923;7.69230769230769;262738.461538462;3213;96.2307692307692
78349;2023;6;6;0;100;0;518383.333333333;4468.66666666667;122.666666666667
78350;2023;68;25;43;36.7647058823529;63.2352941176471;546978.455882353;5315.27941176471;101.823529411765
78354;2023;38;32;6;84.2105263157895;15.7894736842105;242457.605263158;2791.76315789474;89.6052631578947
78356;2023;72;46;26;63.8888888888889;36.1111111111111;334158.791666667;3711.11111111111;90.2777777777778
78358;2023;323;75;248;23.2198142414861;76.7801857585139;519589.086687307;6511.24148606811;76.5356037151703
78361;2023;327;86;241;26.2996941896024;73.7003058103976;175591.681957187;2804.59633027523;64.5626911314985
78362;2023;185;109;76;58.9189189189189;41.0810810810811;198479.827027027;2709.79459459459;74.8972972972973
78364;2023;10;8;2;80;20;344419.4;3050.7;116.7
78366;2023;9;9;0;100;0;452588.888888889;3513.77777777778;127.333333333333
78367;2023;36;24;12;66.6666666666667;33.3333333333333;778059.555555556;6089.88888888889;126.888888888889
78368;2023;15;12;3;80;20;376927;3502.66666666667;108.866666666667
78372;2023;165;26;139;15.7575757575758;84.2424242424242;335067.545454545;4329.34545454545;75.1515151515152
78380;2023;47;37;10;78.7234042553192;21.2765957446809;365915.70212766;3678.97872340426;102.744680851064
78381;2023;9;9;0;100;0;352738.888888889;3601.77777777778;98.3333333333333
78382;2023;53;35;18;66.0377358490566;33.9622641509434;327687.132075472;4084.69811320755;81.3962264150943
78383;2023;220;97;123;44.0909090909091;55.9090909090909;243951;3123.14090909091;78.2818181818182
78384;2023;15;11;4;73.3333333333333;26.6666666666667;482872.666666667;4593.66666666667;108.4
78389;2023;22;20;2;90.9090909090909;9.09090909090909;646801.136363636;4807.09090909091;124.5
78391;2023;3;3;0;100;0;257085;2889.33333333333;90
78396;2023;41;18;23;43.9024390243902;56.0975609756098;531567.43902439;5619.14634146341;91.7560975609756
78397;2023;56;42;14;75;25;366621.589285714;3970.16071428571;95.6607142857143
78398;2023;8;8;0;100;0;661520;5766.125;116.375
78401;2023;119;42;77;35.2941176470588;64.7058823529412;177703.12605042;2872.06722689076;64.4789915966387
78402;2023;26;16;10;61.5384615384615;38.4615384615385;256361.923076923;2605.26923076923;105.269230769231
78403;2023;22;14;8;63.6363636363636;36.3636363636364;277031.272727273;3978.09090909091;78.9545454545455
78404;2023;2;2;0;100;0;538760;4218;136.5
78406;2023;1;1;0;100;0;350000;6731;52
78407;2023;5;5;0;100;0;579566;3312;182
78410;2023;10;10;0;100;0;265558.4;2808.2;107.1
78413;2023;7;7;0;100;0;445676;2884.28571428571;138.428571428571
78415;2023;7;7;0;100;0;516950;4092;140
78416;2023;2;2;0;100;0;216900;2295.5;99
78417;2023;2;2;0;100;0;491200;3715.5;134
78418;2023;133;65;68;48.8721804511278;51.1278195488722;424461.518796992;4977.82706766917;85.1278195488722
78420;2023;26;17;9;65.3846153846154;34.6153846153846;517019.653846154;5298.69230769231;100.961538461538
78423;2023;321;77;244;23.98753894081;76.01246105919;311466.14953271;4065.47352024922;77.6230529595016
78431;2023;24;23;1;95.8333333333333;4.16666666666667;524352.75;4511.83333333333;116.416666666667
78437;2023;8;8;0;100;0;302871.875;2788.125;110.625
78440;2023;190;66;124;34.7368421052632;65.2631578947368;168908.131578947;2453.08947368421;70.2578947368421
78442;2023;61;21;40;34.4262295081967;65.5737704918033;280525.573770492;3911.39344262295;73.6229508196721
78443;2023;8;6;2;75;25;378597.5;3283.5;122.375
78444;2023;6;6;0;100;0;331775;3098.83333333333;108.5
78451;2023;6;6;0;100;0;243366.666666667;2879.83333333333;85.5
78455;2023;57;40;17;70.1754385964912;29.8245614035088;674054.473684211;5504.21052631579;122.19298245614
78460;2023;12;12;0;100;0;323170.833333333;3086.66666666667;108.333333333333
78464;2023;9;9;0;100;0;356990.555555556;3167.66666666667;114.555555555556
78465;2023;24;23;1;95.8333333333333;4.16666666666667;339727.958333333;3284.95833333333;108.875
78466;2023;88;74;14;84.0909090909091;15.9090909090909;589298.579545455;5000.39772727273;119.375
78470;2023;11;10;1;90.9090909090909;9.09090909090909;408343.636363636;3172.54545454545;126.454545454545
78472;2023;3;3;0;100;0;236666.666666667;1924.33333333333;123.333333333333
78474;2023;15;14;1;93.3333333333333;6.66666666666667;274107.866666667;2875.06666666667;99.0666666666667
78475;2023;6;6;0;100;0;410887.5;3312.66666666667;124.666666666667
78478;2023;5;5;0;100;0;224590;2199.2;113.4
78481;2023;184;39;145;21.195652173913;78.804347826087;421759.510869565;5172.8097826087;79.6195652173913
78484;2023;7;6;1;85.7142857142857;14.2857142857143;249807.142857143;2501.14285714286;99
78486;2023;90;55;35;61.1111111111111;38.8888888888889;294199.111111111;3772.61111111111;80.9666666666667
78490;2023;307;117;190;38.1107491856677;61.8892508143323;269070.781758958;3285.29315960912;81.9055374592834
78497;2023;8;8;0;100;0;583537.5;4484.125;124
78498;2023;366;65;301;17.7595628415301;82.2404371584699;272046.691256831;4151.54918032787;65.5109289617486
78499;2023;6;6;0;100;0;299083.333333333;2949.66666666667;106
78501;2023;31;29;2;93.5483870967742;6.45161290322581;261831.64516129;2730.22580645161;100.677419354839
78502;2023;65;3;62;4.61538461538462;95.3846153846154;259717.907692308;4304.09230769231;62.1538461538462
78505;2023;5;5;0;100;0;234820;2026.4;116.4
78506;2023;12;12;0;100;0;287408.333333333;2548.66666666667;117.25
78513;2023;33;23;10;69.6969696969697;30.3030303030303;353182.121212121;3979.60606060606;91.1212121212121
78516;2023;7;7;0;100;0;427025.714285714;3360.14285714286;136.428571428571
78517;2023;371;130;241;35.0404312668464;64.9595687331536;292197.603773585;3990.66576819407;74.4393530997305
78520;2023;14;13;1;92.8571428571429;7.14285714285714;390633.571428571;2781.71428571429;137.428571428571
78522;2023;9;7;2;77.7777777777778;22.2222222222222;339358.888888889;3058.55555555556;135.111111111111
78528;2023;6;6;0;100;0;401839.5;2954.33333333333;122.833333333333
78530;2023;5;5;0;100;0;321800;2978;108.2
78531;2023;57;44;13;77.1929824561403;22.8070175438596;203141.929824561;2612.31578947368;82.3333333333333
78536;2023;5;5;0;100;0;317579;3446.6;97.8
78537;2023;64;54;10;84.375;15.625;323625.1875;3272.515625;98.0625
78545;2023;216;33;183;15.2777777777778;84.7222222222222;293991.319444444;4438.19907407407;67.0555555555556
78548;2023;6;6;0;100;0;878750;5441.5;164.5
78550;2023;17;17;0;100;0;471810.764705882;4792.88235294118;108.058823529412
78551;2023;508;97;411;19.0944881889764;80.9055118110236;551549.468503937;6880.60433070866;78.5236220472441
78557;2023;9;9;0;100;0;334273.333333333;2503.22222222222;129.666666666667
78558;2023;2;2;0;100;0;230500;1726;131.5
78559;2023;9;9;0;100;0;231500;2162.11111111111;107.777777777778
78561;2023;2;2;0;100;0;676866.5;4156;151.5
78562;2023;15;13;2;86.6666666666667;13.3333333333333;672754;4436.53333333333;140.333333333333
78564;2023;5;4;1;80;20;209584;2618.8;89.4
78565;2023;7;7;0;100;0;485342.857142857;3062;155
78567;2023;6;6;0;100;0;241966.666666667;2533.5;97.6666666666667
78569;2023;9;9;0;100;0;240994.444444444;2894.11111111111;95.3333333333333
78571;2023;51;43;8;84.3137254901961;15.6862745098039;800543.137254902;5380.70588235294;150.156862745098
78575;2023;72;49;23;68.0555555555556;31.9444444444444;402837.375;4926.40277777778;85.8611111111111
78576;2023;20;14;6;70;30;413296.85;4014.15;110.55
78586;2023;513;205;308;39.9610136452242;60.0389863547758;328707.173489279;4854.92202729045;69.9571150097466
78588;2023;8;6;2;75;25;371800;3447.375;112.25
78590;2023;5;5;0;100;0;419800;3233.8;122.2
78591;2023;28;26;2;92.8571428571429;7.14285714285714;286550.071428571;2935.42857142857;102.25
78597;2023;3;3;0;100;0;261740.333333333;3441.66666666667;76.6666666666667
78601;2023;17;16;1;94.1176470588235;5.88235294117647;280684.117647059;2854.35294117647;103
78605;2023;6;6;0;100;0;409621.666666667;3346.83333333333;125.333333333333
78608;2023;2;2;0;100;0;220550;1641;149.5
78609;2023;13;13;0;100;0;270428.461538462;2758;102.615384615385
78615;2023;10;9;1;90;10;364490.9;4207.4;85.9
78616;2023;12;9;3;75;25;300380.5;3151.75;101.833333333333
78618;2023;7;7;0;100;0;271516.428571429;2071;135.428571428571
78620;2023;6;5;1;83.3333333333333;16.6666666666667;538087.333333333;5417;106.666666666667
78621;2023;185;35;150;18.9189189189189;81.0810810810811;179477.583783784;2891.75135135135;64.5783783783784
78623;2023;11;8;3;72.7272727272727;27.2727272727273;370310;3617.63636363636;104.545454545455
78624;2023;174;129;45;74.1379310344828;25.8620689655172;317049.770114943;3926.75862068966;83.8620689655172
78638;2023;46;30;16;65.2173913043478;34.7826086956522;320222.391304348;3750.15217391304;87.0434782608696
78640;2023;173;27;146;15.606936416185;84.393063583815;359212.826589595;5018.54913294798;71.1907514450867
78642;2023;157;62;95;39.4904458598726;60.5095541401274;294555.72611465;3641.99363057325;81.3248407643312
78643;2023;89;59;30;66.2921348314607;33.7078651685393;367174.516853933;4068.19101123596;93.5730337078652
78644;2023;11;9;2;81.8181818181818;18.1818181818182;253490;3481.81818181818;78.0909090909091
78646;2023;888;78;810;8.78378378378378;91.2162162162162;529059.274774775;7182.33333333333;72.704954954955
78647;2023;11;10;1;90.9090909090909;9.09090909090909;228666.181818182;2515.72727272727;94.0909090909091
78650;2023;198;83;115;41.9191919191919;58.0808080808081;780952.454545455;7487.85858585859;96.7474747474748
78653;2023;4;4;0;100;0;496287.5;2917.75;177.25
78655;2023;8;7;1;87.5;12.5;418419;3987.5;104
78668;2023;5;5;0;100;0;242600;2496.4;97.6
78672;2023;65;37;28;56.9230769230769;43.0769230769231;511726.707692308;4805.84615384615;107.2
78674;2023;126;88;38;69.8412698412698;30.1587301587302;351360.444444444;4118.15873015873;84.9523809523809
78677;2023;3;3;0;100;0;377086.666666667;2301.33333333333;158.666666666667
78681;2023;8;7;1;87.5;12.5;340362.5;3907.75;89.625
78683;2023;24;22;2;91.6666666666667;8.33333333333333;426108.25;4308.875;105.458333333333
78686;2023;230;54;176;23.4782608695652;76.5217391304348;438436.039130435;6364.54347826087;68.3173913043478
78688;2023;70;46;24;65.7142857142857;34.2857142857143;439766.442857143;4531.18571428571;97.0428571428571
79001;2023;15;15;0;100;0;90185.5333333333;930.066666666667;95.0666666666667
79002;2023;2;2;0;100;0;172450;1442.5;125
79003;2023;47;47;0;100;0;218967.978723404;2113.97872340426;103
79005;2023;45;45;0;100;0;102179.777777778;1081.08888888889;91.6888888888889
79007;2023;7;7;0;100;0;121085.714285714;1022.85714285714;115
79008;2023;8;8;0;100;0;115125;1001.875;117.375
79009;2023;7;7;0;100;0;187622.857142857;1780.42857142857;103.857142857143
79010;2023;11;11;0;100;0;111819.454545455;2097.45454545455;58.2727272727273
79012;2023;20;20;0;100;0;156770;1497.9;104.7
79013;2023;34;34;0;100;0;121594.823529412;1149.52941176471;107.058823529412
79014;2023;30;30;0;100;0;125671.666666667;1263.23333333333;97.8333333333333
79015;2023;2;2;0;100;0;72706.5;856;83
79016;2023;8;8;0;100;0;119812.5;1058;116.625
79018;2023;4;4;0;100;0;119300;1464.25;130
79019;2023;1;1;0;100;0;82333;1614;51
79020;2023;10;10;0;100;0;119080.6;1313.6;86.1
79022;2023;1;1;0;100;0;58000;1160;50
79023;2023;1;1;0;100;0;138000;1586;87
79024;2023;20;20;0;100;0;220654.75;1818.3;125.35
79025;2023;15;15;0;100;0;125694.333333333;1324.26666666667;106.066666666667
79029;2023;5;5;0;100;0;105850;1105.6;94.4
79030;2023;11;11;0;100;0;120916.272727273;1145.09090909091;108.181818181818
79031;2023;22;20;2;90.9090909090909;9.09090909090909;157826.363636364;1434.59090909091;112.363636363636
79032;2023;3;3;0;100;0;36833.3333333333;631.333333333333;63.3333333333333
79034;2023;22;22;0;100;0;280050.909090909;1973.36363636364;142.227272727273
79038;2023;16;16;0;100;0;140451.625;1342.9375;99.6875
79040;2023;2;2;0;100;0;114500;904.5;121
79042;2023;2;2;0;100;0;97262.5;988.5;98
79046;2023;6;6;0;100;0;172708.333333333;1265.5;135.166666666667
79047;2023;4;4;0;100;0;82532.5;908.25;91.5
79048;2023;71;71;0;100;0;176514.056338028;1852.32394366197;97.112676056338
79049;2023;199;183;16;91.9597989949749;8.04020100502512;146929.713567839;1505.93467336683;100.623115577889
79050;2023;10;10;0;100;0;148942.4;1500;102.8
79056;2023;8;8;0;100;0;121500;1291.125;95.375
79057;2023;13;13;0;100;0;135507.692307692;1241.23076923077;109.923076923077
79058;2023;6;6;0;100;0;247475;1430.16666666667;177.333333333333
79059;2023;22;22;0;100;0;108320.772727273;1103.13636363636;100.772727272727
79060;2023;2;2;0;100;0;127475;631;204
79061;2023;36;35;1;97.2222222222222;2.77777777777778;169220.611111111;1509.80555555556;114.944444444444
79062;2023;46;46;0;100;0;128130.826086957;1298.69565217391;98.6739130434783
79063;2023;25;25;0;100;0;95540.6;933.92;104.36
79064;2023;9;9;0;100;0;130388.888888889;1108.33333333333;115.555555555556
79066;2023;24;24;0;100;0;99497.0833333333;1058.25;98.0833333333333
79069;2023;18;18;0;100;0;125522.222222222;1284.44444444444;100.555555555556
79070;2023;4;4;0;100;0;137900;1020;124
79071;2023;8;8;0;100;0;142187.5;1405.375;98
79074;2023;2;2;0;100;0;78165;793;107.5
79076;2023;24;24;0;100;0;123365.416666667;1464.70833333333;104.958333333333
79077;2023;16;16;0;100;0;121090.6875;1201.25;103.125
79078;2023;14;14;0;100;0;172050;1412.42857142857;116.214285714286
79079;2023;93;93;0;100;0;152333.225806452;1465.66666666667;106.52688172043
79080;2023;34;34;0;100;0;127402.147058824;1381.55882352941;96.2058823529412
79081;2023;108;80;28;74.0740740740741;25.9259259259259;189524.990740741;2104.19444444444;90.1666666666667
79083;2023;46;44;2;95.6521739130435;4.34782608695652;125598.391304348;1162.76086956522;110.5
79084;2023;11;11;0;100;0;161590.909090909;1286.81818181818;125.636363636364
79086;2023;22;22;0;100;0;167222.818181818;1745.18181818182;101.772727272727
79087;2023;6;6;0;100;0;119916.666666667;1110.66666666667;107.166666666667
79088;2023;15;15;0;100;0;133632.333333333;1213.4;109.266666666667
79089;2023;4;4;0;100;0;111950;1013.25;113.75
79090;2023;15;15;0;100;0;131942.333333333;1018.93333333333;128.266666666667
79091;2023;15;15;0;100;0;131274.666666667;1286;103.6
79092;2023;3;3;0;100;0;124500;938;136.666666666667
79094;2023;14;14;0;100;0;126570.714285714;1212.71428571429;117.285714285714
79095;2023;13;13;0;100;0;158391;907.923076923077;169.076923076923
79096;2023;23;23;0;100;0;139584.130434783;1318.26086956522;110.608695652174
79100;2023;31;31;0;100;0;215306.387096774;2008.48387096774;104.548387096774
79101;2023;38;38;0;100;0;141915.973684211;1404.05263157895;99.8684210526316
79102;2023;3;3;0;100;0;114650;1006.33333333333;112.666666666667
79103;2023;27;27;0;100;0;119438.592592593;1096.81481481481;108.444444444444
79104;2023;3;3;0;100;0;107063.333333333;1559.66666666667;66
79105;2023;3;3;0;100;0;72966.6666666667;976.333333333333;79.3333333333333
79106;2023;7;7;0;100;0;89808.5714285714;997;110.142857142857
79108;2023;2;2;0;100;0;102500;950;104.5
79109;2023;42;42;0;100;0;211570.476190476;2039.2619047619;109.095238095238
79111;2023;3;3;0;100;0;67780;969.666666666667;74.3333333333333
79112;2023;16;16;0;100;0;204560.625;1841.25;112.75
79114;2023;21;20;1;95.2380952380952;4.76190476190476;134585.714285714;1295.19047619048;108.428571428571
79115;2023;6;6;0;100;0;163546.666666667;1159.66666666667;134
79116;2023;9;9;0;100;0;103077.777777778;1124.88888888889;91.7777777777778
79117;2023;7;7;0;100;0;169571.428571429;1592;107.857142857143
79118;2023;6;6;0;100;0;87916.6666666667;791.166666666667;114.5
79119;2023;13;13;0;100;0;148015.384615385;1366.07692307692;104.230769230769
79120;2023;12;12;0;100;0;125283.25;1218.58333333333;91.25
79121;2023;9;9;0;100;0;120416.666666667;1183.88888888889;102.555555555556
79122;2023;7;7;0;100;0;107884.285714286;993.571428571429;109.285714285714
79123;2023;29;29;0;100;0;110873.793103448;1137.10344827586;101.793103448276
79124;2023;9;6;3;66.6666666666667;33.3333333333333;92657.1111111111;1075.88888888889;83.7777777777778
79125;2023;18;18;0;100;0;158218.055555556;1733.38888888889;93.0555555555556
79126;2023;6;6;0;100;0;127841.666666667;1130.66666666667;131.333333333333
79127;2023;8;8;0;100;0;133125;1340.875;97.875
79128;2023;5;5;0;100;0;190556;1568;110.6
79129;2023;18;18;0;100;0;195733.444444444;1581.66666666667;119.222222222222
79130;2023;39;39;0;100;0;177068.384615385;1638.28205128205;112.871794871795
79131;2023;4;4;0;100;0;124300;931;133
79132;2023;5;5;0;100;0;107610;785.6;140.4
79133;2023;10;10;0;100;0;220472.3;1887.3;118.9
79134;2023;9;9;0;100;0;79966.6666666667;871.666666666667;94.7777777777778
79135;2023;11;11;0;100;0;146254.545454545;1102.81818181818;124.545454545455
79136;2023;15;15;0;100;0;104662.2;1097.6;110.6
79137;2023;4;4;0;100;0;202250;1762.75;107.75
79139;2023;1;1;0;100;0;186500;1332;140
79140;2023;22;22;0;100;0;113434.090909091;1147.18181818182;104.363636363636
79141;2023;3;3;0;100;0;126800;1000;130.666666666667
79144;2023;6;6;0;100;0;136541.666666667;1158;121.833333333333
79145;2023;1;1;0;100;0;115000;1292;89
79147;2023;6;6;0;100;0;129316.666666667;1260.83333333333;103.333333333333
79148;2023;32;31;1;96.875;3.125;113933.1875;1106.5625;112.5625
79150;2023;12;12;0;100;0;104141.666666667;1040.25;104.5
79152;2023;7;7;0;100;0;139190.714285714;1314.71428571429;109.142857142857
79153;2023;1;1;0;100;0;118000;855;138
79154;2023;11;11;0;100;0;124477.727272727;1082.36363636364;112.909090909091
79156;2023;12;12;0;100;0;119103.583333333;1233.58333333333;104.166666666667
79157;2023;16;16;0;100;0;119290;1292.125;89.25
79158;2023;2;2;0;100;0;104000;1113.5;97
79159;2023;2;2;0;100;0;102425;696;131
79160;2023;3;3;0;100;0;172033.333333333;1164.33333333333;130
79161;2023;6;6;0;100;0;260993.333333333;1695.16666666667;148.666666666667
79162;2023;36;36;0;100;0;227065.833333333;2275.75;101.527777777778
79163;2023;11;11;0;100;0;149828;1063.90909090909;141.272727272727
79164;2023;1;1;0;100;0;51520;652;79
79165;2023;1;1;0;100;0;34252;571;60
79166;2023;8;8;0;100;0;148000;1548.5;106.5
79167;2023;3;3;0;100;0;57000;826.666666666667;69
79170;2023;47;47;0;100;0;161375.744680851;1651.68085106383;100.744680851064
79172;2023;8;8;0;100;0;154903.75;1355.5;117.875
79174;2023;90;88;2;97.7777777777778;2.22222222222222;125495.222222222;1265.3;98.5444444444445
79175;2023;9;9;0;100;0;148292.444444444;1032.66666666667;146.333333333333
79176;2023;8;8;0;100;0;116083.375;1514.875;103.5
79177;2023;3;3;0;100;0;153258.666666667;1012.33333333333;162.333333333333
79179;2023;60;60;0;100;0;122683.3;1261.83333333333;98.8
79180;2023;4;4;0;100;0;140625;1200.25;110.75
79183;2023;3;3;0;100;0;98446.6666666667;845.666666666667;114.333333333333
79184;2023;25;23;2;92;8;126398.76;1089.88;121.32
79185;2023;46;46;0;100;0;182080.695652174;1743.63043478261;107.565217391304
79189;2023;23;23;0;100;0;162571.434782609;1550.73913043478;105.869565217391
79190;2023;7;7;0;100;0;129034.285714286;1287.14285714286;103.285714285714
79191;2023;1041;686;355;65.8981748318924;34.1018251681076;163721.728146013;2083.8828049952;79.1738712776177
79195;2023;59;59;0;100;0;137126.118644068;1271.42372881356;110.966101694915
79196;2023;39;39;0;100;0;120274.358974359;1024.35897435897;117.051282051282
79197;2023;1;1;0;100;0;175000;1944;90
79198;2023;9;9;0;100;0;99535.4444444444;867.222222222222;117.888888888889
79200;2023;5;5;0;100;0;99250;846;127.8
79201;2023;19;19;0;100;0;146021.789473684;1323.78947368421;114.421052631579
79202;2023;185;152;33;82.1621621621622;17.8378378378378;109867.254054054;1366.94594594595;82.9513513513513
79203;2023;8;8;0;100;0;115431.25;1191.625;106.625
79204;2023;14;14;0;100;0;143142.857142857;1200.14285714286;120.857142857143
79205;2023;2;2;0;100;0;136934;1605.5;87.5
79207;2023;4;4;0;100;0;99675;1012.5;107
79208;2023;7;7;0;100;0;138142.857142857;1149.57142857143;121.857142857143
79209;2023;7;7;0;100;0;73444.2857142857;902.857142857143;82.1428571428571
79210;2023;10;10;0;100;0;184211;1365.9;123.7
79212;2023;8;8;0;100;0;137216.25;1057.75;134.875
79213;2023;26;26;0;100;0;170275.961538462;1467.88461538462;119.730769230769
79215;2023;6;6;0;100;0;93166.6666666667;750.166666666667;119.833333333333
79216;2023;20;20;0;100;0;161555;1587.4;103.85
79217;2023;7;7;0;100;0;113673.571428571;1080;103.571428571429
79218;2023;2;2;0;100;0;146500;1116.5;128.5
79220;2023;9;9;0;100;0;205555.555555556;1539;138.888888888889
79223;2023;3;3;0;100;0;134600;1075.33333333333;127
79225;2023;6;6;0;100;0;67800;725.166666666667;93.8333333333333
79226;2023;7;7;0;100;0;110785.714285714;1198.57142857143;94.7142857142857
79229;2023;3;3;0;100;0;157813.333333333;1305.33333333333;125.666666666667
79230;2023;17;17;0;100;0;107826.470588235;1083.41176470588;103
79231;2023;8;8;0;100;0;191625;1785.5;113
79235;2023;19;19;0;100;0;134770.789473684;1297.31578947368;105.736842105263
79236;2023;12;12;0;100;0;150110.666666667;1349.75;108.916666666667
79238;2023;6;6;0;100;0;159793.333333333;1600.66666666667;100.166666666667
79239;2023;25;25;0;100;0;106330;1154.6;95.24
79241;2023;4;4;0;100;0;195500;1602;132.75
79242;2023;9;9;0;100;0;158302.888888889;1200.77777777778;129.333333333333
79243;2023;6;6;0;100;0;82500;906.833333333333;84.1666666666667
79244;2023;5;5;0;100;0;148930;1455.4;100.8
79246;2023;4;4;0;100;0;145250;1218.75;110.25
79249;2023;23;23;0;100;0;207710.217391304;2010.30434782609;105.391304347826
79250;2023;7;7;0;100;0;140671.428571429;1251.14285714286;118.428571428571
79251;2023;6;6;0;100;0;121606.833333333;1133.83333333333;116.5
79252;2023;4;4;0;100;0;113000;1482.5;86.5
79253;2023;9;9;0;100;0;121013.888888889;1025.44444444444;114.333333333333
79254;2023;7;7;0;100;0;141857.142857143;1351.14285714286;104.285714285714
79255;2023;5;5;0;100;0;128180;1176.8;102.4
79256;2023;1;1;0;100;0;137000;965;142
79257;2023;27;27;0;100;0;143844.444444444;1387.18518518519;103.333333333333
79258;2023;3;3;0;100;0;83833.3333333333;840;93.6666666666667
79259;2023;16;16;0;100;0;134006.875;1397.75;96.375
79263;2023;7;7;0;100;0;89864.2857142857;1211.42857142857;86.5714285714286
79265;2023;11;11;0;100;0;121156.818181818;1149.54545454545;102.454545454545
79267;2023;9;9;0;100;0;109016.555555556;1036.44444444444;110.666666666667
79268;2023;19;19;0;100;0;107895.263157895;1120.63157894737;94.8947368421053
79269;2023;9;9;0;100;0;178616.666666667;1562.66666666667;113.444444444444
79270;2023;87;83;4;95.4022988505747;4.59770114942529;122723.310344828;1271.75862068966;100.701149425287
79271;2023;7;7;0;100;0;138714.285714286;1406.71428571429;98.4285714285714
79273;2023;9;9;0;100;0;181755.555555556;1754.22222222222;106.444444444444
79274;2023;7;7;0;100;0;116242.857142857;1100;110.428571428571
79276;2023;8;8;0;100;0;159937.5;1475.75;119.375
79277;2023;14;14;0;100;0;112532.142857143;1276.85714285714;88.9285714285714
79278;2023;2;2;0;100;0;74000;1053.5;68.5
79280;2023;16;16;0;100;0;106209.375;1061.8125;95.375
79281;2023;13;13;0;100;0;237031.923076923;1956.15384615385;120.769230769231
79283;2023;14;14;0;100;0;222285.714285714;1775.35714285714;130.214285714286
79284;2023;8;8;0;100;0;139125;1324.875;100.25
79285;2023;32;32;0;100;0;107561.09375;1232.4375;86.71875
79286;2023;6;6;0;100;0;104646.333333333;983.833333333333;104.666666666667
79289;2023;11;11;0;100;0;179040.909090909;1800.36363636364;99.5454545454545
79290;2023;12;11;1;91.6666666666667;8.33333333333333;128361.25;1103.08333333333;121.916666666667
79293;2023;15;15;0;100;0;180315.333333333;1799.06666666667;103.866666666667
79294;2023;2;2;0;100;0;112000;1142.5;98.5
79295;2023;6;6;0;100;0;148582.5;1401.16666666667;105
79297;2023;7;7;0;100;0;111921.428571429;972.857142857143;109.857142857143
79298;2023;22;22;0;100;0;201113.636363636;1835.90909090909;108.818181818182
79299;2023;31;31;0;100;0;120404.032258065;1080.45161290323;114.129032258065
79300;2023;17;17;0;100;0;114791.176470588;1063.11764705882;103.588235294118
79301;2023;6;6;0;100;0;115803.833333333;1319.33333333333;92
79302;2023;13;13;0;100;0;152126.923076923;1437.61538461538;107.615384615385
79303;2023;5;5;0;100;0;65000;705.4;92.8
79304;2023;6;6;0;100;0;242816.666666667;2126.16666666667;128.833333333333
79306;2023;2;2;0;100;0;177400;2056;89
79307;2023;36;36;0;100;0;103625.222222222;1165.13888888889;96.9166666666667
79308;2023;12;12;0;100;0;189065.083333333;1830.25;100.083333333333
79309;2023;7;7;0;100;0;102797.142857143;1094.57142857143;98.5714285714286
79310;2023;5;5;0;100;0;94000;865.8;103.2
79311;2023;28;28;0;100;0;105754.214285714;1136.92857142857;92
79312;2023;2;2;0;100;0;116500;926;116.5
79313;2023;8;8;0;100;0;144371.875;1194.625;125.5
79316;2023;5;5;0;100;0;109600;1103.2;99.6
79319;2023;13;13;0;100;0;140512;1290.30769230769;122.692307692308
79320;2023;7;7;0;100;0;103744.714285714;929.714285714286;113.285714285714
79322;2023;19;19;0;100;0;131554.894736842;1395.05263157895;94.7894736842105
79326;2023;19;19;0;100;0;95514.2105263158;936.736842105263;97.1578947368421
79329;2023;219;207;12;94.5205479452055;5.47945205479452;113810.497716895;1355.75799086758;87.3470319634703
79331;2023;1;1;0;100;0;40000;556;72
79332;2023;1;1;0;100;0;55000;671;82
79334;2023;11;11;0;100;0;153018.181818182;1569;100.090909090909
79335;2023;5;5;0;100;0;208400;1531.8;141.8
79336;2023;7;7;0;100;0;129369;876.857142857143;137.142857142857
79337;2023;16;16;0;100;0;123115.625;1343.9375;89.1875
79338;2023;3;3;0;100;0;92623.3333333333;753.666666666667;120.333333333333
79339;2023;32;32;0;100;0;142907.09375;1272.09375;114.03125
79340;2023;3;3;0;100;0;139666.666666667;941.666666666667;142.666666666667
79341;2023;1;1;0;100;0;555000;2681;207
79342;2023;17;17;0;100;0;113538.647058824;1269;96.7647058823529
79345;2023;7;7;0;100;0;103389;986.285714285714;110.857142857143
79346;2023;4;4;0;100;0;115500;965.25;114.75
79347;2023;9;9;0;100;0;161477.777777778;1250.55555555556;125
79348;2023;4;4;0;100;0;164500;1629.5;105.5
79349;2023;4;4;0;100;0;156475;1015.75;146.5
79350;2023;4;4;0;100;0;118125;1393;91.5
79351;2023;23;23;0;100;0;168239.52173913;1682.65217391304;102.130434782609
79352;2023;2;2;0;100;0;38000;591.5;63
79354;2023;4;4;0;100;0;77250;918.75;78.75
79355;2023;46;43;3;93.4782608695652;6.52173913043478;259119.869565217;2365.91304347826;112.260869565217
79357;2023;1;1;0;100;0;186000;1141;163
80001;2023;271;181;90;66.789667896679;33.210332103321;129594.103321033;1680.33579335793;78.2066420664207
80002;2023;3;3;0;100;0;157000;1537;109.333333333333
80003;2023;4;4;0;100;0;136250;2200;71.75
80004;2023;2;2;0;100;0;67000;1109;57.5
80008;2023;7;7;0;100;0;191211.428571429;2018.28571428571;93.8571428571429
80009;2023;7;6;1;85.7142857142857;14.2857142857143;154474.285714286;1571.71428571429;101
80010;2023;21;21;0;100;0;192507.380952381;2023.28571428571;94.1904761904762
80011;2023;37;37;0;100;0;169942.594594595;1926.35135135135;94.4324324324324
80013;2023;19;17;2;89.4736842105263;10.5263157894737;119207.894736842;1286.05263157895;97.5263157894737
80014;2023;1;1;0;100;0;86290;1269;68
80015;2023;2;2;0;100;0;98000;1480;64.5
80016;2023;129;115;14;89.1472868217054;10.8527131782946;121686.930232558;1513.48062015504;83.9069767441861
80017;2023;6;6;0;100;0;239145.166666667;2020.33333333333;115.5
80019;2023;6;6;0;100;0;169600.166666667;2241.16666666667;87.8333333333333
80020;2023;4;4;0;100;0;348400;2210;156.75
80021;2023;1503;789;714;52.4950099800399;47.5049900199601;168398.804391218;2518.14836992681;68.7152361942781
80022;2023;3;3;0;100;0;135666.666666667;1565.33333333333;87.6666666666667
80023;2023;2;2;0;100;0;130000;1268;102
80024;2023;6;6;0;100;0;321175;2354;139
80025;2023;4;4;0;100;0;164350;2664.5;70.25
80028;2023;4;4;0;100;0;140337.5;1515;100.25
80029;2023;5;5;0;100;0;185830;2605.4;79
80030;2023;3;3;0;100;0;153000;1748;87
80031;2023;10;10;0;100;0;178948;1898.3;103.2
80033;2023;2;2;0;100;0;115000;1248;91.5
80034;2023;13;13;0;100;0;119092.307692308;1382.07692307692;103.769230769231
80036;2023;8;8;0;100;0;188156.25;2161.5;89
80037;2023;5;5;0;100;0;101100;1399.2;84.6
80038;2023;4;4;0;100;0;136375;1300.5;106.75
80039;2023;66;35;31;53.030303030303;46.969696969697;137837.893939394;2631.77272727273;58.6818181818182
80042;2023;2;2;0;100;0;61500;781;90.5
80043;2023;2;2;0;100;0;93000;1112;83.5
80044;2023;1;1;0;100;0;100850;1576;64
80045;2023;3;3;0;100;0;191333.333333333;1733.66666666667;110.666666666667
80046;2023;2;2;0;100;0;36000;537.5;66
80047;2023;6;6;0;100;0;123391.666666667;1308.83333333333;93.6666666666667
80048;2023;1;1;0;100;0;85000;842;101
80049;2023;1;1;0;100;0;120000;1200;100
80050;2023;4;4;0;100;0;372375;2516;137.5
80051;2023;6;6;0;100;0;133358.333333333;1377.33333333333;108.333333333333
80052;2023;2;2;0;100;0;165875;1450.5;115.5
80053;2023;1;1;0;100;0;38000;760;50
80054;2023;1;1;0;100;0;108000;1770;61
80055;2023;2;2;0;100;0;157750;963.5;176.5
80056;2023;1;1;0;100;0;615000;4424;139
80057;2023;1;1;0;100;0;160000;1928;83
80058;2023;4;4;0;100;0;120550;1424;96.5
80059;2023;1;1;0;100;0;258150;2206;117
80060;2023;3;3;0;100;0;137166.666666667;1768.33333333333;80.6666666666667
80061;2023;1;1;0;100;0;114000;1900;60
80062;2023;17;17;0;100;0;150316.470588235;1730.70588235294;93.5882352941177
80063;2023;23;23;0;100;0;147331.086956522;1657.34782608696;88.1739130434783
80064;2023;2;2;0;100;0;160500;1298;120
80065;2023;1;1;0;100;0;32000;492;65
80066;2023;4;4;0;100;0;118833;1472;83.5
80067;2023;1;1;0;100;0;143500;1293;111
80068;2023;3;3;0;100;0;130000;1201;131
80069;2023;4;4;0;100;0;105000;1129.25;94.25
80070;2023;13;13;0;100;0;142669.461538462;1567.84615384615;94.7692307692308
80071;2023;20;20;0;100;0;108650;1339.35;84.7
80073;2023;1;1;0;100;0;130000;1193;109
80074;2023;3;3;0;100;0;153150;1594.66666666667;97
80076;2023;8;8;0;100;0;110875;1641.875;72.25
80077;2023;6;6;0;100;0;200966.666666667;2043.5;95
80078;2023;3;3;0;100;0;202283.333333333;1983;108.333333333333
80079;2023;4;4;0;100;0;127500;1544.25;88.25
80080;2023;1;1;0;100;0;39000;520;75
80081;2023;4;4;0;100;0;79250;941.25;83.25
80082;2023;6;6;0;100;0;174550;1733.33333333333;98.6666666666667
80084;2023;3;3;0;100;0;126140;1736.66666666667;74
80085;2023;2;2;0;100;0;1,00E+05;1166.5;85
80086;2023;11;11;0;100;0;119909.090909091;1550.81818181818;84.5454545454545
80087;2023;3;3;0;100;0;132800;1184.33333333333;115
80088;2023;3;3;0;100;0;115000;930.333333333333;122
80089;2023;1;1;0;100;0;110000;1341;82
80092;2023;2;2;0;100;0;285000;2076;137.5
80093;2023;11;11;0;100;0;88103.8181818182;1108.27272727273;82.1818181818182
80094;2023;8;8;0;100;0;197834;1878.5;104.625
80095;2023;1;1;0;100;0;118000;1311;90
80096;2023;11;11;0;100;0;171868.181818182;1579.81818181818;101.909090909091
80097;2023;2;2;0;100;0;33500;1857.5;39
80098;2023;1;1;0;100;0;55000;1279;43
80100;2023;7;7;0;100;0;132571.428571429;1433.57142857143;92.8571428571429
80101;2023;11;11;0;100;0;118481.818181818;1412;86.3636363636364
80102;2023;1;1;0;100;0;55000;859;64
80103;2023;2;2;0;100;0;210000;2250.5;113
80104;2023;3;3;0;100;0;116666.666666667;1481.66666666667;79
80105;2023;2;2;0;100;0;231750;1580.5;144
80106;2023;2;2;0;100;0;66100;921;83
80107;2023;2;2;0;100;0;247000;2188;114.5
80108;2023;1;1;0;100;0;80000;1000;80
80109;2023;4;4;0;100;0;143375;1357;105.25
80110;2023;3;3;0;100;0;168333.333333333;1977.33333333333;87.3333333333333
80113;2023;2;2;0;100;0;56000;628.5;100
80114;2023;1;1;0;100;0;252000;1800;140
80115;2023;5;5;0;100;0;98480;1131.8;87.2
80116;2023;5;5;0;100;0;178500;1729.8;114.6
80119;2023;4;4;0;100;0;166325;1839.5;84.5
80120;2023;6;6;0;100;0;149166.666666667;1671.83333333333;88.1666666666667
80121;2023;3;3;0;100;0;129833.333333333;1608.66666666667;77.3333333333333
80122;2023;3;3;0;100;0;51000;644.333333333333;82.3333333333333
80123;2023;3;3;0;100;0;185000;1691.66666666667;110.666666666667
80124;2023;7;7;0;100;0;169782.857142857;1843;96.2857142857143
80125;2023;1;1;0;100;0;160000;1103;145
80126;2023;6;6;0;100;0;168000;1502.33333333333;103
80127;2023;7;7;0;100;0;146585.714285714;1800.71428571429;81
80128;2023;2;2;0;100;0;161985;1236;131
80129;2023;8;8;0;100;0;142907.125;1557.5;95.875
80130;2023;4;4;0;100;0;246931.25;2146.5;120.75
80131;2023;29;29;0;100;0;249310.344827586;2265.51724137931;107.344827586207
80132;2023;2;2;0;100;0;190000;1657.5;118
80133;2023;2;2;0;100;0;316250;1587.5;192
80134;2023;2;2;0;100;0;195000;1728;115.5
80135;2023;3;3;0;100;0;110000;1600.33333333333;76.6666666666667
80136;2023;15;15;0;100;0;112026.666666667;1238.33333333333;92.0666666666667
80137;2023;6;6;0;100;0;196357.333333333;2395;89.3333333333333
80138;2023;1;1;0;100;0;124000;1968;63
80139;2023;1;1;0;100;0;188000;1175;160
80140;2023;1;1;0;100;0;1,00E+05;654;153
80141;2023;2;2;0;100;0;65750;741;73.5
80142;2023;4;4;0;100;0;212575;2187;97.5
80143;2023;1;1;0;100;0;128000;1196;107
80144;2023;6;6;0;100;0;67100;802.666666666667;85.8333333333333
80146;2023;4;4;0;100;0;120000;1727.5;87.75
80147;2023;2;2;0;100;0;171000;1441.5;131.5
80148;2023;7;7;0;100;0;114728.571428571;1570.71428571429;78.1428571428571
80149;2023;3;3;0;100;0;202165;2315.33333333333;97
80150;2023;2;2;0;100;0;131750;777.5;147.5
80153;2023;1;1;0;100;0;55000;859;64
80154;2023;1;1;0;100;0;82000;1000;82
80156;2023;5;5;0;100;0;251695.4;1687.2;174.6
80157;2023;1;1;0;100;0;1,00E+05;662;151
80158;2023;1;1;0;100;0;130000;1182;110
80159;2023;4;4;0;100;0;170125;1881.25;87.75
80160;2023;13;13;0;100;0;273365.384615385;2506.53846153846;111.307692307692
80161;2023;2;2;0;100;0;374000;1746;207.5
80162;2023;13;13;0;100;0;81350;1188.30769230769;69.4615384615385
80163;2023;5;5;0;100;0;214084.2;2155.6;97.8
80164;2023;38;37;1;97.3684210526316;2.63157894736842;210773.421052632;2430.39473684211;87.7894736842105
80165;2023;3;3;0;100;0;107500;1111;87.6666666666667
80166;2023;3;3;0;100;0;124500;1323.66666666667;84
80167;2023;1;1;0;100;0;130000;1398;93
80168;2023;4;4;0;100;0;195733.25;1946.75;116
80169;2023;2;2;0;100;0;126000;872.5;149
80170;2023;1;1;0;100;0;90000;1250;72
80171;2023;6;6;0;100;0;191000;1726;109.666666666667
80172;2023;8;8;0;100;0;117468.75;1401.75;91.5
80173;2023;5;5;0;100;0;217650;1896.2;119.2
80176;2023;4;4;0;100;0;138793.75;1973.75;70.5
80177;2023;5;5;0;100;0;103600;1151.2;94.4
80179;2023;3;3;0;100;0;226333.333333333;2730.66666666667;82.6666666666667
80182;2023;97;70;27;72.1649484536082;27.8350515463918;153139.917525773;2789.96907216495;61.3814432989691
80183;2023;2;2;0;100;0;109500;983.5;113
80184;2023;6;6;0;100;0;141798.333333333;1360.83333333333;119.666666666667
80185;2023;3;3;0;100;0;109666.666666667;1426;78
80186;2023;16;16;0;100;0;116340;1514.125;81.625
80187;2023;3;3;0;100;0;220766.666666667;2074.66666666667;108.666666666667
80188;2023;5;5;0;100;0;119400;1646.6;78.8
80190;2023;9;9;0;100;0;152011;1642.66666666667;88.5555555555556
80191;2023;2;2;0;100;0;120000;1306.5;113
80192;2023;3;3;0;100;0;55000.3333333333;1186.33333333333;59.3333333333333
80194;2023;2;2;0;100;0;79000;900.5;89
80195;2023;4;4;0;100;0;116375;1024.75;117.25
80196;2023;2;2;0;100;0;172750;948.5;169.5
80197;2023;1;1;0;100;0;71400;1006;71
80198;2023;5;5;0;100;0;192120;1744.8;110.4
80199;2023;10;10;0;100;0;124665;1603.7;80.2
80200;2023;4;4;0;100;0;95725;1259;78.5
80202;2023;2;2;0;100;0;228500;1533;142.5
80203;2023;1;1;0;100;0;260000;1656;157
80204;2023;16;16;0;100;0;118986.6875;1353.8125;89.25
80205;2023;16;16;0;100;0;132368.125;1397.375;92.25
80206;2023;2;2;0;100;0;104500;1310.5;80
80207;2023;3;3;0;100;0;158716.666666667;1338.33333333333;120
80208;2023;1;1;0;100;0;36100;602;60
80210;2023;1;1;0;100;0;180000;973;185
80211;2023;18;18;0;100;0;165485.555555556;1800.77777777778;90.6666666666667
80212;2023;66;57;9;86.3636363636364;13.6363636363636;144509.090909091;1786.63636363636;84.1212121212121
80213;2023;2;2;0;100;0;251500;2675;94.5
80214;2023;3;3;0;100;0;88166.6666666667;1342.66666666667;65.6666666666667
80215;2023;2;2;0;100;0;191750;1643;117
80216;2023;2;2;0;100;0;42500;768;53
80217;2023;2;2;0;100;0;147000;1674;74.5
80218;2023;1;1;0;100;0;84000;955;88
80219;2023;1;1;0;100;0;1,00E+05;1818;55
80220;2023;1;1;0;100;0;172000;1178;146
80222;2023;17;16;1;94.1176470588235;5.88235294117647;132377.941176471;1440.05882352941;93.7647058823529
80223;2023;2;2;0;100;0;123000;1008.5;120.5
80224;2023;3;3;0;100;0;89333.3333333333;1118.66666666667;82
80225;2023;2;2;0;100;0;302800;2562.5;119
80226;2023;3;3;0;100;0;141849.666666667;1126.33333333333;152
80227;2023;7;7;0;100;0;116714.285714286;1474.14285714286;81.5714285714286
80228;2023;80;47;33;58.75;41.25;270313.9;4854.4125;57.6125
80229;2023;7;4;3;57.1428571428571;42.8571428571429;189492.857142857;1698.71428571429;112.571428571429
80230;2023;5;5;0;100;0;80400;1079.8;79.2
80231;2023;2;2;0;100;0;134757.5;1303;105
80234;2023;9;8;1;88.8888888888889;11.1111111111111;181857.111111111;2016.22222222222;98.2222222222222
80235;2023;14;13;1;92.8571428571429;7.14285714285714;127346.571428571;1582.85714285714;82.7142857142857
80236;2023;7;7;0;100;0;109200;1620.57142857143;72.4285714285714
80237;2023;3;3;0;100;0;189566.666666667;1770.66666666667;110.666666666667
80238;2023;9;9;0;100;0;166644.444444444;1797.11111111111;96.3333333333333
80240;2023;11;11;0;100;0;160099.636363636;1518.63636363636;103.545454545455
80241;2023;12;12;0;100;0;98375;1199.83333333333;83.5833333333333
80242;2023;10;10;0;100;0;175357.4;1551.1;112.4
80244;2023;6;6;0;100;0;95616.6666666667;1535;67.8333333333333
80245;2023;6;6;0;100;0;106833.333333333;1437.66666666667;78.8333333333333
80246;2023;5;5;0;100;0;119000;1459.4;87.6
80247;2023;9;9;0;100;0;95972.2222222222;1077.55555555556;88.2222222222222
80248;2023;9;9;0;100;0;148477.777777778;2053;77.2222222222222
80249;2023;5;5;0;100;0;123400;1262.4;99.8
80250;2023;2;2;0;100;0;167500;1429;118.5
80251;2023;2;2;0;100;0;68000;932.5;74
80252;2023;1;1;0;100;0;154000;1176;131
80253;2023;51;45;6;88.2352941176471;11.7647058823529;121423.588235294;1195.29411764706;98.843137254902
80256;2023;21;15;6;71.4285714285714;28.5714285714286;154586.333333333;1949.61904761905;85.6666666666667
80260;2023;4;4;0;100;0;229775;1809;132.25
80261;2023;9;8;1;88.8888888888889;11.1111111111111;408338.888888889;2602.44444444444;142.222222222222
80262;2023;5;5;0;100;0;150450;1646.8;91.6
80263;2023;1;1;0;100;0;195300;1973;99
80264;2023;8;8;0;100;0;119000;1674.125;69.125
80265;2023;4;4;0;100;0;172545;1842.5;91.25
80266;2023;1;1;0;100;0;74000;925;80
80267;2023;4;4;0;100;0;106282.5;1192.5;94.75
80268;2023;7;7;0;100;0;231314.285714286;1775.42857142857;135.714285714286
80269;2023;3;3;0;100;0;189646.666666667;2178.33333333333;96
80271;2023;12;12;0;100;0;97777.5833333333;1268.33333333333;76.5833333333333
80272;2023;3;3;0;100;0;121333.333333333;1017;116.333333333333
80273;2023;4;4;0;100;0;181250;2075.25;89.25
80274;2023;19;17;2;89.4736842105263;10.5263157894737;101186.842105263;1115.68421052632;92.2105263157895
80275;2023;3;3;0;100;0;58866.6666666667;1063.33333333333;54
80279;2023;11;10;1;90.9090909090909;9.09090909090909;108690.727272727;1350.45454545455;82.0909090909091
80280;2023;2;2;0;100;0;51000;753;65.5
80282;2023;5;5;0;100;0;204480;2026.4;104
80283;2023;1;1;0;100;0;90000;1071;84
80284;2023;10;10;0;100;0;123689;1151.8;104.5
80285;2023;1;1;0;100;0;160000;2000;80
80287;2023;5;5;0;100;0;191500;2550.8;82.2
80288;2023;4;4;0;100;0;152650;1507.5;109.25
80290;2023;4;4;0;100;0;113750;1122;102.25
80291;2023;2;2;0;100;0;331750;2853;117
80292;2023;2;2;0;100;0;93650;986.5;93
80293;2023;3;3;0;100;0;143500;1213;114
80295;2023;4;4;0;100;0;144750;1523.25;89.25
80296;2023;11;11;0;100;0;89559.0909090909;1120.54545454545;78.2727272727273
80298;2023;5;5;0;100;0;87501.4;1541;62.6
80299;2023;4;4;0;100;0;192975;1737;109
80301;2023;2;2;0;100;0;59311;878.5;67.5
80302;2023;1;1;0;100;0;2,00E+05;1058;189
80303;2023;12;12;0;100;0;233883.166666667;2387.16666666667;101.166666666667
80304;2023;2;2;0;100;0;159500;1360.5;108.5
80305;2023;1;1;0;100;0;470000;2938;160
80306;2023;2;2;0;100;0;174350;1490;117
80308;2023;25;25;0;100;0;119360.4;1440.12;85.88
80310;2023;9;9;0;100;0;91322.2222222222;1219.33333333333;82.1111111111111
80312;2023;6;6;0;100;0;104916.666666667;1023.66666666667;113.333333333333
80313;2023;3;3;0;100;0;103716.666666667;952;104.333333333333
80314;2023;2;2;0;100;0;88500;842;99.5
80315;2023;2;2;0;100;0;220500;2000;112
80316;2023;13;13;0;100;0;205526.923076923;2107.15384615385;103.384615384615
80317;2023;1;1;0;100;0;80000;432;185
80318;2023;30;29;1;96.6666666666667;3.33333333333333;183635.5;1797.43333333333;93.7
80319;2023;2;2;0;100;0;192500;1499.5;124.5
80321;2023;1;1;0;100;0;105000;1094;96
80322;2023;4;4;0;100;0;116125;1129.5;104.5
80324;2023;4;4;0;100;0;76250;1216;63.5
80326;2023;4;4;0;100;0;188875;1828.75;113.25
80327;2023;2;2;0;100;0;187000;1331.5;139.5
80328;2023;11;11;0;100;0;135354.545454545;1879.54545454545;72.4545454545455
80329;2023;4;4;0;100;0;127362.5;1135.5;109.5
80330;2023;4;4;0;100;0;81750;989.75;81.5
80331;2023;5;5;0;100;0;129360;1402.2;91.8
80332;2023;5;5;0;100;0;152283.6;1708;89
80333;2023;132;52;80;39.3939393939394;60.6060606060606;199013.295454545;4078.04545454545;49.9090909090909
80336;2023;1;1;0;100;0;28000;1000;28
80337;2023;2;2;0;100;0;124025;1585;77.5
80338;2023;30;26;4;86.6666666666667;13.3333333333333;136023.833333333;1586.86666666667;84.0666666666667
80339;2023;2;2;0;100;0;202000;1289;156
80340;2023;1;1;0;100;0;126000;1385;91
80341;2023;2;2;0;100;0;206665;2598;82
80342;2023;5;5;0;100;0;73000;924.2;80.8
80343;2023;1;1;0;100;0;142000;1632;87
80344;2023;3;3;0;100;0;139666.666666667;1124;115.333333333333
80345;2023;5;5;0;100;0;204900;1820.8;104
80346;2023;1;1;0;100;0;172900;1662;104
80347;2023;2;2;0;100;0;152000;1454;105
80348;2023;1;1;0;100;0;40000;548;73
80349;2023;1;1;0;100;0;235000;1506;156
80350;2023;4;4;0;100;0;250022.5;2302;106.5
80351;2023;4;4;0;100;0;143725;2070;71.75
80352;2023;2;2;0;100;0;124000;1405;88
80353;2023;1;1;0;100;0;1200000;10256;117
80354;2023;5;5;0;100;0;134179.4;1403.4;86.4
80355;2023;1;1;0;100;0;107500;1414;76
80356;2023;5;5;0;100;0;108000;1265;88.4
80357;2023;2;2;0;100;0;261150;1750.5;150.5
80359;2023;3;3;0;100;0;231000;3076.33333333333;89.3333333333333
80360;2023;23;21;2;91.304347826087;8.69565217391304;104826.086956522;1472.26086956522;74.5652173913043
80361;2023;1;1;0;100;0;122500;1289;95
80362;2023;4;4;0;100;0;106500;1301;79
80364;2023;6;6;0;100;0;149082;1827.16666666667;82.6666666666667
80365;2023;2;2;0;100;0;227800;2197;108
80366;2023;7;7;0;100;0;159671.428571429;1563;108.428571428571
80367;2023;4;4;0;100;0;42000;1130.75;44.5
80368;2023;50;42;8;84;16;110013.42;1339.56;82.56
80369;2023;2;2;0;100;0;72000;934;74.5
80371;2023;1;1;0;100;0;90000;900;100
80372;2023;1;1;0;100;0;60000;822;73
80373;2023;37;37;0;100;0;84574.3243243243;1256.64864864865;67.6756756756757
80374;2023;4;4;0;100;0;147675;1548;94.75
80375;2023;2;2;0;100;0;99000;1176;90.5
80376;2023;10;10;0;100;0;203040;2079.9;97.9
80377;2023;5;5;0;100;0;72900;763.8;98.2
80379;2023;3;3;0;100;0;205290;2144.33333333333;96
80380;2023;4;4;0;100;0;133750;1420.25;98.25
80381;2023;1;1;0;100;0;155000;1033;150
80384;2023;6;6;0;100;0;95283.3333333333;1277.66666666667;73.6666666666667
80385;2023;3;3;0;100;0;207290;2808.66666666667;77.3333333333333
80386;2023;3;3;0;100;0;196783.333333333;1616.66666666667;122
80387;2023;2;2;0;100;0;347500;2471;140
80388;2023;1;1;0;100;0;45000;405;111
80390;2023;5;5;0;100;0;120500;1245.6;96.4
80392;2023;9;9;0;100;0;120967.777777778;1354.88888888889;100
80393;2023;7;7;0;100;0;180001.428571429;1493.71428571429;117
80395;2023;4;4;0;100;0;114500;1441.5;87
80396;2023;3;3;0;100;0;130000;2026.66666666667;85
80399;2023;2;2;0;100;0;223000;2105.5;101
80400;2023;7;7;0;100;0;117828.571428571;1543.42857142857;76.2857142857143
80401;2023;4;4;0;100;0;131550;909.25;141.25
80404;2023;2;2;0;100;0;48000;1544;36.5
80405;2023;4;4;0;100;0;241300;1966;120.75
80406;2023;10;10;0;100;0;125230;1482.6;81.9
80407;2023;4;4;0;100;0;127437.5;1406.5;84.5
80408;2023;5;5;0;100;0;150768;1374.6;104
80409;2023;2;2;0;100;0;157650;1117;143
80410;2023;52;48;4;92.3076923076923;7.69230769230769;163132;1364.55769230769;89
80411;2023;4;4;0;100;0;135750;1364.25;94
80412;2023;5;5;0;100;0;269728;1695.6;166.8
80414;2023;1;1;0;100;0;163800;2374;69
80415;2023;13;13;0;100;0;169498.461538462;1678.61538461538;103.615384615385
80416;2023;14;14;0;100;0;137635;1286.5;103.214285714286
80417;2023;15;15;0;100;0;84934;1121.66666666667;75.4666666666667
80420;2023;1;1;0;100;0;70000;778;90
80421;2023;3;3;0;100;0;133000;1113.66666666667;107
80423;2023;3;3;0;100;0;210433.333333333;1844.33333333333;118
80424;2023;7;7;0;100;0;279050;2161;138
80426;2023;3;3;0;100;0;113766.666666667;1536.66666666667;74.6666666666667
80427;2023;2;2;0;100;0;150700;1344;113
80428;2023;1;1;0;100;0;64000;1455;44
80429;2023;1;1;0;100;0;181000;1574;115
80430;2023;1;1;0;100;0;1,00E+05;1053;95
80431;2023;4;4;0;100;0;236150;2037;122.25
80434;2023;4;4;0;100;0;96350;928;102.75
80435;2023;1;1;0;100;0;62000;705;88
80436;2023;7;7;0;100;0;108428.428571429;1370.71428571429;83.5714285714286
80437;2023;2;2;0;100;0;163500;1513.5;105
80438;2023;4;4;0;100;0;94000;1028.25;87.5
80439;2023;1;1;0;100;0;45300;871;52
80440;2023;5;5;0;100;0;107170;1285.8;79
80442;2023;12;12;0;100;0;105275;1080;104.916666666667
80443;2023;21;21;0;100;0;127480.047619048;1385.2380952381;90.1428571428571
80444;2023;7;7;0;100;0;192014.285714286;1770.14285714286;110.571428571429
80445;2023;3;3;0;100;0;230366.666666667;1794;127.333333333333
80446;2023;12;12;0;100;0;192958.333333333;1547.75;135.083333333333
80450;2023;2;2;0;100;0;107500;1392.5;76.5
80451;2023;3;3;0;100;0;86333.3333333333;3241.66666666667;56
80452;2023;2;2;0;100;0;177425;1707;80
80456;2023;2;2;0;100;0;210000;1117;175.5
80458;2023;6;6;0;100;0;249541.666666667;2343.5;109.833333333333
80460;2023;2;2;0;100;0;77500;829.5;94
80461;2023;2;2;0;100;0;210925;2373.5;86.5
80462;2023;5;5;0;100;0;154460;1442.6;110.4
80463;2023;9;9;0;100;0;213291.111111111;1900;125
80464;2023;5;5;0;100;0;135900;1923.2;76.4
80465;2023;3;3;0;100;0;121663.333333333;1230.66666666667;96.3333333333333
80466;2023;1;1;0;100;0;71500;737;97
80467;2023;1;1;0;100;0;170000;739;230
80468;2023;1;1;0;100;0;184400;1676;110
80469;2023;1;1;0;100;0;133000;1167;114
80470;2023;2;2;0;100;0;115706;1053;100.5
80472;2023;4;4;0;100;0;84625;912.25;84.25
80473;2023;3;3;0;100;0;169116.666666667;1954.33333333333;88.3333333333333
80474;2023;1;1;0;100;0;158000;1837;86
80475;2023;6;6;0;100;0;90950;1112.16666666667;88
80476;2023;3;3;0;100;0;127833.333333333;1725;75.3333333333333
80477;2023;3;3;0;100;0;161333.333333333;1780.33333333333;89.6666666666667
80478;2023;2;2;0;100;0;183500;2076.5;92.5
80479;2023;5;5;0;100;0;201920;1746.2;138.4
80481;2023;5;5;0;100;0;97320;1066.8;91.4
80482;2023;1;1;0;100;0;81500;1254;65
80484;2023;5;5;0;100;0;168220;1400;148.8
80485;2023;4;4;0;100;0;213375;1725.5;119.25
80486;2023;4;4;0;100;0;81250;1066.75;82.25
80487;2023;1;1;0;100;0;22000;759;29
80488;2023;25;24;1;96;4;103700;1710.28;66.56
80489;2023;36;28;8;77.7777777777778;22.2222222222222;195990.694444444;2320.25;85.3055555555556
80490;2023;2;2;0;100;0;121500;1276.5;92
80493;2023;2;2;0;100;0;61400;718.5;85
80494;2023;1;1;0;100;0;167200;1393;120
80495;2023;4;4;0;100;0;95312.5;906;102.75
80496;2023;3;3;0;100;0;155000;1561.33333333333;100.333333333333
80497;2023;2;2;0;100;0;129250;1830.5;71
80498;2023;6;6;0;100;0;86250;1025.16666666667;85.1666666666667
80499;2023;2;2;0;100;0;181500;1825;99
80500;2023;4;4;0;100;0;132657.5;1282.5;101.5
80501;2023;2;2;0;100;0;110750;1377;81
80502;2023;1;1;0;100;0;135000;944;143
80503;2023;4;4;0;100;0;130255;1461;92.75
80504;2023;1;1;0;100;0;1,00E+05;926;108
80505;2023;4;4;0;100;0;159125;1448.5;105.5
80507;2023;19;19;0;100;0;172199.894736842;1776.89473684211;97.3684210526316
80509;2023;6;6;0;100;0;94681.6666666667;1042.83333333333;91.3333333333333
80512;2023;13;13;0;100;0;170869.230769231;1913.61538461538;96.5384615384615
80513;2023;3;3;0;100;0;154500;1580;100
80514;2023;1;1;0;100;0;70000;593;118
80515;2023;1;1;0;100;0;55000;1000;55
80516;2023;1;1;0;100;0;97000;758;128
80518;2023;4;4;0;100;0;137397.5;1383.75;92.75
80519;2023;10;10;0;100;0;97200;939.4;96.2
80520;2023;2;2;0;100;0;266850;2546;115
80523;2023;11;11;0;100;0;156872.727272727;1563.27272727273;97.9090909090909
80524;2023;4;4;0;100;0;164312.5;1381.25;125.5
80525;2023;4;4;0;100;0;120750;1785.5;74.5
80526;2023;1;1;0;100;0;85000;1133;75
80529;2023;1;1;0;100;0;65000;485;134
80530;2023;8;8;0;100;0;193362.5;1519.5;127.625
80533;2023;93;49;44;52.6881720430108;47.3118279569892;150083.419354839;2665.27956989247;61.1290322580645
80535;2023;2;2;0;100;0;152950;1249.5;117
80536;2023;1;1;0;100;0;160000;1951;82
80537;2023;1;1;0;100;0;135000;1824;74
80538;2023;3;3;0;100;0;53500;598.666666666667;90
80540;2023;2;2;0;100;0;81000;1164;66.5
80542;2023;3;3;0;100;0;113666.666666667;1262.66666666667;85
80544;2023;2;2;0;100;0;85000;998;88
80545;2023;4;4;0;100;0;146822.5;1827.5;81.5
80546;2023;4;4;0;100;0;114750;1326.25;73
80547;2023;2;2;0;100;0;130500;1143;106
80548;2023;3;3;0;100;0;181843.333333333;1962.66666666667;94
80549;2023;5;5;0;100;0;129100;1374;94.4
80550;2023;2;2;0;100;0;191050;1578.5;128
80552;2023;19;19;0;100;0;105171.052631579;1399.73684210526;74.1578947368421
80553;2023;2;2;0;100;0;178000;1779;108.5
80554;2023;10;10;0;100;0;208160;1570.3;134.6
80555;2023;7;7;0;100;0;167542.857142857;1303.71428571429;140
80556;2023;6;6;0;100;0;120250;1505.66666666667;81.1666666666667
80557;2023;8;8;0;100;0;202487.5;1576.25;127.5
80558;2023;3;3;0;100;0;192087.333333333;1291;158.666666666667
80559;2023;3;3;0;100;0;170666.666666667;1858.66666666667;93.6666666666667
80560;2023;3;3;0;100;0;135966.666666667;1296.33333333333;107.666666666667
80561;2023;45;42;3;93.3333333333333;6.66666666666667;128075.533333333;1442.4;93.3333333333333
80563;2023;1;1;0;100;0;140000;1842;76
80566;2023;4;4;0;100;0;78625;1019.25;82
80568;2023;3;3;0;100;0;171483.333333333;1347;130.666666666667
80569;2023;4;4;0;100;0;136375;1425.25;98
80570;2023;44;43;1;97.7272727272727;2.27272727272727;158038.659090909;1815.61363636364;93
80571;2023;5;5;0;100;0;113700;1378.8;78
80572;2023;4;4;0;100;0;113370;1412.75;79
80573;2023;5;5;0;100;0;89280;1131;89.6
80576;2023;1;1;0;100;0;111200;741;150
80578;2023;6;6;0;100;0;158816.666666667;1810.16666666667;84.3333333333333
80579;2023;5;5;0;100;0;84360;939;92
80580;2023;3;3;0;100;0;150000;1574.66666666667;84.6666666666667
80582;2023;12;12;0;100;0;125361.5;1533.25;79
80583;2023;3;3;0;100;0;237500;1948.33333333333;124.333333333333
80584;2023;10;10;0;100;0;181245;2027;93.9
80585;2023;22;22;0;100;0;122366.136363636;1184.81818181818;108.636363636364
80588;2023;4;4;0;100;0;140625;1624.75;88.25
80589;2023;1;1;0;100;0;40000;494;81
80590;2023;5;5;0;100;0;229620;2082;109
80591;2023;2;2;0;100;0;115000;971.5;107
80592;2023;4;4;0;100;0;77025;1003.25;76.25
80593;2023;4;4;0;100;0;100262.5;1453.75;68
80595;2023;2;2;0;100;0;172000;2191.5;78.5
80596;2023;3;3;0;100;0;154250;1530.33333333333;101.666666666667
80597;2023;6;6;0;100;0;142166.666666667;1697.66666666667;84.3333333333333
80598;2023;14;14;0;100;0;187439.285714286;1722.64285714286;119.928571428571
80599;2023;1;1;0;100;0;157000;1121;140
80600;2023;12;12;0;100;0;238856.5;2983.58333333333;86.3333333333333
80601;2023;6;6;0;100;0;151234.5;1505.66666666667;99.1666666666667
80602;2023;1;1;0;100;0;150000;1351;111
80603;2023;4;4;0;100;0;206587.5;1997.5;113.75
80605;2023;1;1;0;100;0;67000;684;98
80606;2023;7;6;1;85.7142857142857;14.2857142857143;92755.5714285714;1095.28571428571;85
80609;2023;2;2;0;100;0;135000;5006;49
80611;2023;9;8;1;88.8888888888889;11.1111111111111;229650;2676;84.1111111111111
80613;2023;10;10;0;100;0;157725;2166.6;71.6
80614;2023;3;3;0;100;0;127266.666666667;1532.33333333333;82.3333333333333
80615;2023;7;7;0;100;0;196400;1778;116.571428571429
80616;2023;2;2;0;100;0;71000;930.5;80
80617;2023;4;4;0;100;0;188037.5;1733;114.5
80618;2023;10;10;0;100;0;181235;2104.5;106.5
80619;2023;10;10;0;100;0;151290;1402.6;105.4
80620;2023;63;54;9;85.7142857142857;14.2857142857143;122775.253968254;1464.66666666667;87.3174603174603
80621;2023;8;8;0;100;0;105557.5;967.875;112.875
80622;2023;16;16;0;100;0;143374.375;1546.5625;93.0625
80623;2023;5;5;0;100;0;167520;1819.4;102.6
80624;2023;1;1;0;100;0;208850;2088;100
80625;2023;13;13;0;100;0;145229.230769231;1595.76923076923;99.3076923076923
80626;2023;6;6;0;100;0;231150;2221.83333333333;106
80627;2023;7;7;0;100;0;264300;2790;100.285714285714
80628;2023;8;8;0;100;0;142700;1770;81
80629;2023;1;1;0;100;0;55000;743;74
80630;2023;7;7;0;100;0;177700;1647.85714285714;107
80631;2023;3;3;0;100;0;133333.333333333;1460;88
80632;2023;24;16;8;66.6666666666667;33.3333333333333;207384.583333333;2688.875;79.875
80633;2023;8;8;0;100;0;269500;2599.875;110.375
80634;2023;3;3;0;100;0;151541.666666667;1542;96.6666666666667
80635;2023;23;23;0;100;0;166541.086956522;1613.34782608696;105.782608695652
80637;2023;2;2;0;100;0;216500;2398.5;90.5
80639;2023;10;10;0;100;0;228955;2550.5;89.6
80640;2023;3;3;0;100;0;141466.666666667;1478.33333333333;93.6666666666667
80642;2023;1;1;0;100;0;149000;1910;78
80643;2023;6;6;0;100;0;236033.333333333;2379.5;104.5
80644;2023;10;10;0;100;0;135382.9;1592;82.9
80645;2023;4;4;0;100;0;142250;2163;72.5
80646;2023;1;1;0;100;0;51000;481;106
80647;2023;4;4;0;100;0;125987.5;1320;94
80648;2023;1;1;0;100;0;185000;2011;92
80649;2023;78;55;23;70.5128205128205;29.4871794871795;205348.820512821;3359.14102564103;64.9358974358974
80650;2023;1;1;0;100;0;197400;2269;87
80651;2023;5;5;0;100;0;98552;1198.2;84.2
80652;2023;4;4;0;100;0;120000;1450.75;85.25
80654;2023;2;2;0;100;0;191250;2019.5;95.5
80655;2023;2;2;0;100;0;114500;979.5;121.5
80656;2023;8;7;1;87.5;12.5;138418.75;1462;116.5
80657;2023;3;3;0;100;0;186050;1627.66666666667;121
80658;2023;2;2;0;100;0;1,00E+05;913.5;109.5
80661;2023;8;8;0;100;0;287617.5;2253.625;131.625
80662;2023;1;1;0;100;0;155300;1399;111
80663;2023;3;3;0;100;0;101333.333333333;1643;63.3333333333333
80664;2023;3;3;0;100;0;138966.666666667;1174.66666666667;122.333333333333
80665;2023;2;2;0;100;0;225000;1768.5;122
80667;2023;1;1;0;100;0;60000;750;80
80668;2023;1;1;0;100;0;310700;5011;62
80669;2023;1;1;0;100;0;55000;625;88
80670;2023;4;4;0;100;0;267581.25;2195.75;120.25
80671;2023;2;2;0;100;0;186055;1673;129
80672;2023;4;4;0;100;0;185250;1649.5;121.5
80673;2023;4;4;0;100;0;122300;1337.25;93.5
80674;2023;49;47;2;95.9183673469388;4.08163265306122;214848.163265306;2524.12244897959;84.469387755102
80676;2023;2;2;0;100;0;151000;1716.5;87
80677;2023;18;18;0;100;0;100923.055555556;1249.22222222222;89.1111111111111
80678;2023;5;5;0;100;0;102000;1467;73.2
80679;2023;11;11;0;100;0;84049.3636363636;857.454545454545;101.909090909091
80680;2023;22;22;0;100;0;128266.181818182;1459;92.5
80682;2023;4;4;0;100;0;144425;1445;108
80683;2023;3;3;0;100;0;103500;1162.66666666667;89
80685;2023;59;48;11;81.3559322033898;18.6440677966102;107123.728813559;1463.86440677966;76.3389830508475
80686;2023;6;6;0;100;0;250985;2052.33333333333;118.333333333333
80687;2023;1;1;0;100;0;110000;2245;49
80688;2023;23;23;0;100;0;167742.608695652;2032.5652173913;85.5217391304348
80690;2023;5;5;0;100;0;293310;2220.8;130.8
80691;2023;6;6;0;100;0;137125;2507.66666666667;64
80692;2023;7;7;0;100;0;176908.571428571;2150.71428571429;78.2857142857143
80693;2023;6;6;0;100;0;129310;1281.33333333333;104.666666666667
80694;2023;6;6;0;100;0;179575;1260.5;138.5
80695;2023;1;1;0;100;0;87300;1431;61
80696;2023;14;14;0;100;0;323385.714285714;2634.28571428571;114.785714285714
80698;2023;2;2;0;100;0;51250;525;95.5
80699;2023;1;1;0;100;0;136500;1422;96
80700;2023;5;5;0;100;0;121800;1296.2;95.2
80701;2023;4;4;0;100;0;180944.5;1320.5;126.75
80702;2023;15;13;2;86.6666666666667;13.3333333333333;485980;3141.06666666667;147.266666666667
80703;2023;2;2;0;100;0;66000;1156;59
80704;2023;5;5;0;100;0;116260;1239;99.6
80706;2023;13;13;0;100;0;101312;1129.61538461538;91
80707;2023;1;1;0;100;0;269300;1122;240
80708;2023;2;2;0;100;0;156325.5;1558;104.5
80709;2023;2;2;0;100;0;112500;1637.5;65.5
80710;2023;2;2;0;100;0;120275;1503;80
80711;2023;20;19;1;95;5;82624.5;1246.25;71.35
80713;2023;5;5;0;100;0;427400;5894.8;84.6
80714;2023;16;15;1;93.75;6.25;197061.875;2187.5;93
80716;2023;6;6;0;100;0;152233.333333333;1460.66666666667;101.166666666667
80717;2023;7;7;0;100;0;181214.285714286;1987.71428571429;92.7142857142857
80718;2023;11;11;0;100;0;176422.727272727;1955.45454545455;93
80719;2023;1;1;0;100;0;121710;729;167
80721;2023;48;43;5;89.5833333333333;10.4166666666667;248426.229166667;3886.95833333333;67.6666666666667
80722;2023;2;2;0;100;0;164600;1834.5;91
80723;2023;1;1;0;100;0;60000;923;65
80724;2023;11;11;0;100;0;260530;2625.27272727273;100.090909090909
80725;2023;48;25;23;52.0833333333333;47.9166666666667;217716.229166667;2458.1875;87.4375
80726;2023;2;2;0;100;0;90000;914.5;103
80728;2023;1;1;0;100;0;164200;1955;84
80730;2023;13;13;0;100;0;271920.615384615;2598.46153846154;105.230769230769
80732;2023;10;10;0;100;0;128076;1475;83.7
80733;2023;2;2;0;100;0;210500;1893;110.5
80734;2023;5;5;0;100;0;126000;1387.4;101
80735;2023;2;2;0;100;0;239000;2465;97
80737;2023;4;4;0;100;0;65750;986.5;71
80740;2023;4;4;0;100;0;164250;1888;93.25
80741;2023;1;1;0;100;0;160428;1458;110
80743;2023;2;2;0;100;0;100500;1530;65.5
80746;2023;10;10;0;100;0;241610;1997.8;126.9
80747;2023;1;1;0;100;0;42500;904;47
80748;2023;2;2;0;100;0;113750;1405.5;83.5
80749;2023;2;2;0;100;0;126425;1300;97
80751;2023;3;3;0;100;0;202333.333333333;1623;122.333333333333
80752;2023;3;3;0;100;0;370753;2695.66666666667;138
80754;2023;3;3;0;100;0;147666.666666667;1978.33333333333;76
80755;2023;1;1;0;100;0;193500;1248;155
80756;2023;1;1;0;100;0;75000;652;115
80758;2023;1;1;0;100;0;150000;1339;112
80759;2023;5;5;0;100;0;102700;1554.8;66.6
80760;2023;4;4;0;100;0;100750;1526.75;65.75
80762;2023;2;2;0;100;0;83800;1000;75
80763;2023;4;4;0;100;0;169625;1806.25;99
80764;2023;4;4;0;100;0;113825;1717.75;67.25
80765;2023;7;7;0;100;0;139463.428571429;1604.42857142857;88
80766;2023;6;6;0;100;0;126512.5;1559.16666666667;80
80767;2023;1;1;0;100;0;88000;1173;75
80769;2023;2;2;0;100;0;201673;2558;80.5
80770;2023;4;4;0;100;0;92250;1333;67.75
80775;2023;5;5;0;100;0;143560;1699.2;87.8
80776;2023;2;2;0;100;0;193500;1560.5;136
80777;2023;1;1;0;100;0;142000;1732;82
80778;2023;1;1;0;100;0;205000;1444;142
80779;2023;11;11;0;100;0;193532.727272727;2023.09090909091;104.363636363636
80780;2023;1;1;0;100;0;65000;1226;53
80781;2023;1;1;0;100;0;164000;2050;80
80782;2023;5;5;0;100;0;237570;2251.4;101
80784;2023;1;1;0;100;0;50000;746;67
80785;2023;6;6;0;100;0;206500;1999.5;104.5
80786;2023;1;1;0;100;0;215300;2175;99
80789;2023;1;1;0;100;0;132400;1034;128
80791;2023;7;7;0;100;0;285435.714285714;2724.42857142857;108.857142857143
80792;2023;1;1;0;100;0;119000;832;143
80793;2023;21;20;1;95.2380952380952;4.76190476190476;148703.571428571;1570.04761904762;96.6190476190476
80795;2023;4;4;0;100;0;108625;1387.5;79
80797;2023;1;1;0;100;0;220000;1375;160
80798;2023;16;16;0;100;0;279493.75;2098.8125;124.4375
80799;2023;42;41;1;97.6190476190476;2.38095238095238;181543.80952381;2273.61904761905;86.4285714285714
80800;2023;2;2;0;100;0;81735;1476.5;62.5
80801;2023;5;5;0;100;0;128103.2;1075.8;110
80802;2023;6;6;0;100;0;90166.6666666667;986.5;92.6666666666667
80803;2023;1;1;0;100;0;1,00E+05;1333;75
80804;2023;1;1;0;100;0;244700;1989;123
80806;2023;7;7;0;100;0;348142.857142857;3857.71428571429;78.2857142857143
80807;2023;4;4;0;100;0;142125;1828.5;84.25
80808;2023;4;4;0;100;0;261758.25;2430.5;106.75
80809;2023;1;1;0;100;0;123000;898;137
80810;2023;2;2;0;100;0;65000;1091;59
80811;2023;3;3;0;100;0;97000;819;117
80814;2023;2;2;0;100;0;170000;1666.5;100
80815;2023;7;7;0;100;0;121143.857142857;1433.28571428571;93
80819;2023;1;1;0;100;0;127000;1764;72
80820;2023;8;8;0;100;0;173523;1546.375;110
80821;2023;4;4;0;100;0;92500;1009.5;90.25
80822;2023;1;1;0;100;0;136000;2092;65
80823;2023;1;1;0;100;0;59150;883;67
80824;2023;3;3;0;100;0;143100;1534.33333333333;90.3333333333333
80826;2023;13;12;1;92.3076923076923;7.69230769230769;167866.153846154;2404.30769230769;72.5384615384615
80827;2023;13;13;0;100;0;200831.384615385;2693.92307692308;85
80828;2023;1;1;0;100;0;65500;851;77
80829;2023;2;2;0;100;0;50000;651;81
80830;2023;1;1;0;100;0;295500;1572;188
80832;2023;3;3;0;100;0;129937.333333333;1373.66666666667;101.333333333333
80833;2023;2;2;0;100;0;55000;938;55.5
80834;2023;3;3;0;100;0;78100;1231;64.3333333333333
80836;2023;1;1;0;100;0;182500;1659;110
81001;2023;3;3;0;100;0;287800;1956.33333333333;139.333333333333
81002;2023;31;31;0;100;0;137399.838709677;1471.64516129032;92.5161290322581
81003;2023;13;13;0;100;0;175993.153846154;1455.53846153846;117.153846153846
81004;2023;706;405;301;57.3654390934844;42.6345609065156;184682.407932011;2324.06940509915;84.71388101983
81005;2023;7;7;0;100;0;108585.571428571;1203.28571428571;88.7142857142857
81006;2023;1;1;0;100;0;71900;2397;30
81010;2023;5;5;0;100;0;105600;1151.4;90.4
81011;2023;11;11;0;100;0;339174.545454545;2012.27272727273;161.545454545455
81012;2023;2;2;0;100;0;228025;2035;109.5
81013;2023;4;4;0;100;0;160775.5;1618;101
81014;2023;17;16;1;94.1176470588235;5.88235294117647;148632.941176471;1918.82352941176;85.6470588235294
81015;2023;2;2;0;100;0;282500;2290.5;120
81016;2023;6;6;0;100;0;80181.6666666667;1052.5;76.6666666666667
81017;2023;2;2;0;100;0;105300;2247.5;47
81018;2023;14;14;0;100;0;208389.285714286;2022.35714285714;103.571428571429
81020;2023;1;1;0;100;0;185000;1850;100
81021;2023;59;59;0;100;0;142276.101694915;1386.59322033898;102.796610169492
81022;2023;2;2;0;100;0;270000;1096.5;269.5
81023;2023;5;5;0;100;0;47796;664.6;73.8
81024;2023;3;3;0;100;0;175500;1701.33333333333;94.6666666666667
81026;2023;8;7;1;87.5;12.5;189250;1762.75;115.125
81027;2023;1;1;0;100;0;228575;1644;139
81028;2023;2;2;0;100;0;156000;2261.5;81.5
81030;2023;2;2;0;100;0;265650;2260.5;117.5
81031;2023;6;6;0;100;0;103683.333333333;1100;99.6666666666667
81032;2023;2;2;0;100;0;237650;2218;107.5
81033;2023;29;29;0;100;0;133124.137931034;1431.93103448276;96.6551724137931
81034;2023;5;5;0;100;0;58074;1050;64.2
81035;2023;5;5;0;100;0;312322.4;1922.2;173
81036;2023;10;10;0;100;0;156855;1375.6;110.7
81037;2023;16;15;1;93.75;6.25;116864.375;1173.75;107.875
81038;2023;22;22;0;100;0;241465.909090909;2253.95454545455;110.136363636364
81039;2023;20;19;1;95;5;188111;1842.1;111.3
81040;2023;5;5;0;100;0;239622;1585.4;143
81041;2023;1;1;0;100;0;210000;1050;200
81042;2023;25;25;0;100;0;198750.6;1896.76;104.6
81043;2023;9;9;0;100;0;191944.444444444;1798;111.444444444444
81044;2023;2;2;0;100;0;280037;1860;151
81045;2023;6;6;0;100;0;220537.5;1387.16666666667;179.5
81046;2023;8;8;0;100;0;201000;1771.25;105.875
81047;2023;5;5;0;100;0;103796;1149;96.4
81048;2023;25;23;2;92;8;145476.44;1624.32;91.48
81049;2023;2;2;0;100;0;130000;1411;78
81050;2023;2;2;0;100;0;264300;1676.5;164
81051;2023;12;11;1;91.6666666666667;8.33333333333333;279152.833333333;1947.83333333333;131
81052;2023;16;16;0;100;0;242750;2339.25;105.9375
81053;2023;3;3;0;100;0;77333.3333333333;911.666666666667;85
81054;2023;8;8;0;100;0;164493.75;1574.5;107.25
81055;2023;8;8;0;100;0;125797.5;1474.75;87.625
81059;2023;5;5;0;100;0;240518;2073.8;121
81060;2023;121;111;10;91.7355371900827;8.26446280991736;121690.223140496;1314.69421487603;94.7272727272727
81061;2023;2;2;0;100;0;292125;2812;117
81062;2023;17;17;0;100;0;87227.0588235294;1240.94117647059;77.8823529411765
81063;2023;13;13;0;100;0;219639.230769231;1914.53846153846;119.153846153846
81064;2023;15;13;2;86.6666666666667;13.3333333333333;186186;1902.93333333333;103.266666666667
81065;2023;543;372;171;68.5082872928177;31.4917127071823;158515.813996317;1756.43093922652;91.3977900552486
81066;2023;3;3;0;100;0;140266.666666667;1716;86.6666666666667
81067;2023;5;5;0;100;0;319778.8;1599;206.4
81068;2023;2;2;0;100;0;407000;1747.5;230.5
81069;2023;9;7;2;77.7777777777778;22.2222222222222;107832.222222222;1480.77777777778;74.3333333333333
81070;2023;37;37;0;100;0;302681.486486487;2442.18918918919;127.27027027027
81071;2023;1;1;0;100;0;36904;615;60
81072;2023;3;2;1;66.6666666666667;33.3333333333333;95000;1049;115
81073;2023;3;3;0;100;0;166666.666666667;2545.66666666667;77
81074;2023;12;12;0;100;0;249211.083333333;1916.75;120.583333333333
81075;2023;5;5;0;100;0;213740;1626.6;144.8
81076;2023;4;4;0;100;0;197000;2246;97.75
81077;2023;6;6;0;100;0;146100;1687.66666666667;103.833333333333
81078;2023;10;10;0;100;0;203650;1947;104.4
81079;2023;6;6;0;100;0;152090;1772.16666666667;92.3333333333333
81081;2023;9;9;0;100;0;146045.555555556;1318.88888888889;114.333333333333
81083;2023;3;3;0;100;0;236954.333333333;2063.33333333333;129.333333333333
81084;2023;9;9;0;100;0;183572.222222222;1527.55555555556;126.666666666667
81085;2023;1;1;0;100;0;47645;596;80
81086;2023;2;2;0;100;0;40000;486;81
81087;2023;1;1;0;100;0;231300;2628;88
81088;2023;7;7;0;100;0;223911.428571429;2285.28571428571;100
81089;2023;1;1;0;100;0;110950;822;135
81092;2023;9;9;0;100;0;234909.888888889;2367.66666666667;96.5555555555556
81093;2023;6;6;0;100;0;228533.333333333;2344.33333333333;112
81094;2023;1;1;0;100;0;95000;1118;85
81095;2023;1;1;0;100;0;197000;2239;88
81096;2023;9;9;0;100;0;82250;897.555555555556;94
81097;2023;8;8;0;100;0;200178.75;1893.25;101.625
81098;2023;1;1;0;100;0;283500;2577;110
81099;2023;193;143;50;74.0932642487047;25.9067357512953;182457.279792746;2082.88082901554;89.4041450777202
81101;2023;10;10;0;100;0;188375;1882.8;102
81102;2023;2;2;0;100;0;293222.5;2738.5;109
81103;2023;3;3;0;100;0;55585;702;79.6666666666667
81104;2023;15;15;0;100;0;320973;1984.8;170.466666666667
81105;2023;210;168;42;80;20;135432.00952381;1495.84285714286;94.6904761904762
81106;2023;5;5;0;100;0;257560;2142;111.4
81108;2023;1;1;0;100;0;211000;2221;95
81109;2023;4;4;0;100;0;147333;1573.25;88.5
81110;2023;1;1;0;100;0;128895;1572;82
81112;2023;17;17;0;100;0;190437.588235294;2024.47058823529;100.470588235294
81114;2023;5;5;0;100;0;191600;1764.8;119.2
81115;2023;30;29;1;96.6666666666667;3.33333333333333;75743.8333333333;992.266666666667;81.8
81116;2023;12;12;0;100;0;238178.166666667;2250.16666666667;108.25
81117;2023;10;10;0;100;0;245972.2;1776.3;141.3
81119;2023;7;6;1;85.7142857142857;14.2857142857143;158621.428571429;1554.28571428571;106.142857142857
81120;2023;81;72;9;88.8888888888889;11.1111111111111;159091.222222222;1655.93827160494;97.1234567901235
81121;2023;7;7;0;100;0;48550;801.571428571429;64.8571428571429
81122;2023;2;2;0;100;0;131300;1317;100
81124;2023;40;39;1;97.5;2.5;100534.475;1082.95;96.675
81125;2023;5;5;0;100;0;90592;1357.2;70
81128;2023;19;19;0;100;0;110235.105263158;1255;95.1052631578947
81129;2023;5;5;0;100;0;206947.8;1887.8;113.8
81130;2023;22;16;6;72.7272727272727;27.2727272727273;178526.681818182;1857.31818181818;93.5454545454545
81131;2023;16;16;0;100;0;220918.9375;2225.3125;101.0625
81132;2023;11;11;0;100;0;183818.181818182;1524.27272727273;121.727272727273
81133;2023;7;7;0;100;0;252698.571428571;2168.42857142857;119.285714285714
81134;2023;1;1;0;100;0;355200;4179;85
81135;2023;1;1;0;100;0;243000;2059;118
81136;2023;5;5;0;100;0;143790;1510.2;98.4
81137;2023;3;3;0;100;0;130333.333333333;1156;103.666666666667
81138;2023;6;6;0;100;0;142500;1276.5;119
81139;2023;8;8;0;100;0;184125;1986.625;92.125
81140;2023;135;99;36;73.3333333333333;26.6666666666667;212670.059259259;2254.82962962963;93.4518518518519
81142;2023;5;5;0;100;0;186375.2;1680;108.4
81143;2023;3;3;0;100;0;176362;1913.66666666667;98.6666666666667
81144;2023;28;27;1;96.4285714285714;3.57142857142857;183426.428571429;1904.46428571429;99.6785714285714
81145;2023;52;50;2;96.1538461538462;3.84615384615385;225777.019230769;2440.36538461538;96.7692307692308
81146;2023;2;2;0;100;0;414853.5;3995;105
81147;2023;4;4;0;100;0;183289.5;1307.75;175
81148;2023;1;1;0;100;0;120000;580;207
81149;2023;1;1;0;100;0;262750;2411;109
81150;2023;1;1;0;100;0;95000;1900;50
81152;2023;7;6;1;85.7142857142857;14.2857142857143;251948.571428571;2089.42857142857;120.285714285714
81154;2023;2;2;0;100;0;248500;1538.5;169.5
81156;2023;36;35;1;97.2222222222222;2.77777777777778;233713.083333333;2496;96.3055555555556
81157;2023;6;6;0;100;0;246583.333333333;1834.66666666667;136
81158;2023;4;4;0;100;0;87000;891.25;99
81159;2023;5;3;2;60;40;191010;1606.2;121.8
81160;2023;3;3;0;100;0;106666.666666667;1213.66666666667;87.3333333333333
81161;2023;1;1;0;100;0;175000;1400;125
81162;2023;2;2;0;100;0;170093.5;1750.5;97
81163;2023;155;118;37;76.1290322580645;23.8709677419355;122099.516129032;1304.02580645161;98.6516129032258
81164;2023;4;4;0;100;0;254386.25;2329.75;111.5
81165;2023;4;4;0;100;0;293132.75;1980.25;141.5
81167;2023;4;4;0;100;0;78242.5;1005;79.75
81168;2023;13;13;0;100;0;174069.230769231;1675.23076923077;109.692307692308
81170;2023;14;13;1;92.8571428571429;7.14285714285714;167746.428571429;1495.71428571429;113.428571428571
81171;2023;10;10;0;100;0;213397;1986.8;115.9
81172;2023;2;2;0;100;0;89000;932;77
81173;2023;2;2;0;100;0;593466.5;3545;176
81174;2023;3;3;0;100;0;156482;1438.33333333333;110.333333333333
81175;2023;4;4;0;100;0;197400;2178;96.75
81177;2023;5;5;0;100;0;340133.2;1864.8;171.4
81178;2023;8;8;0;100;0;272476.25;1826.625;167.875
81179;2023;5;5;0;100;0;287467;1774.8;149.8
81180;2023;4;4;0;100;0;182875;1566.25;112.75
81181;2023;2;2;0;100;0;258500;2170;122.5
81182;2023;21;21;0;100;0;120237.047619048;1057.61904761905;122.47619047619
81183;2023;2;2;0;100;0;202220;1767;157.5
81184;2023;1;1;0;100;0;160300;1705;94
81185;2023;3;3;0;100;0;308433.333333333;2579;120
81186;2023;5;5;0;100;0;114870;1300.6;83.8
81187;2023;1;1;0;100;0;270890;1977;137
81188;2023;4;4;0;100;0;86600;1566.75;50.75
81190;2023;5;5;0;100;0;259802;2200;118.4
81191;2023;3;3;0;100;0;293816.666666667;1344.33333333333;192
81192;2023;13;13;0;100;0;109878.076923077;1280.30769230769;86.6923076923077
81193;2023;16;14;2;87.5;12.5;144496.25;1830.625;80.625
81195;2023;10;9;1;90;10;312816.8;2313.9;127.3
81196;2023;10;10;0;100;0;146000.9;2157;72.6
81197;2023;2;2;0;100;0;267935;1681;162
81198;2023;2;2;0;100;0;243340;2425;100
81199;2023;5;5;0;100;0;88390;1087.4;100.4
81200;2023;3;3;0;100;0;206138.666666667;2176;102.666666666667
81201;2023;11;11;0;100;0;130915.454545455;1168.36363636364;109.727272727273
81202;2023;7;7;0;100;0;217454.285714286;1768.14285714286;127.285714285714
81203;2023;3;3;0;100;0;141281.333333333;989.333333333333;106.333333333333
81204;2023;18;18;0;100;0;161401.722222222;1502.83333333333;104.833333333333
81206;2023;12;12;0;100;0;171442.083333333;2153.33333333333;78.5
81207;2023;4;4;0;100;0;106340;1120;104
81208;2023;4;4;0;100;0;183850;2068.5;93.25
81209;2023;34;34;0;100;0;167867.264705882;1662.67647058824;98.3529411764706
81210;2023;2;2;0;100;0;83500;905;85.5
81211;2023;1;1;0;100;0;197000;1378;143
81212;2023;2;2;0;100;0;277500;1934;147.5
81213;2023;1;1;0;100;0;226500;2004;113
81214;2023;1;1;0;100;0;271900;2344;116
81215;2023;6;6;0;100;0;221975;2126.83333333333;108.333333333333
81216;2023;2;2;0;100;0;136500;1371.5;79
81217;2023;6;6;0;100;0;179750.666666667;1528.5;118.833333333333
81218;2023;29;29;0;100;0;296578.482758621;2407.55172413793;118.827586206897
81219;2023;34;34;0;100;0;171581.529411765;1743.26470588235;98.5588235294118
81220;2023;51;47;4;92.156862745098;7.84313725490196;227972.37254902;2238.60784313725;104.274509803922
81221;2023;4;4;0;100;0;113827.5;929.5;131.5
81222;2023;34;34;0;100;0;159496.382352941;1659.38235294118;94.5882352941177
81223;2023;5;5;0;100;0;148712;1358;106.2
81224;2023;3;3;0;100;0;121000;1407.66666666667;85.3333333333333
81225;2023;18;15;3;83.3333333333333;16.6666666666667;197424.944444444;2205.33333333333;88.5555555555556
81227;2023;32;31;1;96.875;3.125;142411.875;1581.0625;87.8125
81228;2023;3;3;0;100;0;256700;2253;118.666666666667
81229;2023;2;2;0;100;0;318875;1720.5;183.5
81230;2023;7;7;0;100;0;225757.142857143;1625.14285714286;139.428571428571
81231;2023;4;4;0;100;0;184062.5;1688.75;103.75
81232;2023;3;3;0;100;0;219400;2114.66666666667;115.666666666667
81233;2023;17;17;0;100;0;144350;1408.11764705882;108.588235294118
81234;2023;1;1;0;100;0;75418;656;115
81235;2023;3;3;0;100;0;142000;1634.66666666667;87.3333333333333
81236;2023;3;3;0;100;0;380266.666666667;2317.33333333333;151.666666666667
81237;2023;3;3;0;100;0;259911.333333333;1617.66666666667;189.666666666667
81238;2023;22;22;0;100;0;92849.7727272727;1157.27272727273;83.0454545454545
81239;2023;12;12;0;100;0;119208.333333333;1191;99.9166666666667
81240;2023;3;3;0;100;0;111666.666666667;2160.66666666667;73.6666666666667
81242;2023;2;2;0;100;0;85000;787;96.5
81243;2023;2;2;0;100;0;317770;1879.5;170
81244;2023;21;21;0;100;0;108723.952380952;1190.61904761905;91.3333333333333
81245;2023;2;2;0;100;0;171962;1131.5;147
81247;2023;4;4;0;100;0;194087.5;1533.5;129.25
81248;2023;9;9;0;100;0;258238.888888889;2183.44444444444;124.888888888889
81249;2023;9;9;0;100;0;145711.111111111;1466.11111111111;114.111111111111
81250;2023;3;3;0;100;0;408156.666666667;1701;219
81251;2023;9;9;0;100;0;271640.444444444;2195.66666666667;124.555555555556
81252;2023;2;2;0;100;0;207150;1690.5;130
81254;2023;4;4;0;100;0;227315;1598.5;161
81255;2023;5;5;0;100;0;354842;2504.8;140.6
81256;2023;1;1;0;100;0;1,00E+05;813;123
81257;2023;66;61;5;92.4242424242424;7.57575757575758;178436.545454545;1895.19696969697;98.4848484848485
81258;2023;5;5;0;100;0;232642.8;1896.8;122.8
81261;2023;7;7;0;100;0;463891.142857143;2564.28571428571;174.285714285714
81262;2023;2;2;0;100;0;308485;2569.5;123
81263;2023;2;2;0;100;0;149065;1490.5;104
81264;2023;3;3;0;100;0;113333.333333333;1062.66666666667;111.666666666667
81265;2023;2;2;0;100;0;197375;2132.5;99
81266;2023;9;9;0;100;0;168701.111111111;1682.66666666667;94
81267;2023;5;5;0;100;0;118648;1135.2;106.8
81268;2023;2;2;0;100;0;151750;2391.5;70
81269;2023;8;8;0;100;0;124128.75;1354.125;103.375
81270;2023;1;1;0;100;0;362563;2145;169
81271;2023;100;88;12;88;12;245946.27;2652.33;94.03
81272;2023;1;1;0;100;0;135000;1154;117
81273;2023;27;26;1;96.2962962962963;3.7037037037037;232943.62962963;2094.81481481481;110.037037037037
81274;2023;12;12;0;100;0;215760.25;2134.83333333333;102.833333333333
81275;2023;2;2;0;100;0;70000;735.5;95.5
81276;2023;17;17;0;100;0;212812.352941176;2010.41176470588;116.764705882353
81277;2023;4;4;0;100;0;226887.5;2129;112.25
81278;2023;2;2;0;100;0;80760;835.5;100.5
81279;2023;3;3;0;100;0;152156;1188.66666666667;121
81280;2023;5;5;0;100;0;151948;1526.2;99.6
81281;2023;28;28;0;100;0;201403.214285714;1769.64285714286;118.5
81283;2023;7;7;0;100;0;190478.571428571;1864.71428571429;96.8571428571429
81284;2023;15;13;2;86.6666666666667;13.3333333333333;192649.2;2292.26666666667;85.4
81285;2023;4;4;0;100;0;127250;1744.5;81.25
81286;2023;8;8;0;100;0;133410;1318.875;93.5
81287;2023;4;4;0;100;0;259875;1791.5;151.75
81288;2023;41;35;6;85.3658536585366;14.6341463414634;151191.756097561;1695.82926829268;89.0975609756098
81289;2023;27;27;0;100;0;201994.740740741;1864.03703703704;109.666666666667
81290;2023;3;3;0;100;0;155223.666666667;1417.33333333333;112.333333333333
81291;2023;7;7;0;100;0;165345.142857143;1828.28571428571;89.5714285714286
81292;2023;1;1;0;100;0;120000;545;220
81293;2023;3;3;0;100;0;266853.333333333;2685;99.3333333333333
81294;2023;14;14;0;100;0;203652.214285714;1733.78571428571;118.857142857143
81295;2023;1;1;0;100;0;32000;1000;32
81297;2023;13;13;0;100;0;286805;2406.46153846154;120.846153846154
81298;2023;3;3;0;100;0;362900;2440.33333333333;157.666666666667
81299;2023;4;4;0;100;0;247288.25;1805.75;135
81300;2023;1;1;0;100;0;677300;2206;307
81302;2023;2;2;0;100;0;82750;778.5;118.5
81303;2023;6;6;0;100;0;112000;1076;113
81304;2023;3;3;0;100;0;140666.666666667;1012;135
81305;2023;18;18;0;100;0;95248.0555555556;1000.38888888889;95.0555555555556
81306;2023;3;3;0;100;0;174458.333333333;1854.33333333333;96.6666666666667
81307;2023;9;9;0;100;0;131280.222222222;1300.11111111111;103.333333333333
81308;2023;9;8;1;88.8888888888889;11.1111111111111;173200;1643.88888888889;114.777777777778
81309;2023;4;4;0;100;0;185800.5;1757.75;106.5
81310;2023;1;1;0;100;0;303380;2136;142
81311;2023;3;3;0;100;0;112666.666666667;1187.33333333333;114
81312;2023;4;4;0;100;0;137526;1553;101.75
81313;2023;2;2;0;100;0;78750;1731;46.5
81314;2023;8;7;1;87.5;12.5;69906.25;1062.875;67.625
81315;2023;12;12;0;100;0;163645.833333333;1597.66666666667;107.833333333333
81316;2023;2;2;0;100;0;140000;1851;73.5
81317;2023;9;9;0;100;0;175797.777777778;1651.33333333333;107.666666666667
81318;2023;1;1;0;100;0;386400;3193;121
81319;2023;5;5;0;100;0;185040;1742.4;114.2
81320;2023;1;1;0;100;0;60000;800;75
81323;2023;7;7;0;100;0;253711.857142857;2021.28571428571;131.142857142857
81324;2023;1;1;0;100;0;390000;2216;176
81325;2023;11;10;1;90.9090909090909;9.09090909090909;168298.636363636;1589.45454545455;98.8181818181818
81326;2023;4;4;0;100;0;205475;2032.75;104.25
82001;2023;8;8;0;100;0;226684.5;2101.75;107.75
82002;2023;36;27;9;75;25;176377.944444444;1983.52777777778;86.3333333333333
82003;2023;4;4;0;100;0;311877.25;1540.25;206.25
82004;2023;1;1;0;100;0;115000;991;116
82005;2023;10;10;0;100;0;255368;2703.3;92.5
82006;2023;2;2;0;100;0;299750;1415;235
82007;2023;1;1;0;100;0;158000;1264;125
82008;2023;9;8;1;88.8888888888889;11.1111111111111;154332.222222222;1890;106.777777777778
82010;2023;4;4;0;100;0;247262.5;1664.75;143
82011;2023;8;8;0;100;0;180300;2039.75;91.375
82012;2023;2;2;0;100;0;227305;2033.5;111.5
82013;2023;62;62;0;100;0;126623.951612903;1348.61290322581;98.6451612903226
82014;2023;4;4;0;100;0;304350;2423.25;119.5
82015;2023;1;1;0;100;0;280050;2546;110
82016;2023;4;4;0;100;0;339256.75;1711.5;206.5
82017;2023;8;6;2;75;25;203261.25;2223.25;91
82018;2023;14;14;0;100;0;174402.857142857;1752.64285714286;105.071428571429
82019;2023;5;5;0;100;0;169344;1364.8;121.6
82020;2023;4;4;0;100;0;203650;2079.75;105.5
82021;2023;4;4;0;100;0;162675;1414.75;115
82022;2023;3;3;0;100;0;189000;1514.33333333333;125.666666666667
82023;2023;8;8;0;100;0;167100;1616.125;122.25
82024;2023;2;2;0;100;0;124000;1681;67.5
82025;2023;37;36;1;97.2972972972973;2.7027027027027;247933.675675676;2335.27027027027;108.108108108108
82026;2023;9;8;1;88.8888888888889;11.1111111111111;192576.222222222;1849.66666666667;123.777777777778
82027;2023;14;14;0;100;0;275180;2361.14285714286;117.785714285714
82028;2023;13;13;0;100;0;182446.692307692;2110;88.5384615384615
82029;2023;5;5;0;100;0;163330.6;2023.2;85
82030;2023;4;4;0;100;0;134750;1342.75;102.25
82031;2023;11;11;0;100;0;172595.454545455;1683.63636363636;110.363636363636
82032;2023;7;7;0;100;0;157478.571428571;1330.71428571429;118.857142857143
82033;2023;167;129;38;77.2455089820359;22.7544910179641;147637.51497006;1593.41916167665;95.6107784431138
82034;2023;4;4;0;100;0;133337.5;1165.25;128
82035;2023;4;4;0;100;0;170326.5;1457.5;138.75
82036;2023;1;1;0;100;0;216700;1141;190
82037;2023;94;73;21;77.6595744680851;22.3404255319149;149322.734042553;1729.95744680851;88.031914893617
82038;2023;32;31;1;96.875;3.125;146308.4375;1655.3125;90.53125
82039;2023;3;3;0;100;0;220900;2534;93.3333333333333
82040;2023;2;2;0;100;0;319450;2786;114.5
82041;2023;4;4;0;100;0;102500;1227.5;76.75
82042;2023;15;15;0;100;0;145581.2;1420.26666666667;109.733333333333
82043;2023;3;3;0;100;0;297357;2458;110
82044;2023;22;19;3;86.3636363636364;13.6363636363636;202030.5;2024.22727272727;101.636363636364
82045;2023;3;3;0;100;0;145833.333333333;1416.33333333333;99.3333333333333
82046;2023;2;2;0;100;0;142000;1812.5;76
82048;2023;28;24;4;85.7142857142857;14.2857142857143;205386.464285714;1975.46428571429;106.071428571429
82049;2023;6;6;0;100;0;194623.333333333;1704.66666666667;124.333333333333
82050;2023;11;11;0;100;0;172249.272727273;1499.27272727273;116.727272727273
82051;2023;6;5;1;83.3333333333333;16.6666666666667;193931.666666667;2223.16666666667;108.666666666667
82052;2023;12;12;0;100;0;212384.333333333;1953.16666666667;115
82054;2023;3;3;0;100;0;168033.333333333;1621.66666666667;101.666666666667
82055;2023;4;4;0;100;0;319740;2401;129.25
82056;2023;2;2;0;100;0;127500;1937.5;78
82057;2023;4;4;0;100;0;175687.5;1737;104.5
82058;2023;1;1;0;100;0;223600;2236;100
82059;2023;2;2;0;100;0;355000;1678.5;195
82060;2023;2;2;0;100;0;244350;3689;80
82061;2023;4;4;0;100;0;191602.5;2155;92.25
82062;2023;14;14;0;100;0;185535.714285714;2036.78571428571;94.5714285714286
82063;2023;11;11;0;100;0;161778.181818182;1364.36363636364;131
82064;2023;2;2;0;100;0;221760;3099;96.5
82065;2023;5;5;0;100;0;219140;1627;134.6
82066;2023;2;2;0;100;0;200550;1752.5;116.5
82068;2023;3;3;0;100;0;176550;1548.33333333333;113.333333333333
82069;2023;5;5;0;100;0;247000;2190.2;118.4
82072;2023;9;9;0;100;0;140533.333333333;1338.66666666667;106.444444444444
82073;2023;6;6;0;100;0;196835;2100.16666666667;101.166666666667
82074;2023;4;4;0;100;0;269529.5;1565.25;167.25
82075;2023;43;40;3;93.0232558139535;6.97674418604651;216836.76744186;2385.04651162791;92.5116279069767
82076;2023;17;17;0;100;0;189294.411764706;2050.29411764706;93.4705882352941
82077;2023;8;8;0;100;0;184943.125;1915.375;102.875
82079;2023;24;23;1;95.8333333333333;4.16666666666667;190619.416666667;2043.79166666667;98.125
82080;2023;9;9;0;100;0;182361.111111111;1818.77777777778;103.444444444444
82081;2023;2;2;0;100;0;119100;982.5;110.5
82082;2023;4;4;0;100;0;320067.5;2702;130.25
82083;2023;1;1;0;100;0;50000;625;80
82084;2023;6;6;0;100;0;273376.666666667;2505.83333333333;109.5
82085;2023;4;4;0;100;0;184775;1857.25;109.25
82086;2023;3;3;0;100;0;201670;1532.33333333333;121.666666666667
82087;2023;25;24;1;96;4;209111.6;1820.76;117.32
82088;2023;12;12;0;100;0;112333.333333333;1374.66666666667;100.916666666667
82089;2023;21;21;0;100;0;148595.238095238;1339.61904761905;121.190476190476
82090;2023;12;12;0;100;0;251254.583333333;2107.25;120.916666666667
82091;2023;1;1;0;100;0;198000;3300;60
82092;2023;2;2;0;100;0;239500;2175;109.5
82093;2023;2;2;0;100;0;238850;1878.5;134
82094;2023;32;32;0;100;0;138218.625;1464.875;104
82095;2023;1;1;0;100;0;179000;1721;104
82096;2023;48;42;6;87.5;12.5;186445.729166667;1876.60416666667;102.645833333333
82097;2023;7;7;0;100;0;119535.714285714;824.285714285714;146.285714285714
82098;2023;19;19;0;100;0;235052.368421053;2348.47368421053;100.105263157895
82099;2023;4;4;0;100;0;123750;1421.75;89.75
82100;2023;2;2;0;100;0;254600;2300;109
82101;2023;12;12;0;100;0;123922;1260.66666666667;106.833333333333
82102;2023;1;1;0;100;0;121000;605;200
82104;2023;2;2;0;100;0;183400;1306;141
82105;2023;18;17;1;94.4444444444444;5.55555555555556;148812.222222222;1444.38888888889;107.888888888889
82106;2023;1;1;0;100;0;120000;1765;68
82108;2023;13;13;0;100;0;226796.846153846;1988.92307692308;111.538461538462
82109;2023;2;2;0;100;0;98000;1084;99.5
82110;2023;4;4;0;100;0;142415.5;1728.25;79.25
82111;2023;6;6;0;100;0;116177.5;1066.66666666667;100.333333333333
82112;2023;149;121;28;81.2080536912752;18.7919463087248;137783.342281879;1506.48993288591;92.3087248322148
82113;2023;13;13;0;100;0;175628.615384615;1924.38461538462;97.8461538461538
82114;2023;9;9;0;100;0;233855.333333333;2174.88888888889;107.666666666667
82115;2023;32;32;0;100;0;166663.625;1691.21875;95.28125
82116;2023;2;2;0;100;0;433800;3243.5;125.5
82117;2023;28;27;1;96.4285714285714;3.57142857142857;230366.857142857;1903.35714285714;124.857142857143
82119;2023;5;5;0;100;0;295424;1580;163.2
82120;2023;1;1;0;100;0;50000;556;90
82121;2023;821;441;380;53.7149817295981;46.2850182704019;188119.987819732;2173.44214372716;86.6004872107186
82122;2023;2;2;0;100;0;186165;1885.5;101.5
82123;2023;13;13;0;100;0;184689.384615385;2238.92307692308;88.0769230769231
82124;2023;51;37;14;72.5490196078431;27.4509803921569;211776.058823529;2156.1568627451;99.4117647058823
82125;2023;63;56;7;88.8888888888889;11.1111111111111;197644.761904762;2068.77777777778;96.0476190476191
82126;2023;11;11;0;100;0;186968.272727273;2102.72727272727;92.2727272727273
82127;2023;9;9;0;100;0;174830.333333333;1580;107.666666666667
82130;2023;3;3;0;100;0;209136.666666667;2603.33333333333;80
82131;2023;24;22;2;91.6666666666667;8.33333333333333;180992.791666667;1596.16666666667;111.5
82132;2023;29;29;0;100;0;151186.724137931;1758.34482758621;92.1379310344828
82133;2023;1;1;0;100;0;180000;2000;90
82134;2023;61;50;11;81.9672131147541;18.0327868852459;169964.180327869;1889.70491803279;93.4754098360656
82135;2023;17;16;1;94.1176470588235;5.88235294117647;239752.941176471;2502.70588235294;99.9411764705882
82136;2023;15;15;0;100;0;270079;2671.33333333333;95.6666666666667
82137;2023;13;13;0;100;0;147746.923076923;1656.23076923077;92
82138;2023;3;3;0;100;0;287966.666666667;2123.66666666667;157
82139;2023;4;4;0;100;0;188750;1095;174
82140;2023;6;6;0;100;0;187490.833333333;1815.33333333333;110.166666666667
82141;2023;10;10;0;100;0;222733;1687.6;131.5
82142;2023;13;13;0;100;0;272343.076923077;2491.23076923077;107.307692307692
82143;2023;1;1;0;100;0;285000;2127;134
82144;2023;6;6;0;100;0;247366.666666667;2265.33333333333;107.333333333333
82145;2023;4;4;0;100;0;326097.5;2356.25;137.25
82147;2023;5;5;0;100;0;162454.6;2031.8;89.4
82148;2023;11;10;1;90.9090909090909;9.09090909090909;119918.727272727;1110.90909090909;104.818181818182
82149;2023;15;15;0;100;0;187998;1967.2;100.866666666667
82150;2023;8;8;0;100;0;212058.75;1931;112
82151;2023;7;7;0;100;0;244082.142857143;1812.85714285714;137
82152;2023;6;3;3;50;50;126916.666666667;1416.83333333333;88.3333333333333
82153;2023;1;1;0;100;0;50590;723;70
82154;2023;4;4;0;100;0;310782.5;1888.75;152
82155;2023;52;50;2;96.1538461538462;3.84615384615385;197396.884615385;2437;91.1346153846154
82156;2023;1;1;0;100;0;165000;1650;100
82158;2023;2;2;0;100;0;168650;1336;123.5
82159;2023;3;3;0;100;0;159148;1224.33333333333;127
82160;2023;4;4;0;100;0;180500;1844;98.5
82161;2023;34;32;2;94.1176470588235;5.88235294117647;236798.617647059;2199.35294117647;108.147058823529
82162;2023;1;1;0;100;0;140000;1795;78
82164;2023;1;1;0;100;0;442370;2587;171
82165;2023;6;6;0;100;0;188032.166666667;1762.16666666667;123.166666666667
82166;2023;3;1;2;33.3333333333333;66.6666666666667;320158.333333333;2699.66666666667;98.3333333333333
82167;2023;6;6;0;100;0;375376.166666667;2495.66666666667;148.333333333333
82168;2023;2;2;0;100;0;107500;1099;98
82169;2023;18;18;0;100;0;146857.222222222;1379.11111111111;113.388888888889
82170;2023;3;3;0;100;0;120019.333333333;1568.33333333333;74.3333333333333
82171;2023;10;10;0;100;0;191338.6;1722.5;119.8
82172;2023;10;10;0;100;0;132453;1740.5;76.4
82173;2023;11;10;1;90.9090909090909;9.09090909090909;164177.272727273;1443.45454545455;114.818181818182
82174;2023;1;1;0;100;0;303077;6735;45
82176;2023;5;5;0;100;0;246780;2193.8;112.2
82177;2023;1;1;0;100;0;375000;2500;150
82178;2023;8;8;0;100;0;199427.375;2012.375;99.75
82179;2023;34;32;2;94.1176470588235;5.88235294117647;208463.647058824;2219.23529411765;102.235294117647
82180;2023;5;5;0;100;0;122120;1125.4;107.8
82181;2023;1;1;0;100;0;170000;829;205
82182;2023;5;5;0;100;0;114021.2;1109.6;104.8
82183;2023;4;4;0;100;0;231131;1597;153.5
82184;2023;9;9;0;100;0;194809.777777778;1672.77777777778;109.888888888889
82185;2023;2;2;0;100;0;222000;1924;114.5
82186;2023;66;55;11;83.3333333333333;16.6666666666667;132921.333333333;1404.84848484848;97.7424242424242
82187;2023;28;27;1;96.4285714285714;3.57142857142857;161654.821428571;1662.25;97.6071428571429
82188;2023;3;3;0;100;0;268406.666666667;2604;100.333333333333
82189;2023;9;9;0;100;0;174427.777777778;1531.33333333333;114.555555555556
82190;2023;73;58;15;79.4520547945205;20.5479452054795;189694.260273973;2113.02739726027;90.7671232876712
82191;2023;7;7;0;100;0;148321.428571429;1588.85714285714;95.8571428571429
82194;2023;6;6;0;100;0;281730;2263.33333333333;128.833333333333
82195;2023;4;4;0;100;0;179500;1928.5;91.25
83001;2023;29;23;6;79.3103448275862;20.6896551724138;595348.75862069;5126.41379310345;118.965517241379
83002;2023;6;5;1;83.3333333333333;16.6666666666667;307420;2735.83333333333;95.3333333333333
83003;2023;19;17;2;89.4736842105263;10.5263157894737;188559.473684211;2157;87.2631578947368
83004;2023;140;72;68;51.4285714285714;48.5714285714286;267562.9;3270.42142857143;80.6857142857143
83005;2023;7;7;0;100;0;292122.285714286;2887.42857142857;108
83006;2023;2;2;0;100;0;397500;3514.5;116
83007;2023;60;42;18;70;30;211693.216666667;2789.23333333333;79.2666666666667
83008;2023;58;37;21;63.7931034482759;36.2068965517241;329206.103448276;3894.46551724138;82.9827586206897
83009;2023;341;56;285;16.4222873900293;83.5777126099707;404095.126099707;7225.77126099707;55.6451612903226
83011;2023;40;20;20;50;50;179752.5;2154.225;70.55
83012;2023;71;36;35;50.7042253521127;49.2957746478873;191056.549295775;2654.84507042254;71.2253521126761
83013;2023;7;6;1;85.7142857142857;14.2857142857143;146485.714285714;2246.28571428571;62
83014;2023;5;5;0;100;0;369336;3777;139.8
83015;2023;5;2;3;40;60;230076;3820;63.8
83016;2023;137;69;68;50.3649635036496;49.6350364963504;371541.182481752;4587.35766423358;77.8102189781022
83017;2023;37;22;15;59.4594594594595;40.5405405405405;259725.513513514;3647.89189189189;74.1351351351351
83018;2023;46;40;6;86.9565217391304;13.0434782608696;304198.956521739;3100.78260869565;95.6304347826087
83019;2023;337;96;241;28.486646884273;71.513353115727;378343.370919881;6012.14540059347;57.646884272997
83020;2023;1;1;0;100;0;75000;1250;60
83021;2023;30;23;7;76.6666666666667;23.3333333333333;276708.5;3390.26666666667;85.1666666666667
83022;2023;1;1;0;100;0;235000;2938;80
83023;2023;254;127;127;50;50;224714.25984252;2909.82283464567;77.2913385826772
83025;2023;16;13;3;81.25;18.75;328222.625;3011.4375;105
83026;2023;35;32;3;91.4285714285714;8.57142857142857;262541.714285714;2899;86.7428571428571
83027;2023;51;41;10;80.3921568627451;19.6078431372549;798447.254901961;6866.88235294118;113.647058823529
83028;2023;36;27;9;75;25;321943.888888889;2987.02777777778;98.25
83029;2023;68;51;17;75;25;396328.911764706;4063.82352941176;99.3088235294118
83030;2023;29;24;5;82.7586206896552;17.2413793103448;306750.379310345;3061.68965517241;97.9310344827586
83031;2023;61;49;12;80.327868852459;19.672131147541;326886.557377049;3389.6393442623;96.1475409836066
83032;2023;56;47;9;83.9285714285714;16.0714285714286;288573.375;3137.75;92.5535714285714
83033;2023;68;53;15;77.9411764705882;22.0588235294118;249906.691176471;3358.32352941176;75.3529411764706
83034;2023;186;74;112;39.7849462365591;60.2150537634409;557293.193548387;6453.64516129032;83.8494623655914
83035;2023;61;47;14;77.0491803278689;22.9508196721311;417318.06557377;5160.5737704918;78.344262295082
83036;2023;385;86;299;22.3376623376623;77.6623376623377;375528.402597403;5982.53506493506;60.1194805194805
83037;2023;15;12;3;80;20;330993.533333333;3639.2;91.6
83038;2023;5;4;1;80;20;301210;3608;84.2
83040;2023;1;0;1;0;100;60500;1210;50
83041;2023;15;12;3;80;20;280961.533333333;3030.73333333333;82.1333333333333
83042;2023;221;73;148;33.0316742081448;66.9683257918552;276576.619909502;4357.01357466063;65.8235294117647
83043;2023;37;24;13;64.8648648648649;35.1351351351351;245043.783783784;3027.32432432432;74.7297297297297
83044;2023;3;3;0;100;0;132166.666666667;1734.66666666667;75.6666666666667
83045;2023;16;11;5;68.75;31.25;175809.375;2646.1875;76.625
83046;2023;68;52;16;76.4705882352941;23.5294117647059;349483.985294118;3393.85294117647;99.1323529411765
83047;2023;172;109;63;63.3720930232558;36.6279069767442;363294.063953488;4301.68604651163;84.1686046511628
83048;2023;171;68;103;39.766081871345;60.233918128655;572449.233918129;7522.0350877193;71.5380116959064
83049;2023;179;108;71;60.3351955307263;39.6648044692737;282339.983240223;3560.06703910615;80.4469273743017
83050;2023;626;214;412;34.185303514377;65.814696485623;212766.28115016;2629.08466453674;78.1693290734824
83051;2023;18;16;2;88.8888888888889;11.1111111111111;336268.388888889;3796.38888888889;89.2777777777778
83052;2023;10;10;0;100;0;175981.7;2195.7;78.4
83053;2023;17;13;4;76.4705882352941;23.5294117647059;347625.705882353;3921.23529411765;84.4117647058823
83054;2023;106;56;50;52.8301886792453;47.1698113207547;312010.009433962;4260.11320754717;73.9056603773585
83055;2023;108;75;33;69.4444444444444;30.5555555555556;358158.083333333;4010.47222222222;90.6481481481482
83056;2023;32;29;3;90.625;9.375;334875.625;3599.5;93.71875
83057;2023;54;39;15;72.2222222222222;27.7777777777778;270384.814814815;2840.31481481481;92.5555555555556
83058;2023;100;66;34;66;34;322757.12;3315.96;93.14
83059;2023;56;40;16;71.4285714285714;28.5714285714286;313844.642857143;3484.625;94.3392857142857
83060;2023;4;4;0;100;0;295800;2805.75;95
83061;2023;1390;251;1139;18.0575539568345;81.9424460431655;266488.489208633;4412.59064748201;61.3532374100719
83062;2023;276;85;191;30.7971014492754;69.2028985507246;289731.014492754;3840.44202898551;74.3007246376812
83063;2023;51;40;11;78.4313725490196;21.5686274509804;519611.411764706;5024.35294117647;101.764705882353
83064;2023;85;73;12;85.8823529411765;14.1176470588235;366279.588235294;3746.02352941176;100.435294117647
83065;2023;90;55;35;61.1111111111111;38.8888888888889;912317.355555556;8781.01111111111;90.6333333333333
83066;2023;28;27;1;96.4285714285714;3.57142857142857;289261.785714286;3025.78571428571;98.9642857142857
83067;2023;80;62;18;77.5;22.5;211899.5125;2673.7375;81.1875
83068;2023;232;112;120;48.2758620689655;51.7241379310345;703998.176724138;8106.13362068965;81.9655172413793
83069;2023;988;190;798;19.2307692307692;80.7692307692308;286698.326923077;4476.07388663968;63.7419028340081
83070;2023;354;59;295;16.6666666666667;83.3333333333333;378974.474576271;6599.39830508475;53.3022598870056
83071;2023;278;111;167;39.9280575539568;60.0719424460432;329149.956834532;5900.36330935252;57.3093525179856
83072;2023;174;123;51;70.6896551724138;29.3103448275862;372753.494252874;3550.01149425287;98.7643678160919
83073;2023;188;108;80;57.4468085106383;42.5531914893617;224596.191489362;2852.22872340426;78.1914893617021
83074;2023;7;7;0;100;0;232142.857142857;2506.28571428571;97.2857142857143
83075;2023;11;11;0;100;0;248727.272727273;2797.81818181818;89.9090909090909
83076;2023;9;9;0;100;0;185407.111111111;2808.22222222222;68.2222222222222
83077;2023;27;26;1;96.2962962962963;3.7037037037037;375810;3585.18518518519;109.407407407407
83078;2023;7;7;0;100;0;353265.714285714;2869;126.714285714286
83079;2023;24;14;10;58.3333333333333;41.6666666666667;478580.416666667;4709.29166666667;87.8333333333333
83080;2023;24;22;2;91.6666666666667;8.33333333333333;428924.166666667;3408.125;119
83081;2023;111;83;28;74.7747747747748;25.2252252252252;450436.261261261;4140.61261261261;109.414414414414
83082;2023;8;4;4;50;50;158250;2283.75;61.375
83083;2023;25;21;4;84;16;267640.72;3042.44;101.56
83084;2023;12;12;0;100;0;260951.666666667;2874;91.8333333333333
83085;2023;54;45;9;83.3333333333333;16.6666666666667;374012.759259259;4087.68518518519;93.7407407407407
83086;2023;132;71;61;53.7878787878788;46.2121212121212;260421.666666667;3158.33333333333;78.0227272727273
83087;2023;52;43;9;82.6923076923077;17.3076923076923;403890.115384615;4017.73076923077;99.25
83088;2023;25;23;2;92;8;374280.84;3448.88;106.28
83089;2023;2;2;0;100;0;301665.5;3707.5;81.5
83090;2023;158;83;75;52.5316455696203;47.4683544303797;417943.689873418;4330.90506329114;88.9936708860759
83091;2023;65;50;15;76.9230769230769;23.0769230769231;302887.876923077;3534.84615384615;84.6461538461539
83092;2023;84;65;19;77.3809523809524;22.6190476190476;242999.916666667;2731.82142857143;90.4285714285714
83093;2023;23;13;10;56.5217391304348;43.4782608695652;296008.695652174;3725.86956521739;77.695652173913
83094;2023;62;49;13;79.0322580645161;20.9677419354839;642896.274193548;5900.1935483871;102.645161290323
83095;2023;12;12;0;100;0;197766.666666667;2191.16666666667;89.3333333333333
83096;2023;19;16;3;84.2105263157895;15.7894736842105;262292.157894737;3221.47368421053;82.7894736842105
83097;2023;59;50;9;84.7457627118644;15.2542372881356;423825.644067797;4183.47457627119;94.728813559322
83098;2023;170;68;102;40;60;382550.176470588;4932.16470588235;73.2882352941176
83099;2023;136;63;73;46.3235294117647;53.6764705882353;292785.477941176;3694.66176470588;76.6470588235294
83100;2023;58;52;6;89.6551724137931;10.3448275862069;306551.051724138;3817.53448275862;83.1724137931034
83101;2023;39;23;16;58.974358974359;41.025641025641;1178314.43589744;10078.9230769231;108.102564102564
83102;2023;74;72;2;97.2972972972973;2.7027027027027;297414.297297297;3348.7027027027;93.3513513513514
83103;2023;46;38;8;82.6086956521739;17.3913043478261;445176.5;4941.26086956522;94.9565217391304
83104;2023;58;50;8;86.2068965517241;13.7931034482759;244115.793103448;2962.36206896552;82.9310344827586
83105;2023;1;1;0;100;0;140000;7000;20
83106;2023;68;66;2;97.0588235294118;2.94117647058824;315180.691176471;3427.66176470588;91.2058823529412
83107;2023;448;261;187;58.2589285714286;41.7410714285714;470507.267857143;5517.40178571429;83.53125
83108;2023;35;31;4;88.5714285714286;11.4285714285714;312372.542857143;3147.65714285714;101.371428571429
83109;2023;5;5;0;100;0;221200;2551.4;94.8
83110;2023;27;20;7;74.0740740740741;25.9259259259259;280830.555555556;3174.85185185185;91.962962962963
83111;2023;35;33;2;94.2857142857143;5.71428571428571;337729.514285714;3733.74285714286;95.2285714285714
83112;2023;261;89;172;34.0996168582375;65.9003831417624;458072.808429119;6437.67432950192;69.7049808429119
83113;2023;40;38;2;95;5;218847.525;2950.225;77.175
83114;2023;9;7;2;77.7777777777778;22.2222222222222;166584.444444444;2341;62
83115;2023;536;154;382;28.7313432835821;71.2686567164179;469105.052238806;6423.30970149254;66.8712686567164
83116;2023;204;160;44;78.4313725490196;21.5686274509804;359363.225490196;3881.5931372549;90.1617647058823
83117;2023;33;28;5;84.8484848484848;15.1515151515152;399726.181818182;3893.90909090909;104.393939393939
83118;2023;1375;255;1120;18.5454545454545;81.4545454545455;365488.293818182;5218.19272727273;67.5512727272727
83119;2023;146;25;121;17.1232876712329;82.8767123287671;837149.808219178;10578.7945205479;76.0616438356164
83120;2023;57;32;25;56.140350877193;43.859649122807;354245.438596491;4247.24561403509;81.6491228070175
83121;2023;77;55;22;71.4285714285714;28.5714285714286;262170.12987013;3236.35064935065;82.3116883116883
83122;2023;8;3;5;37.5;62.5;128049.375;2611.125;59.75
83123;2023;485;129;356;26.5979381443299;73.4020618556701;444110.75257732;6718.61443298969;65.4020618556701
83124;2023;57;47;10;82.4561403508772;17.5438596491228;446509.350877193;3636.84210526316;115.017543859649
83125;2023;37;33;4;89.1891891891892;10.8108108108108;311507.567567568;3634.75675675676;85.6486486486486
83126;2023;1099;229;870;20.8371246587807;79.1628753412193;226044.454959054;3741.49499545041;61.4476797088262
83127;2023;29;25;4;86.2068965517241;13.7931034482759;311996.517241379;3586.10344827586;85.9310344827586
83128;2023;12;9;3;75;25;256246.666666667;2894.66666666667;85.9166666666667
83129;2023;770;231;539;30;70;334678.77012987;5382.96623376623;63.2402597402597
83130;2023;122;73;49;59.8360655737705;40.1639344262295;323226.598360656;3776.09836065574;85.0409836065574
83131;2023;79;64;15;81.0126582278481;18.9873417721519;375350.810126582;4328.08860759494;85.5949367088608
83132;2023;29;22;7;75.8620689655172;24.1379310344828;413798.620689655;4492.20689655172;95.6551724137931
83133;2023;13;8;5;61.5384615384615;38.4615384615385;529746.153846154;4573.07692307692;107.846153846154
83134;2023;27;24;3;88.8888888888889;11.1111111111111;317904.851851852;3440.2962962963;91.3703703703704
83135;2023;28;27;1;96.4285714285714;3.57142857142857;225922.035714286;2704.71428571429;84.2857142857143
83136;2023;46;42;4;91.304347826087;8.69565217391304;378164.239130435;3715.02173913043;101.347826086957
83137;2023;2937;401;2536;13.6533878106912;86.3466121893088;207294.569969356;3182.3190330269;63.7368062648962
83138;2023;60;49;11;81.6666666666667;18.3333333333333;412088.533333333;4685.11666666667;81.9666666666667
83139;2023;11;10;1;90.9090909090909;9.09090909090909;333186.363636364;3111.63636363636;101.363636363636
83140;2023;60;50;10;83.3333333333333;16.6666666666667;267731.416666667;3475.71666666667;81.1
83141;2023;75;46;29;61.3333333333333;38.6666666666667;272855.68;3039.30666666667;84.24
83142;2023;5;5;0;100;0;105000;1712;72.8
83143;2023;71;63;8;88.7323943661972;11.2676056338028;335061.070422535;3204.71830985915;104.323943661972
83144;2023;340;81;259;23.8235294117647;76.1764705882353;257009.344117647;3604.66176470588;70.2205882352941
83145;2023;31;23;8;74.1935483870968;25.8064516129032;173455.903225806;2518.54838709677;71.7096774193548
83146;2023;33;31;2;93.9393939393939;6.06060606060606;236499.878787879;2679.81818181818;83.2121212121212
83148;2023;236;152;84;64.4067796610169;35.5932203389831;258343.156779661;3228.16949152542;77.521186440678
83149;2023;27;21;6;77.7777777777778;22.2222222222222;301425.555555556;3353.85185185185;88.2592592592593
83150;2023;56;45;11;80.3571428571429;19.6428571428571;226368.482142857;2957.94642857143;73.4821428571429
83151;2023;13;13;0;100;0;238220.846153846;2815.92307692308;86.8461538461538
83152;2023;34;16;18;47.0588235294118;52.9411764705882;732392.205882353;7443.85294117647;94.1176470588235
83153;2023;176;14;162;7.95454545454545;92.0454545454545;205423.715909091;4998.48295454545;41.4659090909091
83154;2023;13;11;2;84.6153846153846;15.3846153846154;321538.461538462;3568.46153846154;93.0769230769231
84001;2023;14;10;4;71.4285714285714;28.5714285714286;319195.857142857;3605.57142857143;89.7142857142857
84002;2023;13;13;0;100;0;459194.615384615;5518.23076923077;90.3846153846154
84003;2023;111;58;53;52.2522522522522;47.7477477477478;201393.306306306;2461.42342342342;78.972972972973
84004;2023;72;65;7;90.2777777777778;9.72222222222222;219472.166666667;2772.58333333333;77.6944444444444
84005;2023;2;2;0;100;0;206750;2565;80.5
84006;2023;1;1;0;100;0;370000;5286;70
84007;2023;1608;396;1212;24.6268656716418;75.3731343283582;158927.683457711;2609.17350746269;62.9757462686567
84008;2023;7;7;0;100;0;561685.714285714;4835;126.714285714286
84009;2023;16;14;2;87.5;12.5;276241.25;2765;106.6875
84010;2023;18;17;1;94.4444444444444;5.55555555555556;309978.333333333;3320.66666666667;94.8333333333333
84011;2023;5;3;2;60;40;595340;4303.2;101
84012;2023;31;29;2;93.5483870967742;6.45161290322581;319058.387096774;3279.74193548387;90.4193548387097
84013;2023;3;0;3;0;100;145932;3194.66666666667;49
84014;2023;9;9;0;100;0;285000;2370;119.666666666667
84015;2023;3;3;0;100;0;363583.333333333;2799.33333333333;141.666666666667
84016;2023;50;43;7;86;14;271359.36;2750.82;100.4
84017;2023;56;52;4;92.8571428571429;7.14285714285714;312859.785714286;3650.25;84.9642857142857
84018;2023;5;5;0;100;0;463711.6;3766.8;120.6
84019;2023;135;98;37;72.5925925925926;27.4074074074074;181610.607407407;2069.65925925926;91.8148148148148
84020;2023;16;12;4;75;25;529067.3125;3500.125;122.375
84021;2023;3;3;0;100;0;527420;2691.33333333333;200
84022;2023;5;5;0;100;0;257500;2614.2;90.4
84023;2023;1;1;0;100;0;712355;4397;162
84024;2023;11;9;2;81.8181818181818;18.1818181818182;306734.909090909;3466.45454545455;97.0909090909091
84025;2023;22;21;1;95.4545454545455;4.54545454545455;685565;5169.81818181818;123.545454545455
84026;2023;65;44;21;67.6923076923077;32.3076923076923;305575.676923077;4038.63076923077;74.4923076923077
84027;2023;21;20;1;95.2380952380952;4.76190476190476;314140.714285714;2645.61904761905;119.142857142857
84028;2023;11;8;3;72.7272727272727;27.2727272727273;530243.727272727;3949;124.818181818182
84029;2023;36;34;2;94.4444444444444;5.55555555555556;262985.555555556;2672.47222222222;102
84030;2023;35;28;7;80;20;262020.285714286;3134.48571428571;87.4571428571429
84031;2023;321;167;154;52.0249221183801;47.9750778816199;177927.146417445;2195.95638629283;80.2772585669782
84032;2023;3;3;0;100;0;211666.666666667;1754.66666666667;104
84033;2023;2;2;0;100;0;89000;1539.5;60.5
84034;2023;51;41;10;80.3921568627451;19.6078431372549;303414.666666667;2930.11764705882;103.235294117647
84035;2023;285;130;155;45.6140350877193;54.3859649122807;207232.849122807;2601.27719298246;77.5333333333333
84036;2023;24;22;2;91.6666666666667;8.33333333333333;319608.583333333;2810.08333333333;122.916666666667
84037;2023;19;17;2;89.4736842105263;10.5263157894737;252425.263157895;2768.68421052632;92.6842105263158
84038;2023;24;22;2;91.6666666666667;8.33333333333333;449614.125;3842.16666666667;111.416666666667
84039;2023;66;53;13;80.3030303030303;19.6969696969697;235805.121212121;2680.13636363636;85.5
84040;2023;2;2;0;100;0;466000;3027;142
84041;2023;7;7;0;100;0;525981.857142857;4341;118.285714285714
84042;2023;24;19;5;79.1666666666667;20.8333333333333;466225.458333333;4815.54166666667;86.875
84043;2023;79;59;20;74.6835443037975;25.3164556962025;245705.443037975;2719.49367088608;91.7088607594937
84044;2023;19;17;2;89.4736842105263;10.5263157894737;313107.526315789;3810.52631578947;91.5263157894737
84045;2023;9;9;0;100;0;330951.111111111;3187.55555555556;100.222222222222
84046;2023;5;5;0;100;0;219760;2354.4;92.2
84047;2023;39;39;0;100;0;308673.205128205;3181.79487179487;97.3333333333333
84048;2023;2;2;0;100;0;185000;5690.5;32.5
84049;2023;2;2;0;100;0;207500;1712;121
84050;2023;45;43;2;95.5555555555556;4.44444444444444;964949.4;6949.11111111111;138.155555555556
84051;2023;13;11;2;84.6153846153846;15.3846153846154;881099.307692308;5102.76923076923;145.923076923077
84052;2023;21;20;1;95.2380952380952;4.76190476190476;376104.904761905;3864.57142857143;97.9523809523809
84053;2023;23;22;1;95.6521739130435;4.34782608695652;269137.608695652;2522.86956521739;104.521739130435
84054;2023;284;184;100;64.7887323943662;35.2112676056338;359117.116197183;3927.66197183099;86.7147887323944
84055;2023;7;7;0;100;0;370908.142857143;3304.57142857143;112.714285714286
84056;2023;54;49;5;90.7407407407407;9.25925925925926;262111.5;2659.7962962963;98.4444444444444
84057;2023;4;4;0;100;0;690250;6366.25;93.5
84058;2023;7;7;0;100;0;667971.285714286;6419.57142857143;122.285714285714
84061;2023;3;3;0;100;0;545383.666666667;4402.66666666667;127.333333333333
84062;2023;14;14;0;100;0;685342.857142857;4137.07142857143;145.142857142857
84063;2023;4;4;0;100;0;482275;3278.75;162.25
84064;2023;34;28;6;82.3529411764706;17.6470588235294;183065.852941176;2125.05882352941;92.4705882352941
84065;2023;53;50;3;94.3396226415094;5.66037735849057;391306.433962264;3864.62264150943;102.660377358491
84066;2023;3;3;0;100;0;357266.666666667;3453.66666666667;106.666666666667
84067;2023;24;23;1;95.8333333333333;4.16666666666667;316293.625;3408.58333333333;93.2083333333333
84068;2023;17;14;3;82.3529411764706;17.6470588235294;935533.176470588;6539.35294117647;128.588235294118
84069;2023;30;23;7;76.6666666666667;23.3333333333333;287150.9;3193.76666666667;90.4
84070;2023;27;23;4;85.1851851851852;14.8148148148148;275788.518518519;2701.03703703704;101.851851851852
84071;2023;22;18;4;81.8181818181818;18.1818181818182;507475.863636364;4369.81818181818;111.090909090909
84072;2023;50;42;8;84;16;270117.86;2886.56;91.74
84073;2023;19;17;2;89.4736842105263;10.5263157894737;780030;7484.36842105263;100.684210526316
84074;2023;26;24;2;92.3076923076923;7.69230769230769;344801.615384615;3893.69230769231;91.7692307692308
84075;2023;6;6;0;100;0;212833.333333333;2473.5;69.3333333333333
84076;2023;19;18;1;94.7368421052632;5.26315789473684;290039.421052632;3408.52631578947;86.5263157894737
84077;2023;4;4;0;100;0;521672.5;3331.25;151
84078;2023;37;33;4;89.1891891891892;10.8108108108108;207992.972972973;2114.08108108108;98.0810810810811
84079;2023;6;6;0;100;0;345690.666666667;4691.16666666667;84.8333333333333
84080;2023;124;90;34;72.5806451612903;27.4193548387097;265971.209677419;3054.06451612903;85.9032258064516
84081;2023;89;63;26;70.7865168539326;29.2134831460674;245647.741573034;2849.55056179775;86.4719101123596
84082;2023;33;26;7;78.7878787878788;21.2121212121212;259659.878787879;2679.90909090909;93.7575757575758
84083;2023;24;22;2;91.6666666666667;8.33333333333333;218322.5;2386.625;93.625
84084;2023;16;12;4;75;25;403651.875;3433.125;113.125
84085;2023;5;5;0;100;0;393801.6;4168.6;92.6
84086;2023;17;16;1;94.1176470588235;5.88235294117647;487667.647058824;5363.41176470588;93.6470588235294
84087;2023;321;173;148;53.8940809968847;46.1059190031153;206329.788161994;2489.78816199377;80.8380062305296
84088;2023;92;81;11;88.0434782608696;11.9565217391304;307574.130434783;3460.95652173913;90.8913043478261
84089;2023;245;117;128;47.7551020408163;52.2448979591837;249029.46122449;3462.02040816327;72.4408163265306
84090;2023;11;11;0;100;0;314205.454545455;3457.09090909091;93.6363636363636
84091;2023;69;51;18;73.9130434782609;26.0869565217391;229866.971014493;2404.40579710145;92.2608695652174
84092;2023;209;108;101;51.6746411483254;48.3253588516746;169763.631578947;2238.995215311;76.2105263157895
84093;2023;10;10;0;100;0;464977.1;4029.5;121.6
84094;2023;4;4;0;100;0;382768.75;3417.25;108
84095;2023;9;9;0;100;0;424481.111111111;3674.22222222222;122.777777777778
84096;2023;10;10;0;100;0;355835.9;3356;106.7
84097;2023;11;11;0;100;0;263794;2669.27272727273;101.363636363636
84098;2023;3;3;0;100;0;398333.333333333;2517.33333333333;160
84099;2023;47;39;8;82.9787234042553;17.0212765957447;348194.404255319;4250.27659574468;84.468085106383
84100;2023;3;3;0;100;0;360016.666666667;3669.66666666667;89.3333333333333
84101;2023;8;8;0;100;0;685206.5;4314.375;145.125
84102;2023;29;18;11;62.0689655172414;37.9310344827586;369062.75862069;4123.1724137931;96.7586206896552
84103;2023;13;12;1;92.3076923076923;7.69230769230769;288418.461538462;3161.38461538462;90.0769230769231
84104;2023;22;17;5;77.2727272727273;22.7272727272727;325354.318181818;2829.77272727273;112.863636363636
84105;2023;16;16;0;100;0;271575.625;2853.25;97.4375
84106;2023;41;31;10;75.609756097561;24.390243902439;277308.219512195;2892.0487804878;96.4634146341463
84107;2023;9;9;0;100;0;141140;1718.11111111111;79.8888888888889
84108;2023;29;27;2;93.1034482758621;6.89655172413793;340247.068965517;3411.31034482759;100.724137931034
84109;2023;2;2;0;100;0;626500;5031.5;122
84110;2023;2;2;0;100;0;181400;2285;74
84111;2023;4;4;0;100;0;417573;4091;100
84112;2023;11;10;1;90.9090909090909;9.09090909090909;317131.818181818;3755.09090909091;93
84113;2023;8;7;1;87.5;12.5;205097.5;2550.75;79.875
84114;2023;5;5;0;100;0;952528.4;4798;193
84115;2023;5;5;0;100;0;324206;2765.6;119
84116;2023;7;6;1;85.7142857142857;14.2857142857143;254014.285714286;2620.57142857143;98.2857142857143
84117;2023;2;2;0;100;0;241226.5;2492.5;111.5
84118;2023;44;42;2;95.4545454545455;4.54545454545455;407995.568181818;3882.36363636364;109.409090909091
84119;2023;57;43;14;75.4385964912281;24.5614035087719;297644.228070175;3172.0701754386;92.3157894736842
84120;2023;3;3;0;100;0;181926.666666667;2106.66666666667;86.3333333333333
84121;2023;2;2;0;100;0;364500;3730.5;98
84122;2023;41;37;4;90.2439024390244;9.75609756097561;275977.56097561;2768.12195121951;98.8536585365854
84123;2023;17;14;3;82.3529411764706;17.6470588235294;271156.470588235;2485.11764705882;106.470588235294
84124;2023;23;6;17;26.0869565217391;73.9130434782609;235152.173913043;3230.21739130435;69.3478260869565
84125;2023;1;1;0;100;0;20000;513;39
84126;2023;7;7;0;100;0;371467.142857143;3443.42857142857;108.285714285714
84127;2023;35;32;3;91.4285714285714;8.57142857142857;285265.114285714;2690.45714285714;103.771428571429
84128;2023;1;0;1;0;100;340000;5763;59
84129;2023;170;105;65;61.7647058823529;38.2352941176471;201940.641176471;2447.4;81.1470588235294
84130;2023;2;2;0;100;0;542500;6495.5;97.5
84131;2023;25;23;2;92;8;390000.8;4108.88;95.64
84132;2023;79;59;20;74.6835443037975;25.3164556962025;305730.556962025;3066.70886075949;96.1139240506329
84133;2023;48;39;9;81.25;18.75;330152.291666667;3280.3125;96.8958333333333
84134;2023;8;8;0;100;0;437449.375;3983.25;119.5
84135;2023;15;14;1;93.3333333333333;6.66666666666667;407520.6;3215.13333333333;119.733333333333
84136;2023;15;12;3;80;20;274934;3205.66666666667;87.3333333333333
84137;2023;90;67;23;74.4444444444444;25.5555555555556;327695.588888889;3325.04444444444;96.0444444444445
84138;2023;106;80;26;75.4716981132076;24.5283018867925;191540.29245283;2257.64150943396;88.1981132075472
84139;2023;13;7;6;53.8461538461538;46.1538461538462;241985;3516.61538461538;64.2307692307692
84140;2023;2;1;1;50;50;443515.5;3833.5;95
84141;2023;107;91;16;85.0467289719626;14.9532710280374;266861.252336449;2870.15887850467;93.4018691588785
84142;2023;31;24;7;77.4193548387097;22.5806451612903;330269.193548387;3680.45161290323;95.8387096774194
84143;2023;16;14;2;87.5;12.5;286251.125;3281.625;91
84144;2023;12;11;1;91.6666666666667;8.33333333333333;285207.083333333;3258.58333333333;94.75
84145;2023;4;4;0;100;0;958810;5412.75;153.25
84146;2023;6;6;0;100;0;425720;3030;133.666666666667
84147;2023;32;21;11;65.625;34.375;330127.0625;3626.8125;89.65625
84148;2023;15;14;1;93.3333333333333;6.66666666666667;241628.666666667;2645.6;90.8
84149;2023;17;16;1;94.1176470588235;5.88235294117647;265452.941176471;2583.41176470588;108.176470588235
84150;2023;16;15;1;93.75;6.25;280380.625;2583;94.5
84151;2023;5;4;1;80;20;332268;3637.2;86.4
85001;2023;86;80;6;93.0232558139535;6.97674418604651;204763.302325581;3040;71.2674418604651
85002;2023;44;44;0;100;0;204650.590909091;2664.34090909091;75.2045454545455
85003;2023;106;99;7;93.3962264150943;6.60377358490566;246097.283018868;2544.94339622642;95.7924528301887
85004;2023;74;74;0;100;0;237646.324324324;2874.83783783784;88.4054054054054
85005;2023;10;10;0;100;0;141103.8;1170.5;119.4
85006;2023;25;25;0;100;0;198965.2;2205.72;93.2
85008;2023;67;67;0;100;0;255262.373134328;2508.80597014925;102.582089552239
85009;2023;19;19;0;100;0;187671;1825.94736842105;103.052631578947
85010;2023;17;17;0;100;0;233158;2453.94117647059;96.4117647058823
85011;2023;42;39;3;92.8571428571429;7.14285714285714;341613.80952381;4391.7619047619;79.9523809523809
85012;2023;80;65;15;81.25;18.75;172085.75;3362.9375;55.75
85013;2023;14;14;0;100;0;136571.428571429;1829.78571428571;75.9285714285714
85014;2023;13;13;0;100;0;147467.384615385;1438.76923076923;110.230769230769
85015;2023;15;15;0;100;0;215783.333333333;2115.33333333333;104.666666666667
85016;2023;35;34;1;97.1428571428571;2.85714285714286;207005.714285714;2343.22857142857;92.9428571428571
85017;2023;19;19;0;100;0;190278.105263158;2031.26315789474;94.2105263157895
85018;2023;72;71;1;98.6111111111111;1.38888888888889;215134.041666667;2623.41666666667;84.1805555555556
85019;2023;57;57;0;100;0;224155.070175439;2311.73684210526;99.7368421052632
85020;2023;45;45;0;100;0;170546.133333333;1594.8;110.866666666667
85021;2023;16;16;0;100;0;211065.3125;2147.0625;99.0625
85022;2023;29;29;0;100;0;228697.724137931;2676.20689655172;92.1034482758621
85023;2023;2;2;0;100;0;161525;1544;92.5
85024;2023;32;30;2;93.75;6.25;210298.59375;2287.4375;93.03125
85025;2023;25;25;0;100;0;167403.24;1677.92;99.56
85026;2023;14;14;0;100;0;196770;2061.57142857143;94.4285714285714
85028;2023;10;10;0;100;0;134180;1563.4;107.8
85029;2023;44;44;0;100;0;167579.068181818;1995.15909090909;87.5454545454545
85031;2023;36;36;0;100;0;167919.305555556;1678;101.388888888889
85033;2023;18;18;0;100;0;148365.555555556;1634.83333333333;92.3888888888889
85034;2023;37;37;0;100;0;170794.594594595;1831.91891891892;96.4054054054054
85035;2023;170;149;21;87.6470588235294;12.3529411764706;290587.794117647;4244.08823529412;72.9764705882353
85036;2023;4;4;0;100;0;194500;1187.25;165.5
85037;2023;1;1;0;100;0;124000;1192;104
85038;2023;30;30;0;100;0;180686.666666667;1851.5;103.066666666667
85039;2023;37;37;0;100;0;228651.351351351;2226.05405405405;102.594594594595
85040;2023;16;16;0;100;0;176601.25;1601;108.3125
85041;2023;7;7;0;100;0;143642.857142857;1101.42857142857;131.428571428571
85042;2023;25;24;1;96;4;172267;1779.36;98.24
85045;2023;26;26;0;100;0;196793.653846154;2510.69230769231;78.4615384615385
85046;2023;50;50;0;100;0;207807.98;2186.36;98.5
85047;2023;306;231;75;75.4901960784314;24.5098039215686;232209.89869281;2724.60130718954;86.4705882352941
85049;2023;24;24;0;100;0;182829.958333333;1931.04166666667;94.7916666666667
85050;2023;35;35;0;100;0;202750.885714286;2000.08571428571;98.2
85051;2023;107;94;13;87.8504672897196;12.1495327102804;164188.943925234;1825.24299065421;91.0467289719626
85054;2023;18;18;0;100;0;204158.333333333;2413.27777777778;84.1666666666667
85055;2023;14;14;0;100;0;228125.357142857;2185.35714285714;102
85056;2023;4;4;0;100;0;106375;1461.25;74.25
85058;2023;12;12;0;100;0;231276.416666667;2029.91666666667;113.333333333333
85059;2023;29;29;0;100;0;145285.931034483;1408.65517241379;104.689655172414
85061;2023;19;19;0;100;0;206702.631578947;2099.21052631579;101.421052631579
85062;2023;16;16;0;100;0;242884.375;2569.6875;98.3125
85064;2023;22;22;0;100;0;204897.727272727;2039.68181818182;105.045454545455
85065;2023;35;35;0;100;0;175739.828571429;1938;101.857142857143
85066;2023;9;9;0;100;0;138017.888888889;1682.22222222222;82.7777777777778
85067;2023;10;10;0;100;0;179802;1815.2;99.8
85070;2023;50;48;2;96;4;209280.46;2424.06;91.1
85071;2023;58;57;1;98.2758620689655;1.72413793103448;243396.913793103;2662.63793103448;92.1724137931034
85072;2023;13;13;0;100;0;208776.923076923;2023.30769230769;102.692307692308
85073;2023;9;9;0;100;0;193777.777777778;1777.22222222222;109.333333333333
85074;2023;2;2;0;100;0;98000;1408.5;84
85076;2023;38;38;0;100;0;255333.842105263;2575.05263157895;101.526315789474
85077;2023;10;10;0;100;0;157800;1524.3;100
85078;2023;11;11;0;100;0;129000;1355.09090909091;96.8181818181818
85080;2023;11;11;0;100;0;156972.727272727;1416.27272727273;110.363636363636
85081;2023;35;34;1;97.1428571428571;2.85714285714286;260674.971428571;2363.57142857143;115.485714285714
85082;2023;18;18;0;100;0;233206.333333333;2067.77777777778;108.888888888889
85083;2023;43;43;0;100;0;415106.976744186;4697.20930232558;90.4186046511628
85084;2023;85;83;2;97.6470588235294;2.35294117647059;206973.8;2265.12941176471;96.8352941176471
85086;2023;16;15;1;93.75;6.25;169789.3125;1991.75;87.9375
85087;2023;6;6;0;100;0;88715.5;734.833333333333;118
85088;2023;67;64;3;95.5223880597015;4.47761194029851;344278.432835821;3517.9552238806;98.3283582089552
85089;2023;46;46;0;100;0;218357.760869565;2286.28260869565;97.4130434782609
85090;2023;54;54;0;100;0;169095.407407407;1679.18518518519;102.796296296296
85092;2023;213;176;37;82.6291079812207;17.3708920187793;146021.727699531;1643.54460093897;90.3192488262911
85093;2023;13;13;0;100;0;167285.076923077;1899.46153846154;90.4615384615385
85094;2023;19;19;0;100;0;157321;1570.31578947368;111.894736842105
85095;2023;29;29;0;100;0;209005.620689655;2294.44827586207;91.6896551724138
85096;2023;56;55;1;98.2142857142857;1.78571428571429;226528.214285714;2401.78571428571;95.3392857142857
85097;2023;30;30;0;100;0;197811.833333333;2046.7;99.1666666666667
85098;2023;19;19;0;100;0;248982.842105263;2558.63157894737;98.2631578947368
85099;2023;15;14;1;93.3333333333333;6.66666666666667;235266.666666667;2629.13333333333;90.7333333333333
85100;2023;20;20;0;100;0;272971.8;3171.75;90
85101;2023;3;3;0;100;0;186833.333333333;1841.66666666667;101.666666666667
85102;2023;15;15;0;100;0;208618.466666667;1988.06666666667;104.4
85103;2023;28;28;0;100;0;245946.142857143;2642.57142857143;93.4642857142857
85104;2023;25;25;0;100;0;199105.28;2776;78.56
85105;2023;10;10;0;100;0;167278;1375;113.2
85106;2023;39;36;3;92.3076923076923;7.69230769230769;390527.435897436;4930.05128205128;87.1538461538462
85108;2023;36;35;1;97.2222222222222;2.77777777777778;200878.833333333;2281.83333333333;90.3611111111111
85109;2023;177;160;17;90.3954802259887;9.6045197740113;211953.395480226;2378.13559322034;90.4293785310734
85110;2023;11;11;0;100;0;112255.454545455;1040.54545454545;98.2727272727273
85111;2023;30;30;0;100;0;111803.333333333;1644.06666666667;79.0333333333333
85112;2023;46;46;0;100;0;274415.304347826;3397.02173913043;81.9347826086957
85113;2023;82;76;6;92.6829268292683;7.31707317073171;620632.597560976;7041.39024390244;92.5365853658537
85114;2023;131;97;34;74.0458015267176;25.9541984732824;265004.038167939;3801.03816793893;73.2824427480916
85115;2023;8;8;0;100;0;142635.5;1476.625;98.75
85116;2023;7;7;0;100;0;225357.142857143;2129.71428571429;108.714285714286
85117;2023;5;5;0;100;0;128384;1808.2;68.8
85118;2023;20;20;0;100;0;220573.75;2256.2;100.6
85119;2023;20;20;0;100;0;178278.2;1944.85;99.05
85120;2023;23;23;0;100;0;259126.608695652;2993.60869565217;93.304347826087
85121;2023;11;11;0;100;0;141454.545454545;1682.09090909091;86.7272727272727
85123;2023;4;4;0;100;0;145000;1549;109.75
85125;2023;5;5;0;100;0;164385.2;1561.8;103.6
85126;2023;14;14;0;100;0;191933.785714286;1816.92857142857;109.5
85127;2023;79;68;11;86.0759493670886;13.9240506329114;230946.746835443;3160.73417721519;77.126582278481
85128;2023;154;138;16;89.6103896103896;10.3896103896104;183283.707792208;2053.34415584416;91.7142857142857
85129;2023;33;33;0;100;0;209560.333333333;2144.36363636364;100.424242424242
85130;2023;11;11;0;100;0;240381.818181818;2746.09090909091;101.090909090909
85131;2023;20;20;0;100;0;193308.2;2016.25;101.1
85132;2023;16;16;0;100;0;155328.125;1550;101.5
85133;2023;17;17;0;100;0;133723.529411765;1369.29411764706;103.588235294118
85134;2023;4;4;0;100;0;249600;1935;123.25
85135;2023;29;28;1;96.551724137931;3.44827586206897;170991.965517241;1902.93103448276;94.8965517241379
85136;2023;1;1;0;100;0;84000;944;89
85137;2023;4;4;0;100;0;131625;1096;116
85138;2023;9;9;0;100;0;234666.666666667;2276.11111111111;104.666666666667
85139;2023;1;1;0;100;0;299587;1248;240
85140;2023;13;13;0;100;0;141412.461538462;1440.76923076923;100.230769230769
85141;2023;9;9;0;100;0;165294.111111111;1558.55555555556;105.888888888889
85142;2023;15;15;0;100;0;210630.2;2118.06666666667;100.4
85143;2023;17;17;0;100;0;134544.117647059;1826.82352941176;87.2941176470588
85144;2023;15;15;0;100;0;184103.333333333;1867.86666666667;101.2
85145;2023;9;9;0;100;0;198111.111111111;1523.77777777778;118.333333333333
85146;2023;192;175;17;91.1458333333333;8.85416666666667;223852.932291667;2512.63020833333;92.2864583333333
85147;2023;24;24;0;100;0;132951.375;1333.91666666667;97.375
85148;2023;11;11;0;100;0;179454.545454545;1738.45454545455;102.636363636364
85149;2023;5;5;0;100;0;153600;1700;90.4
85151;2023;54;53;1;98.1481481481482;1.85185185185185;190130;2162;93.2962962962963
85152;2023;77;76;1;98.7012987012987;1.2987012987013;256089.025974026;2681.18181818182;98.0779220779221
85153;2023;38;38;0;100;0;167210.894736842;1811.92105263158;98.4210526315789
85154;2023;29;29;0;100;0;134143.172413793;1425.86206896552;97.448275862069
85155;2023;54;54;0;100;0;280504.981481481;2674.96296296296;103.574074074074
85156;2023;25;24;1;96;4;192397.16;2258.68;89.16
85157;2023;13;13;0;100;0;190269.230769231;1800.69230769231;107.615384615385
85158;2023;19;19;0;100;0;198307.894736842;1580.63157894737;132.210526315789
85159;2023;28;28;0;100;0;143232.142857143;1525.39285714286;100.107142857143
85160;2023;26;25;1;96.1538461538462;3.84615384615385;238878.653846154;2398.46153846154;99.8076923076923
85161;2023;32;32;0;100;0;206094.84375;2656.8125;85.40625
85162;2023;22;22;0;100;0;162996.818181818;1425;118.090909090909
85163;2023;110;97;13;88.1818181818182;11.8181818181818;482984.9;6024.86363636364;82.1
85164;2023;64;34;30;53.125;46.875;205819.078125;3725.625;57.75
85167;2023;10;10;0;100;0;184339;1784.4;97.2
85169;2023;12;12;0;100;0;187875;1985.5;97.0833333333333
85171;2023;6;6;0;100;0;122283.333333333;1467.16666666667;92.6666666666667
85172;2023;29;28;1;96.551724137931;3.44827586206897;218909.827586207;2459.65517241379;90.7241379310345
85174;2023;11;11;0;100;0;131285.454545455;1229.63636363636;110.363636363636
85175;2023;14;14;0;100;0;143785.214285714;1628.35714285714;93.2142857142857
85176;2023;7;7;0;100;0;186521.428571429;1692.28571428571;114.571428571429
85177;2023;11;11;0;100;0;160652.181818182;1387.72727272727;117.818181818182
85178;2023;86;84;2;97.6744186046512;2.32558139534884;217027.709302326;2258.54651162791;96.5581395348837
85179;2023;21;21;0;100;0;212706.19047619;2438.80952380952;90.7142857142857
85181;2023;9;9;0;100;0;141811.111111111;1409.77777777778;103.444444444444
85182;2023;80;66;14;82.5;17.5;138974.6625;1568.2625;92.8375
85184;2023;7;6;1;85.7142857142857;14.2857142857143;150116.428571429;1704;101.571428571429
85185;2023;8;8;0;100;0;137876.25;1395;106.5
85186;2023;9;9;0;100;0;261333.333333333;2432.66666666667;105.111111111111
85187;2023;15;15;0;100;0;143756.666666667;1451.6;99.1333333333333
85188;2023;8;8;0;100;0;159250;1534;108.5
85189;2023;24;24;0;100;0;272297.916666667;2834.58333333333;96.75
85190;2023;32;31;1;96.875;3.125;202745.46875;2203.15625;97.4375
85191;2023;822;433;389;52.676399026764;47.323600973236;185944.326034063;2599.47810218978;73.9586374695864
85192;2023;12;12;0;100;0;200904.5;1878.75;104.75
85193;2023;8;8;0;100;0;131600;1302.25;101.75
85194;2023;1055;608;447;57.6303317535545;42.3696682464455;323683.570616114;4699.18672985782;72.060663507109
85196;2023;15;15;0;100;0;177006.666666667;1966.33333333333;97
85197;2023;29;29;0;100;0;215237.24137931;2047.37931034483;105.48275862069
85198;2023;19;19;0;100;0;215338.526315789;1910.10526315789;113.105263157895
85199;2023;5;5;0;100;0;234800;1787.6;128
85200;2023;13;13;0;100;0;241421.923076923;2120.07692307692;118.230769230769
85201;2023;13;13;0;100;0;184438.461538462;2324.53846153846;84.9230769230769
85202;2023;19;19;0;100;0;163225.684210526;1658.47368421053;106.105263157895
85204;2023;26;26;0;100;0;244352.884615385;2273.30769230769;107.846153846154
85205;2023;9;9;0;100;0;125755.777777778;1144.11111111111;107.777777777778
85206;2023;15;15;0;100;0;113818.666666667;1666.2;70
85207;2023;7;7;0;100;0;161628.571428571;1707.42857142857;103.714285714286
85208;2023;38;38;0;100;0;184577.710526316;1743.07894736842;105.552631578947
85209;2023;8;8;0;100;0;135106.25;1324.5;106.75
85210;2023;19;19;0;100;0;176632;1802.15789473684;99.4736842105263
85211;2023;28;28;0;100;0;207387.285714286;2478.25;85.1428571428571
85213;2023;48;47;1;97.9166666666667;2.08333333333333;191690.125;1983.33333333333;98.7291666666667
85214;2023;31;31;0;100;0;275311.483870968;2861.48387096774;97.6451612903226
85215;2023;41;38;3;92.6829268292683;7.31707317073171;167722.731707317;1800.53658536585;95.0975609756098
85216;2023;20;19;1;95;5;203568.95;1815.5;113.85
85218;2023;30;30;0;100;0;229371.666666667;2309.03333333333;98.5
85220;2023;11;11;0;100;0;169500;1808.63636363636;93.9090909090909
85221;2023;32;32;0;100;0;261913.75;2562.1875;104.53125
85222;2023;227;117;110;51.5418502202643;48.4581497797357;304949.757709251;4685.66519823789;64.8149779735683
85223;2023;45;44;1;97.7777777777778;2.22222222222222;159562.466666667;1598.28888888889;98.4888888888889
85226;2023;493;240;253;48.6815415821501;51.3184584178499;210041.770791075;3639.40567951318;59.2292089249493
85227;2023;33;32;1;96.969696969697;3.03030303030303;119027.424242424;1198.15151515152;104.909090909091
85229;2023;7;7;0;100;0;156785.714285714;1198.85714285714;133
85231;2023;13;13;0;100;0;236805.461538462;2485.15384615385;95
85232;2023;15;15;0;100;0;159779.8;1611.46666666667;98.2666666666667
85233;2023;5;5;0;100;0;194600;1496.8;141.6
85234;2023;400;178;222;44.5;55.5;191881.2125;3511.8075;57.8975
85235;2023;9;9;0;100;0;130879.222222222;1544.66666666667;82.4444444444444
85236;2023;25;25;0;100;0;277516.24;2759.24;101.72
85237;2023;3;3;0;100;0;90666.6666666667;1148;80
85238;2023;32;31;1;96.875;3.125;207660.9375;2146.65625;96.0625
85239;2023;9;9;0;100;0;198383.333333333;2127.11111111111;98
85240;2023;9;9;0;100;0;199040.555555556;1966.55555555556;102.333333333333
85242;2023;6;6;0;100;0;258583.333333333;1889.33333333333;138.166666666667
85243;2023;41;41;0;100;0;252889.756097561;3160.92682926829;83.8536585365854
85244;2023;10;10;0;100;0;166450;1505.4;107
85245;2023;2;2;0;100;0;83750;1239.5;69
85246;2023;18;18;0;100;0;187475.166666667;1757.16666666667;111.166666666667
85247;2023;7;7;0;100;0;217285.714285714;2434.14285714286;89.7142857142857
85248;2023;8;8;0;100;0;114500;1020.375;110.125
85250;2023;39;39;0;100;0;221907.102564103;2486;93.3076923076923
85251;2023;10;10;0;100;0;138580;1291.2;105.9
85252;2023;9;9;0;100;0;124278.444444444;1262.77777777778;99.8888888888889
85254;2023;28;28;0;100;0;135393.178571429;1392.42857142857;98.9642857142857
85255;2023;49;49;0;100;0;173691.591836735;1917.34693877551;93.6938775510204
85256;2023;18;18;0;100;0;156107.777777778;1577.66666666667;96.7222222222222
85259;2023;6;6;0;100;0;224900;2342.83333333333;99.5
85260;2023;13;13;0;100;0;195623.076923077;2049.15384615385;95.3846153846154
85261;2023;5;5;0;100;0;120200;1037.8;109
85262;2023;45;42;3;93.3333333333333;6.66666666666667;209720;2455.95555555556;88.9777777777778
85264;2023;14;14;0;100;0;136460.428571429;1278.78571428571;109.071428571429
85265;2023;15;15;0;100;0;144433.333333333;1376.06666666667;104.866666666667
85266;2023;12;12;0;100;0;135267.916666667;1537.5;83.9166666666667
85267;2023;21;21;0;100;0;207784.761904762;2178.61904761905;108.571428571429
85268;2023;23;23;0;100;0;244261.956521739;2540.17391304348;97.4347826086957
85269;2023;6;6;0;100;0;167683.333333333;1727.66666666667;97.1666666666667
85271;2023;12;12;0;100;0;161708.333333333;1273.25;134
85273;2023;22;22;0;100;0;218242.090909091;2485.81818181818;89.6818181818182
85274;2023;8;8;0;100;0;151873.75;1616.125;91.25
85276;2023;10;10;0;100;0;169550;1884.2;89.2
85277;2023;22;22;0;100;0;168291.136363636;1699.09090909091;100.136363636364
85278;2023;57;45;12;78.9473684210526;21.0526315789474;239592.01754386;3988.05263157895;64.0175438596491
85280;2023;46;45;1;97.8260869565217;2.17391304347826;257601.717391304;2658.34782608696;98.5
85281;2023;9;9;0;100;0;133437;1174.55555555556;109.555555555556
85282;2023;18;18;0;100;0;148582.444444444;1611.22222222222;91.1111111111111
85284;2023;59;59;0;100;0;260394.474576271;2864.67796610169;92.8474576271186
85285;2023;8;8;0;100;0;241947.125;2169.5;109.25
85286;2023;9;9;0;100;0;171300;1658.55555555556;106.555555555556
85287;2023;6;6;0;100;0;142161.333333333;1419.66666666667;95
85288;2023;224;145;79;64.7321428571429;35.2678571428571;258837.276785714;3567.625;73.1830357142857
85289;2023;19;19;0;100;0;173346.315789474;1506.68421052632;116.894736842105
85290;2023;4;4;0;100;0;122325;946.25;134
85291;2023;19;19;0;100;0;181200.631578947;1745.68421052632;109.315789473684
85292;2023;11;11;0;100;0;114344.363636364;1166.36363636364;103.363636363636
85293;2023;11;11;0;100;0;193143.636363636;1841.45454545455;106.545454545455
85294;2023;167;143;24;85.6287425149701;14.3712574850299;271526.71257485;4333.73652694611;66.8023952095808
85295;2023;23;23;0;100;0;232595.043478261;2188.47826086957;106.782608695652
85296;2023;9;9;0;100;0;180288.888888889;1573.11111111111;112.555555555556
85297;2023;19;19;0;100;0;157136.947368421;1858.36842105263;87.7894736842105
85298;2023;30;30;0;100;0;257216.5;2963.36666666667;87.8666666666667
85300;2023;41;41;0;100;0;245632.975609756;2606.0243902439;102.463414634146
85301;2023;14;14;0;100;0;157357.142857143;1974.42857142857;83.1428571428571
85302;2023;54;54;0;100;0;203007.444444444;2143.74074074074;103.333333333333
85303;2023;24;24;0;100;0;161741.666666667;1568.16666666667;103.541666666667
85304;2023;7;7;0;100;0;168881.142857143;1649.28571428571;107.428571428571
85305;2023;20;18;2;90;10;184615.5;1504.25;123.75
85306;2023;9;9;0;100;0;149333.333333333;1338.55555555556;116.333333333333
86001;2023;16;16;0;100;0;84904.375;1005.125;85.4375
86002;2023;4;4;0;100;0;118250;1644.25;81.25
86003;2023;4;4;0;100;0;93425;1117.25;84.75
86004;2023;6;6;0;100;0;113916.666666667;1089.83333333333;102.833333333333
86005;2023;10;10;0;100;0;123400;1052.8;117.3
86006;2023;10;10;0;100;0;115711;972;113.7
86007;2023;9;9;0;100;0;197377.777777778;1723;117.555555555556
86008;2023;4;4;0;100;0;86300;717.5;116.75
86009;2023;15;14;1;93.3333333333333;6.66666666666667;131316.666666667;1375.66666666667;102.6
86010;2023;6;6;0;100;0;182671.666666667;1785.5;107
86011;2023;3;3;0;100;0;186216.666666667;1209.66666666667;162.333333333333
86012;2023;1;1;0;100;0;90000;900;100
86013;2023;3;3;0;100;0;127966.666666667;1102;117
86014;2023;11;10;1;90.9090909090909;9.09090909090909;127772.727272727;1468.54545454545;87.0909090909091
86015;2023;34;32;2;94.1176470588235;5.88235294117647;102155;1154.85294117647;87.4705882352941
86016;2023;14;14;0;100;0;192170.714285714;1883.35714285714;102.357142857143
86017;2023;9;9;0;100;0;129666.666666667;1258.66666666667;104.333333333333
86018;2023;7;7;0;100;0;149608.571428571;1470.42857142857;104.857142857143
86019;2023;20;20;0;100;0;157230;1738.2;95.1
86020;2023;3;3;0;100;0;141000;1460;100.666666666667
86022;2023;3;3;0;100;0;91000;962;98.6666666666667
86023;2023;4;4;0;100;0;149587.5;1063;160
86024;2023;13;13;0;100;0;238762.384615385;1679.92307692308;147.461538461538
86025;2023;5;5;0;100;0;77960;1113.6;70.6
86026;2023;3;3;0;100;0;168266.666666667;1740.66666666667;99.3333333333333
86027;2023;21;21;0;100;0;230848.047619048;2497.19047619048;93.2857142857143
86028;2023;4;4;0;100;0;231250;2273.25;100.25
86029;2023;13;13;0;100;0;125484.615384615;1055.61538461538;106.923076923077
86031;2023;15;15;0;100;0;129746;1574.66666666667;81.7333333333333
86032;2023;12;12;0;100;0;149999.166666667;1568.5;94.9166666666667
86034;2023;6;6;0;100;0;107165;1209.83333333333;93
86035;2023;3;3;0;100;0;101000;982.333333333333;96.3333333333333
86036;2023;7;7;0;100;0;147985.714285714;1438.14285714286;102.714285714286
86037;2023;12;12;0;100;0;77831.25;937.5;87.3333333333333
86038;2023;2;2;0;100;0;123500;1159;107
86039;2023;8;8;0;100;0;163900;1102.5;140.125
86040;2023;5;5;0;100;0;71300;743;90.4
86041;2023;138;89;49;64.4927536231884;35.5072463768116;173519.31884058;2091.78985507246;83.268115942029
86042;2023;15;15;0;100;0;141915.333333333;1463.46666666667;95.8666666666667
86044;2023;4;4;0;100;0;116200;1260;90.25
86045;2023;17;17;0;100;0;156252.941176471;1590.58823529412;100.411764705882
86046;2023;19;18;1;94.7368421052632;5.26315789473684;148407.368421053;1581.73684210526;90.3157894736842
86047;2023;6;6;0;100;0;119900;1388.66666666667;80.5
86048;2023;13;13;0;100;0;172216.692307692;1793.76923076923;98.6923076923077
86049;2023;7;7;0;100;0;155671.428571429;1409.28571428571;100.857142857143
86050;2023;9;9;0;100;0;140337.777777778;1257.44444444444;111.555555555556
86051;2023;1;1;0;100;0;215000;1361;158
86052;2023;15;15;0;100;0;138813.333333333;1496.73333333333;98.6666666666667
86053;2023;13;13;0;100;0;169453.846153846;1949.92307692308;93.9230769230769
86054;2023;6;6;0;100;0;120451.166666667;1018.66666666667;125
86055;2023;9;9;0;100;0;123353.888888889;1262.11111111111;97.8888888888889
86058;2023;5;5;0;100;0;139991.6;1926.8;77.6
86059;2023;9;9;0;100;0;105486.111111111;1073.33333333333;94.4444444444444
86061;2023;19;19;0;100;0;85038.0526315789;963.842105263158;91.6842105263158
86062;2023;47;31;16;65.9574468085106;34.0425531914894;150625.531914894;2238.34042553192;79.6382978723404
86063;2023;5;5;0;100;0;75193.4;881;98.8
86064;2023;9;9;0;100;0;120867.222222222;1165.66666666667;108.111111111111
86065;2023;14;14;0;100;0;175035.714285714;1815.5;99.8571428571429
86066;2023;424;325;99;76.6509433962264;23.3490566037736;116158.266509434;1444.69339622642;82.3018867924528
86068;2023;25;25;0;100;0;135332.72;1292.44;110.04
86069;2023;3;3;0;100;0;164000;1329.33333333333;119
86070;2023;85;84;1;98.8235294117647;1.17647058823529;140899.811764706;1709.49411764706;86.4352941176471
86072;2023;7;7;0;100;0;98571.4285714286;1206.57142857143;87.5714285714286
86073;2023;7;7;0;100;0;159016;976.285714285714;163.428571428571
86074;2023;12;12;0;100;0;179291.666666667;1499.25;118.833333333333
86075;2023;7;7;0;100;0;126990.142857143;1464.28571428571;88.7142857142857
86076;2023;28;28;0;100;0;231496.071428571;2111.71428571429;111.678571428571
86077;2023;10;10;0;100;0;121850;1373.4;87.9
86078;2023;37;35;2;94.5945945945946;5.40540540540541;130982.540540541;1336.43243243243;106.594594594595
86079;2023;12;12;0;100;0;117641.666666667;1059.75;110.833333333333
86080;2023;6;6;0;100;0;145050;1476.83333333333;95.8333333333333
86081;2023;16;16;0;100;0;132947.9375;1298.25;100.4375
86082;2023;72;72;0;100;0;122884.722222222;1271.08333333333;103.125
86083;2023;17;17;0;100;0;158729.882352941;1630.94117647059;98
86084;2023;15;15;0;100;0;85658.8666666667;853.466666666667;101.6
86085;2023;4;4;0;100;0;162750;1415.75;116.75
86086;2023;10;10;0;100;0;105700;1401.5;77.9
86087;2023;2;2;0;100;0;89000;787.5;116
86088;2023;5;3;2;60;40;163376;2071.8;79.4
86089;2023;7;7;0;100;0;172278;1157;154.857142857143
86090;2023;3;3;0;100;0;116666.666666667;1262.66666666667;94
86091;2023;3;3;0;100;0;83333.3333333333;976.666666666667;94.6666666666667
86092;2023;25;25;0;100;0;118918.6;1361.44;88.72
86093;2023;4;4;0;100;0;190000;1723.5;108.75
86094;2023;3;3;0;100;0;179750;1603.66666666667;110
86095;2023;22;22;0;100;0;176095.909090909;1667;107.545454545455
86096;2023;6;6;0;100;0;177081.666666667;1400.16666666667;119.5
86097;2023;1;1;0;100;0;210000;2283;92
86098;2023;2;2;0;100;0;145000;1384.5;105
86099;2023;16;16;0;100;0;135081.25;1658.375;83.5625
86100;2023;33;33;0;100;0;229042.151515152;2144.81818181818;106.30303030303
86102;2023;1;1;0;100;0;90000;1125;80
86103;2023;21;21;0;100;0;130164.952380952;1217.52380952381;107.380952380952
86104;2023;11;11;0;100;0;119424.545454545;1413.72727272727;87
86105;2023;4;4;0;100;0;137500;1056.5;133.25
86107;2023;9;9;0;100;0;77748.8888888889;841;84.1111111111111
86108;2023;6;6;0;100;0;77333.3333333333;830.333333333333;87.6666666666667
86109;2023;4;4;0;100;0;116562.5;867.25;127.5
86110;2023;2;2;0;100;0;141500;1781.5;70.5
86111;2023;16;16;0;100;0;142643.75;1563.5;88.75
86112;2023;18;18;0;100;0;106525.944444444;1092.61111111111;97.1666666666667
86113;2023;37;36;1;97.2972972972973;2.7027027027027;169026.756756757;1740.2972972973;103.648648648649
86114;2023;12;12;0;100;0;159016.666666667;1667.25;96.5833333333333
86115;2023;93;79;14;84.9462365591398;15.0537634408602;156201.838709677;1817.03225806452;90.0860215053764
86116;2023;13;13;0;100;0;124576.923076923;1250.46153846154;105
86117;2023;4;4;0;100;0;133681.25;1132;115
86118;2023;8;8;0;100;0;146428.875;1390.875;90
86119;2023;8;8;0;100;0;101989.875;821;116.625
86120;2023;30;30;0;100;0;88694.6;953.8;93.8666666666667
86121;2023;26;26;0;100;0;143396.153846154;1392.11538461538;105.192307692308
86122;2023;1;1;0;100;0;35000;427;82
86123;2023;33;33;0;100;0;133740.575757576;1245.06060606061;104.090909090909
86124;2023;20;20;0;100;0;180868.5;1630.2;113.75
86125;2023;4;4;0;100;0;132175;1464.25;94.75
86126;2023;7;7;0;100;0;101142.857142857;987.714285714286;103.857142857143
86127;2023;2;2;0;100;0;125000;1139.5;115
86128;2023;31;30;1;96.7741935483871;3.2258064516129;113901.129032258;1254;96.7741935483871
86129;2023;13;13;0;100;0;93292.3076923077;1008.38461538462;87.0769230769231
86130;2023;8;8;0;100;0;113056.25;1273.875;95.375
86131;2023;15;15;0;100;0;123433.333333333;1317.26666666667;101.4
86132;2023;8;8;0;100;0;154937.5;1306.125;109.625
86133;2023;33;31;2;93.9393939393939;6.06060606060606;235757.575757576;2507.90909090909;94.1818181818182
86134;2023;2;2;0;100;0;157977.5;2070;93
86135;2023;3;3;0;100;0;211508.333333333;1378.33333333333;149.666666666667
86136;2023;5;5;0;100;0;121532;1143.6;97.8
86137;2023;98;86;12;87.7551020408163;12.2448979591837;109229.591836735;1187.36734693878;93.8061224489796
86138;2023;6;6;0;100;0;84500;819;100.333333333333
86139;2023;25;25;0;100;0;120276;1371.2;86.68
86140;2023;33;33;0;100;0;104683.03030303;1210.21212121212;87.3030303030303
86141;2023;6;6;0;100;0;145250;1468.83333333333;108.166666666667
86142;2023;4;4;0;100;0;110600;1048.75;112.25
86143;2023;4;4;0;100;0;112950;1020;114.75
86144;2023;5;5;0;100;0;131200;1435.2;92
86145;2023;7;7;0;100;0;180142.857142857;1805.42857142857;101.142857142857
86147;2023;15;15;0;100;0;173703.333333333;1486.2;115.6
86148;2023;9;8;1;88.8888888888889;11.1111111111111;200505.555555556;1567.22222222222;132
86149;2023;9;9;0;100;0;122333.333333333;1061;118.555555555556
86150;2023;3;3;0;100;0;124600;1002.33333333333;124.666666666667
86151;2023;2;2;0;100;0;207760.5;1381;147.5
86152;2023;14;14;0;100;0;104666.428571429;1196.57142857143;88.3571428571429
86153;2023;15;15;0;100;0;96166.6666666667;1527;79.5333333333333
86156;2023;4;4;0;100;0;117250;1136.5;109.75
86157;2023;47;38;9;80.8510638297872;19.1489361702128;234614.70212766;2714.95744680851;91.0851063829787
86158;2023;63;59;4;93.6507936507936;6.34920634920635;222617.301587302;2067.77777777778;109.111111111111
86159;2023;9;9;0;100;0;171622.222222222;1065;145
86160;2023;13;13;0;100;0;160517.692307692;1280.30769230769;126.461538461538
86161;2023;11;11;0;100;0;134770.636363636;1105.36363636364;119.909090909091
86162;2023;1;1;0;100;0;75000;824;91
86163;2023;32;30;2;93.75;6.25;276377.28125;2361.5625;117.0625
86164;2023;10;10;0;100;0;173960;1426.5;120.8
86165;2023;68;65;3;95.5882352941177;4.41176470588235;100508.705882353;1213.60294117647;85.9852941176471
86167;2023;10;10;0;100;0;104700;988.7;107.8
86169;2023;2;2;0;100;0;136250;2215.5;67
86170;2023;11;11;0;100;0;81090.9090909091;933.545454545455;83.9090909090909
86171;2023;11;11;0;100;0;96818.1818181818;1158.18181818182;89.9090909090909
86172;2023;3;3;0;100;0;56000;733.666666666667;75.6666666666667
86173;2023;6;6;0;100;0;127333.333333333;989.833333333333;141
86174;2023;58;58;0;100;0;141738.431034483;1549.1724137931;91.8965517241379
86175;2023;2;2;0;100;0;98700;3196;41.5
86176;2023;6;6;0;100;0;98166.6666666667;979.333333333333;96.6666666666667
86177;2023;85;80;5;94.1176470588235;5.88235294117647;184911.317647059;1842.01176470588;102.576470588235
86178;2023;19;19;0;100;0;178717.368421053;1783.31578947368;99.3684210526316
86180;2023;28;28;0;100;0;241666.071428571;2164.96428571429;112.392857142857
86181;2023;4;4;0;100;0;197625;2139.75;91
86182;2023;5;5;0;100;0;69400;912.2;85
86183;2023;13;13;0;100;0;129396.153846154;1246.76923076923;112.461538461538
86184;2023;13;13;0;100;0;143969.230769231;1231.15384615385;115.538461538462
86186;2023;5;5;0;100;0;129300;1229.2;101.4
86187;2023;5;5;0;100;0;148000;1466.2;100.2
86189;2023;9;9;0;100;0;115821;1156.66666666667;100
86190;2023;16;16;0;100;0;111252.375;1119.875;96.4375
86191;2023;9;9;0;100;0;88832.2222222222;1026.77777777778;88.6666666666667
86192;2023;3;3;0;100;0;150000;1241.33333333333;109
86193;2023;11;11;0;100;0;66818.1818181818;877.545454545455;77.0909090909091
86194;2023;1265;449;816;35.4940711462451;64.505928853755;146763.859288538;2307.10039525692;66.7517786561265
86195;2023;8;8;0;100;0;80289;1395.25;62.875
86196;2023;7;7;0;100;0;113285.714285714;1169.14285714286;98.7142857142857
86197;2023;5;5;0;100;0;116330;1403.2;92.6
86198;2023;9;9;0;100;0;188166.666666667;1455;136.555555555556
86200;2023;15;15;0;100;0;128120.533333333;1360;90.7333333333333
86201;2023;2;2;0;100;0;52000;575.5;92
86202;2023;5;5;0;100;0;78750;1117.8;70.6
86203;2023;9;9;0;100;0;132933.222222222;1225.11111111111;91.7777777777778
86204;2023;23;23;0;100;0;192421.739130435;1875.82608695652;107.608695652174
86205;2023;2;2;0;100;0;96500;2177;51
86206;2023;1;1;0;100;0;79000;952;83
86207;2023;25;18;7;72;28;117148.72;1366.28;88.48
86209;2023;21;20;1;95.2380952380952;4.76190476190476;187300;1802.66666666667;107.333333333333
86210;2023;5;5;0;100;0;121000;1164;108
86211;2023;18;18;0;100;0;106167.5;1024;99
86213;2023;26;26;0;100;0;113144.307692308;1112;103.384615384615
86214;2023;69;49;20;71.0144927536232;28.9855072463768;195491.289855072;2181.40579710145;89.1014492753623
86217;2023;3;3;0;100;0;72000;1275;63.3333333333333
86218;2023;2;2;0;100;0;51500;570.5;90.5
86220;2023;7;7;0;100;0;128964.285714286;1272.57142857143;97.4285714285714
86221;2023;5;5;0;100;0;121480;1198;106.8
86222;2023;40;38;2;95;5;206197.25;2231.675;94.05
86223;2023;14;14;0;100;0;124842.857142857;1128.85714285714;104.5
86224;2023;8;8;0;100;0;115473.75;1238.875;93.5
86225;2023;20;20;0;100;0;114094.85;1224.15;99.8
86226;2023;25;24;1;96;4;183324;2020.2;91.52
86227;2023;1;1;0;100;0;80000;2000;40
86229;2023;9;9;0;100;0;137716.222222222;1238.66666666667;106.777777777778
86230;2023;2;2;0;100;0;131000;1233;91
86231;2023;8;8;0;100;0;133310;1126.75;113.375
86233;2023;36;36;0;100;0;148002.166666667;1620.61111111111;95.3611111111111
86234;2023;11;11;0;100;0;89395.4545454545;854;103.909090909091
86235;2023;14;14;0;100;0;129228.571428571;1415.57142857143;88.1428571428571
86236;2023;10;10;0;100;0;175950;1804.9;84.7
86237;2023;6;6;0;100;0;141648.333333333;1537.5;95.3333333333333
86239;2023;1;1;0;100;0;93000;894;104
86241;2023;10;10;0;100;0;125145;1435.1;86.9
86242;2023;7;7;0;100;0;77629.2857142857;850;82.4285714285714
86244;2023;24;23;1;95.8333333333333;4.16666666666667;109218.458333333;1126.54166666667;99.25
86245;2023;18;18;0;100;0;207254.444444444;1832.77777777778;110.5
86246;2023;16;15;1;93.75;6.25;90626.9375;1077.75;84.6875
86247;2023;11;11;0;100;0;88827.2727272727;1137.54545454545;80.1818181818182
86248;2023;5;5;0;100;0;86600;841;102
86249;2023;1;1;0;100;0;175070;1563;112
86250;2023;2;2;0;100;0;88500;1107.5;73.5
86252;2023;8;8;0;100;0;160826.875;1623.875;106.25
86253;2023;7;7;0;100;0;154631.428571429;1654.71428571429;98.5714285714286
86254;2023;12;12;0;100;0;117087.5;1189.25;92.5833333333333
86255;2023;23;23;0;100;0;144892.608695652;1209.08695652174;116.521739130435
86256;2023;10;10;0;100;0;211920;1930.7;112.5
86257;2023;4;4;0;100;0;125500;1052.5;106.25
86258;2023;19;19;0;100;0;131415.789473684;1249.15789473684;105.210526315789
86260;2023;4;4;0;100;0;82425;944.75;78
86261;2023;23;23;0;100;0;197681.304347826;1992.65217391304;99.1739130434783
86262;2023;6;6;0;100;0;46666.6666666667;665;72.5
86263;2023;31;30;1;96.7741935483871;3.2258064516129;195148.387096774;2002.45161290323;97.3548387096774
86264;2023;14;14;0;100;0;99048.5714285714;1042;93.5714285714286
86265;2023;3;3;0;100;0;116333.333333333;1298;95
86266;2023;6;6;0;100;0;70433.3333333333;955.666666666667;73
86268;2023;17;17;0;100;0;201130;1803.29411764706;113.764705882353
86269;2023;3;3;0;100;0;49800;648;77.6666666666667
86270;2023;1;1;0;100;0;32000;400;80
86271;2023;13;13;0;100;0;131090;1242.15384615385;109.230769230769
86272;2023;31;31;0;100;0;148124.838709677;1452.70967741935;99.5806451612903
86273;2023;20;20;0;100;0;114937.4;1053.9;109.65
86274;2023;4;4;0;100;0;203350;1483.5;141
86275;2023;2;2;0;100;0;128500;1196.5;108
86276;2023;20;20;0;100;0;83200;983.15;84.95
86279;2023;5;5;0;100;0;132800;1511;82
86281;2023;64;64;0;100;0;165804.265625;1643.84375;106.65625
86284;2023;8;8;0;100;0;116812.5;1279.75;97.75
86285;2023;13;13;0;100;0;114738.461538462;1412.23076923077;90.6153846153846
86286;2023;5;5;0;100;0;88240;965.2;90
86287;2023;3;3;0;100;0;232666.666666667;1966.66666666667;120.666666666667
86288;2023;12;12;0;100;0;80279.1666666667;1048.83333333333;79.6666666666667
86289;2023;9;9;0;100;0;133079.222222222;1201.22222222222;102.444444444444
86290;2023;15;14;1;93.3333333333333;6.66666666666667;132712.133333333;1782.6;77.4666666666667
86291;2023;2;2;0;100;0;62500;1406;46
86292;2023;8;8;0;100;0;191731.25;1838.25;104
86293;2023;36;34;2;94.4444444444444;5.55555555555556;163922.222222222;1663.13888888889;102.805555555556
86294;2023;39;39;0;100;0;155914.102564103;1720.02564102564;93.3333333333333
86295;2023;9;9;0;100;0;106844.444444444;1094.77777777778;114.444444444444
86296;2023;5;5;0;100;0;147800;1532.2;94.6
86297;2023;69;64;5;92.7536231884058;7.2463768115942;214459.057971014;2250.97101449275;92.7536231884058
86298;2023;26;26;0;100;0;139206.269230769;1323.73076923077;102.692307692308
86299;2023;5;5;0;100;0;181365.6;1349;132.8
86300;2023;5;5;0;100;0;253980;2177;116.4
87001;2023;61;55;6;90.1639344262295;9.83606557377049;167709.344262295;1748.65573770492;97.5245901639344
87002;2023;65;57;8;87.6923076923077;12.3076923076923;135624.984615385;1586.66153846154;86.0461538461538
87003;2023;9;9;0;100;0;73055.5555555556;871.333333333333;84.8888888888889
87004;2023;3;3;0;100;0;150666.666666667;1205;116
87005;2023;8;8;0;100;0;226981.25;2044.125;112.625
87006;2023;10;10;0;100;0;137381.3;1128.4;116.8
87007;2023;8;8;0;100;0;98047.75;1031.125;102.75
87008;2023;1;1;0;100;0;157408;1431;110
87009;2023;8;7;1;87.5;12.5;132540;1461.125;92
87011;2023;41;37;4;90.2439024390244;9.75609756097561;102581.024390244;1152.36585365854;90.2439024390244
87012;2023;9;9;0;100;0;95351.6666666667;1183.11111111111;77.2222222222222
87013;2023;6;6;0;100;0;138147.5;1356.66666666667;96.5
87014;2023;31;29;2;93.5483870967742;6.45161290322581;122748.064516129;1400.38709677419;84.9677419354839
87015;2023;6;6;0;100;0;146145;1389.33333333333;105.666666666667
87016;2023;2;2;0;100;0;55500;925;60
87017;2023;8;8;0;100;0;105411.75;882.75;101.5
87018;2023;17;17;0;100;0;120976.352941176;1265.47058823529;105
87019;2023;19;19;0;100;0;228767.421052632;2171.73684210526;106.631578947368
87020;2023;12;12;0;100;0;164358.333333333;1447.58333333333;114.583333333333
87021;2023;36;36;0;100;0;199432.777777778;2090.41666666667;96.4444444444444
87022;2023;1;1;0;100;0;55000;821;67
87023;2023;4;4;0;100;0;163700;1603;103.5
87024;2023;23;23;0;100;0;91190.4347826087;1121.86956521739;81.6521739130435
87025;2023;10;10;0;100;0;158699;1451.5;105.2
87027;2023;36;36;0;100;0;117397.722222222;1411.11111111111;86.2777777777778
87028;2023;47;47;0;100;0;99604.5531914894;1036.27659574468;96.3404255319149
87029;2023;6;6;0;100;0;108933.333333333;866;132.333333333333
87030;2023;17;17;0;100;0;147196.647058824;1744.11764705882;88.2352941176471
87031;2023;5;5;0;100;0;109570;914.4;111
87032;2023;23;23;0;100;0;94796.9565217391;1062.60869565217;98.695652173913
87033;2023;5;5;0;100;0;120194.4;1203.4;100.4
87034;2023;18;18;0;100;0;91098.8333333333;1188.66666666667;75.1111111111111
87035;2023;2;2;0;100;0;109000;1161;98.5
87036;2023;11;11;0;100;0;94895.4545454545;1109.45454545455;83.6363636363636
87037;2023;5;5;0;100;0;56400;1019;58.2
87038;2023;9;9;0;100;0;200317.777777778;1874.77777777778;111.444444444444
87039;2023;15;15;0;100;0;155242.8;1558.66666666667;112.266666666667
87040;2023;17;17;0;100;0;123886.647058824;1218;96.5882352941177
87041;2023;37;37;0;100;0;80055.4594594595;1136.24324324324;72.7297297297297
87042;2023;3;3;0;100;0;217666.666666667;1389.33333333333;109.666666666667
87043;2023;4;4;0;100;0;91250;1152.25;89.25
87044;2023;6;6;0;100;0;114291.666666667;1254.5;91.8333333333333
87045;2023;18;18;0;100;0;115546.444444444;1227;93.2222222222222
87046;2023;18;18;0;100;0;127965.555555556;1714.16666666667;76.6111111111111
87047;2023;16;16;0;100;0;130270.125;1430.4375;94.0625
87048;2023;55;51;4;92.7272727272727;7.27272727272727;204977.145454545;1965.70909090909;104.672727272727
87049;2023;24;22;2;91.6666666666667;8.33333333333333;95400.2083333333;995;90.2916666666667
87050;2023;101;74;27;73.2673267326733;26.7326732673267;188678.534653465;2122.41584158416;91.5049504950495
87051;2023;15;15;0;100;0;87196.6666666667;879.666666666667;98.1333333333333
87052;2023;3;3;0;100;0;65133.3333333333;818;82
87053;2023;7;7;0;100;0;126521.428571429;1164;102.571428571429
87054;2023;18;18;0;100;0;119618.333333333;1231.05555555556;98.8888888888889
87056;2023;2;2;0;100;0;68500;836;77.5
87057;2023;15;15;0;100;0;115975.4;1217.46666666667;99.8666666666667
87058;2023;3;3;0;100;0;205753.333333333;1998;102.333333333333
87059;2023;20;18;2;90;10;109439.1;1246.65;91.2
87060;2023;14;14;0;100;0;100208;1178.85714285714;84.3571428571429
87061;2023;16;16;0;100;0;95578.125;982.4375;98.5625
87062;2023;3;3;0;100;0;209400;1623.33333333333;122.666666666667
87063;2023;2;2;0;100;0;151000;1934;78.5
87064;2023;33;30;3;90.9090909090909;9.09090909090909;123406.787878788;1379.15151515152;87.0909090909091
87065;2023;55;53;2;96.3636363636364;3.63636363636364;221188.545454545;2106.67272727273;106.745454545455
87066;2023;8;8;0;100;0;167943.75;1846.375;98.25
87067;2023;10;10;0;100;0;129105.5;1445.3;92
87068;2023;10;10;0;100;0;85559;776.9;102.5
87069;2023;2;2;0;100;0;59000;720.5;81
87070;2023;8;8;0;100;0;199262.5;1582.625;118.125
87071;2023;7;7;0;100;0;181307.142857143;1864;93.2857142857143
87072;2023;6;6;0;100;0;149250;1947.66666666667;69.5
87073;2023;7;7;0;100;0;164350;1441.28571428571;119.428571428571
87074;2023;5;5;0;100;0;93120;1332.8;74.4
87075;2023;73;62;11;84.9315068493151;15.0684931506849;184262.808219178;1956.21917808219;92.6164383561644
87076;2023;1;1;0;100;0;100500;1288;78
87077;2023;4;4;0;100;0;110875;1127.25;97.5
87078;2023;9;9;0;100;0;77680;958.111111111111;79.1111111111111
87079;2023;4;3;1;75;25;106500;1701.5;65
87080;2023;2;2;0;100;0;105500;1141;93
87081;2023;4;4;0;100;0;143800;1711;78.75
87082;2023;18;18;0;100;0;99277.7777777778;1198.55555555556;84.8333333333333
87083;2023;9;9;0;100;0;98146.1111111111;1058.66666666667;101.222222222222
87084;2023;3;3;0;100;0;96116.6666666667;1062.33333333333;91.6666666666667
87085;2023;1848;519;1329;28.0844155844156;71.9155844155844;121266.471861472;1798.17803030303;68.0308441558442
87086;2023;10;10;0;100;0;98415;1023.4;98.2
87087;2023;11;11;0;100;0;173724.909090909;1924.45454545455;73.8181818181818
87088;2023;13;13;0;100;0;154609.307692308;1602.30769230769;93
87089;2023;19;19;0;100;0;88458.7368421053;906.894736842105;98.1052631578947
87090;2023;3;3;0;100;0;163553.333333333;1375;122.666666666667
87091;2023;8;8;0;100;0;143361;1122.25;123.625
87092;2023;12;12;0;100;0;91526.4166666667;933.75;101.416666666667
87093;2023;7;7;0;100;0;90950;1471.85714285714;61.8571428571429
87094;2023;3;3;0;100;0;216066.666666667;1529;136
87095;2023;14;14;0;100;0;96020.2142857143;1050.64285714286;86.2857142857143
87096;2023;13;13;0;100;0;90344.1538461538;1288.84615384615;80
87097;2023;23;23;0;100;0;104698.043478261;1257.95652173913;81.304347826087
87099;2023;2;2;0;100;0;110250;1229.5;85
87100;2023;4;4;0;100;0;151250;1597.5;98.25
87101;2023;5;5;0;100;0;98984;1038;95.8
87103;2023;16;16;0;100;0;143525;1561;92.5625
87104;2023;8;8;0;100;0;94314.875;1301.75;74.75
87105;2023;16;16;0;100;0;118461.5625;1265.0625;96.25
87106;2023;26;26;0;100;0;146549.692307692;1518.26923076923;100.538461538462
87107;2023;13;13;0;100;0;161594.615384615;1583.69230769231;104
87108;2023;6;5;1;83.3333333333333;16.6666666666667;96083.3333333333;1526.16666666667;81.3333333333333
87109;2023;11;11;0;100;0;146224.545454545;1345.18181818182;97.1818181818182
87110;2023;21;20;1;95.2380952380952;4.76190476190476;165766.333333333;1549.33333333333;105.095238095238
87111;2023;27;27;0;100;0;125704.259259259;1351.77777777778;100.851851851852
87112;2023;7;7;0;100;0;108985.714285714;883;122.285714285714
87113;2023;54;54;0;100;0;168513.351851852;1833.01851851852;95.462962962963
87114;2023;121;95;26;78.5123966942149;21.4876033057851;194046.090909091;1970.07438016529;97.9338842975207
87115;2023;1;1;0;100;0;149000;1342;111
87116;2023;18;18;0;100;0;105657.5;1276.55555555556;82.3333333333333
87117;2023;27;27;0;100;0;97237.037037037;1157.92592592593;82.8888888888889
87118;2023;16;16;0;100;0;157518.75;1600.4375;98.9375
87119;2023;10;10;0;100;0;105925;1481.5;72.7
87120;2023;10;10;0;100;0;127415;1193.6;103.7
87121;2023;9;9;0;100;0;102853.111111111;1085.22222222222;93.6666666666667
87122;2023;11;11;0;100;0;112757.272727273;1240;95.1818181818182
87123;2023;2;2;0;100;0;45000;516.5;87.5
87124;2023;7;7;0;100;0;126614.285714286;1928.28571428571;76.5714285714286
87125;2023;45;45;0;100;0;185346.422222222;1949;95.7555555555556
87126;2023;52;50;2;96.1538461538462;3.84615384615385;115406.326923077;1234.80769230769;94.75
87127;2023;8;8;0;100;0;131906.25;1410.5;98.25
87128;2023;17;17;0;100;0;91293.5294117647;1129.41176470588;83.8235294117647
87129;2023;17;17;0;100;0;169545.647058824;1657.70588235294;105.764705882353
87130;2023;3;3;0;100;0;160620;1066.33333333333;155.666666666667
87131;2023;10;10;0;100;0;103433;1392;95.4
87132;2023;3;3;0;100;0;46750;947;62
87133;2023;5;5;0;100;0;96724;892;110.6
87134;2023;4;4;0;100;0;108000;1143.5;78.75
87135;2023;15;15;0;100;0;101996;1275.13333333333;83.8
87137;2023;4;4;0;100;0;174562.5;2085;78.5
87138;2023;6;6;0;100;0;178877.833333333;1645.5;114.333333333333
87139;2023;12;12;0;100;0;93234.8333333333;1424.75;81
87140;2023;15;15;0;100;0;136985.266666667;1434.6;92.4
87141;2023;8;8;0;100;0;110602.25;1277.75;90.125
87142;2023;4;4;0;100;0;113075;1040.5;107
87143;2023;17;17;0;100;0;156599.941176471;1600.29411764706;95.4705882352941
87144;2023;10;10;0;100;0;166485;1569.5;108.6
87145;2023;5;5;0;100;0;163401;1649.6;103.6
87146;2023;12;12;0;100;0;100100;1267.41666666667;82.1666666666667
87148;2023;8;8;0;100;0;192750;1878.5;101.5
87149;2023;13;13;0;100;0;100929.384615385;1104.76923076923;95.6153846153846
87150;2023;13;13;0;100;0;137725;1529.69230769231;88
87151;2023;7;7;0;100;0;135000;1411.85714285714;104.285714285714
87152;2023;19;19;0;100;0;128680.736842105;1661.31578947368;78
87153;2023;7;7;0;100;0;133343.428571429;1430.71428571429;120
87154;2023;111;104;7;93.6936936936937;6.30630630630631;140783.810810811;1639.53153153153;87.6036036036036
87155;2023;2;2;0;100;0;69701.5;802.5;87.5
87156;2023;20;20;0;100;0;225342.5;1788.75;129.55
87157;2023;10;10;0;100;0;118395;1138;97.7
87158;2023;18;18;0;100;0;106182.722222222;1288.22222222222;87.2222222222222
87159;2023;3;3;0;100;0;126240;1297;94.3333333333333
87160;2023;7;7;0;100;0;143700;1343;115.428571428571
87161;2023;50;40;10;80;20;113124.2;1287.02;90.98
87162;2023;5;5;0;100;0;145100;1834.2;74.8
87163;2023;3;3;0;100;0;105500;980.666666666667;126.333333333333
87164;2023;5;5;0;100;0;144158;1257;118.6
87165;2023;3;3;0;100;0;109430;996.666666666667;107.666666666667
87166;2023;6;6;0;100;0;184366.666666667;1841.83333333333;97.8333333333333
87167;2023;2;2;0;100;0;170800;1622.5;84.5
87168;2023;24;24;0;100;0;101507;1137.79166666667;91.875
87169;2023;7;7;0;100;0;230364.285714286;1783.71428571429;131.428571428571
87170;2023;2;2;0;100;0;155000;1475;119.5
87172;2023;3;3;0;100;0;94443.3333333333;871;92
87174;2023;14;14;0;100;0;133110.714285714;1431.57142857143;94.5714285714286
87176;2023;7;7;0;100;0;96214.2857142857;1263;75.8571428571429
87177;2023;20;20;0;100;0;141361.15;1634.45;85.7
87178;2023;35;35;0;100;0;126230;1457.11428571429;96.5428571428571
87180;2023;8;8;0;100;0;100507.5;1092.375;103
87181;2023;12;12;0;100;0;94480;1250.91666666667;74.1666666666667
87182;2023;18;17;1;94.4444444444444;5.55555555555556;103337.777777778;920.277777777778;106.222222222222
87183;2023;8;8;0;100;0;128450;1296.375;92.5
87185;2023;25;25;0;100;0;153414.4;1497.6;107.08
87186;2023;5;5;0;100;0;133400;1463.6;95.4
87187;2023;93;80;13;86.0215053763441;13.9784946236559;130582.817204301;1503.97849462366;91.0860215053764
87188;2023;10;10;0;100;0;175513.5;1773.2;106.8
87189;2023;7;7;0;100;0;154406.285714286;1167.42857142857;133.857142857143
87190;2023;10;10;0;100;0;109300;1007.5;99.2
87191;2023;24;24;0;100;0;144931.041666667;1484.58333333333;102.75
87192;2023;11;10;1;90.9090909090909;9.09090909090909;153545.454545455;1631.54545454545;97.2727272727273
87193;2023;2;2;0;100;0;134000;1461.5;90.5
87194;2023;5;5;0;100;0;98400;1274.2;101.2
87195;2023;5;5;0;100;0;160022.2;1644.6;82.6
87197;2023;6;6;0;100;0;189176.666666667;2206.16666666667;113.833333333333
87198;2023;10;10;0;100;0;97391.9;1057.3;103.1
87199;2023;23;23;0;100;0;113268.304347826;1213.30434782609;103.391304347826
87200;2023;1;1;0;100;0;224200;1014;221
87201;2023;31;31;0;100;0;224622.064516129;2039.32258064516;115.354838709677
87202;2023;15;15;0;100;0;176858.866666667;1702.13333333333;106
87203;2023;9;9;0;100;0;139777.777777778;1451.55555555556;95.3333333333333
87204;2023;8;8;0;100;0;96254;1224.25;83.25
87205;2023;23;22;1;95.6521739130435;4.34782608695652;196163.782608696;1890.13043478261;104.95652173913
87206;2023;3;3;0;100;0;118963.666666667;1899.33333333333;80
88003;2023;3;3;0;100;0;103783.333333333;1197.33333333333;84.3333333333333
88004;2023;3;3;0;100;0;59833.3333333333;661.333333333333;83.6666666666667
88005;2023;1;1;0;100;0;98500;1094;90
88006;2023;3;2;1;66.6666666666667;33.3333333333333;111566.666666667;1335.66666666667;83.3333333333333
88008;2023;2;2;0;100;0;97500;875;110.5
88009;2023;32;29;3;90.625;9.375;180928.25;2016.21875;92.78125
88010;2023;4;4;0;100;0;47500;646.5;73.25
88011;2023;19;17;2;89.4736842105263;10.5263157894737;144585;1315.47368421053;113.736842105263
88012;2023;14;12;2;85.7142857142857;14.2857142857143;168592.857142857;1380.42857142857;119.285714285714
88013;2023;1;1;0;100;0;85600;785;109
88014;2023;2;2;0;100;0;120000;967;122.5
88015;2023;4;4;0;100;0;86813.75;1013;87
88016;2023;1;1;0;100;0;259000;1489;174
88019;2023;1;1;0;100;0;67500;597;113
88020;2023;1;1;0;100;0;90000;763;118
88021;2023;4;4;0;100;0;61875;899.75;67.25
88022;2023;1;1;0;100;0;155000;738;210
88024;2023;1;1;0;100;0;183700;1185;155
88026;2023;7;7;0;100;0;167085.714285714;1626.28571428571;106
88028;2023;3;0;3;0;100;123216.666666667;1483.33333333333;81
88029;2023;17;14;3;82.3529411764706;17.6470588235294;128574.117647059;1455.11764705882;82.5294117647059
88031;2023;1;1;0;100;0;45000;818;55
88032;2023;12;12;0;100;0;169583.333333333;1804.58333333333;94.6666666666667
88033;2023;1;1;0;100;0;164000;886;185
88036;2023;1;1;0;100;0;74000;592;125
88037;2023;9;8;1;88.8888888888889;11.1111111111111;268538.888888889;2154.44444444444;113.555555555556
88039;2023;3;3;0;100;0;99316.6666666667;877;111.333333333333
88041;2023;2;1;1;50;50;106750;1328;77
88042;2023;3;3;0;100;0;80616.6666666667;761.333333333333;120.333333333333
88044;2023;5;5;0;100;0;127830.2;1396.4;99.8
88046;2023;1;1;0;100;0;89000;636;140
88048;2023;6;6;0;100;0;184250;1534.16666666667;116.166666666667
88051;2023;1;1;0;100;0;73500;942;78
88053;2023;1;1;0;100;0;76538;1595;48
88054;2023;1;0;1;0;100;160000;2667;60
88056;2023;1;1;0;100;0;237350;1899;125
88057;2023;1;1;0;100;0;142755;1190;120
88058;2023;1;1;0;100;0;138000;885;156
88059;2023;3;3;0;100;0;171666.666666667;1666.33333333333;108.666666666667
88061;2023;2;2;0;100;0;83450;1068;84.5
88062;2023;1;1;0;100;0;40000;667;60
88063;2023;1;1;0;100;0;342800;1804;190
88064;2023;2;2;0;100;0;135000;1765;89
88065;2023;1;1;0;100;0;25000;500;50
88068;2023;8;8;0;100;0;138362.5;1646.5;82.5
88069;2023;1;1;0;100;0;187300;1387;135
88070;2023;1;1;0;100;0;102500;4100;25
88073;2023;1;1;0;100;0;95000;1131;84
88075;2023;85;32;53;37.6470588235294;62.3529411764706;186176.223529412;2737.22352941176;71.0235294117647
88076;2023;5;4;1;80;20;115730;1592.8;83.2
88077;2023;2;2;0;100;0;185025;1169;155
88078;2023;18;16;2;88.8888888888889;11.1111111111111;124268.333333333;1236.16666666667;94.9444444444444
88079;2023;14;14;0;100;0;109786.071428571;1154.71428571429;98.2857142857143
88080;2023;1;1;0;100;0;1,00E+05;667;150
88081;2023;19;12;7;63.1578947368421;36.8421052631579;132916.842105263;1709.31578947368;80.5789473684211
88082;2023;12;10;2;83.3333333333333;16.6666666666667;118833.333333333;1123.41666666667;111.166666666667
88084;2023;4;4;0;100;0;101895;678.75;150.75
88085;2023;2;2;0;100;0;179500;1558.5;117.5
88086;2023;3;3;0;100;0;81333.3333333333;926.333333333333;97.3333333333333
88087;2023;43;20;23;46.5116279069767;53.4883720930233;167621.279069767;1745.20930232558;83
88088;2023;10;10;0;100;0;111850;1049.6;113
88089;2023;4;4;0;100;0;92900;1336.5;82.75
88090;2023;42;30;12;71.4285714285714;28.5714285714286;136305.952380952;1425.85714285714;94.8095238095238
88091;2023;1;1;0;100;0;80000;1600;50
88092;2023;7;7;0;100;0;175914.285714286;1286.57142857143;125.857142857143
88094;2023;13;10;3;76.9230769230769;23.0769230769231;119034.615384615;1307.38461538462;96.6923076923077
88095;2023;6;6;0;100;0;87416.6666666667;866.333333333333;101.333333333333
88096;2023;3;3;0;100;0;82083.3333333333;1413.66666666667;60.6666666666667
88098;2023;14;10;4;71.4285714285714;28.5714285714286;153234.785714286;1914;82.8571428571429
88099;2023;14;11;3;78.5714285714286;21.4285714285714;150142.857142857;1492.14285714286;101.071428571429
88101;2023;9;9;0;100;0;184657.777777778;1561.55555555556;120.444444444444
88102;2023;1;1;0;100;0;38000;422;90
88104;2023;1;1;0;100;0;65000;464;140
88105;2023;3;3;0;100;0;77533.3333333333;857.333333333333;89
88106;2023;14;13;1;92.8571428571429;7.14285714285714;250399.285714286;2501.85714285714;111.142857142857
88108;2023;11;11;0;100;0;85045.4545454545;947.818181818182;103
88109;2023;1;0;1;0;100;122000;1371;89
88110;2023;2;2;0;100;0;76650;848;84
88111;2023;3;3;0;100;0;248166.666666667;1517.66666666667;185.333333333333
88113;2023;3;3;0;100;0;82666.6666666667;873.666666666667;93.3333333333333
88114;2023;29;14;15;48.2758620689655;51.7241379310345;96038.9655172414;1050.31034482759;89.2413793103448
88115;2023;20;15;5;75;25;139240.25;1892.6;81.9
88116;2023;30;19;11;63.3333333333333;36.6666666666667;141358.4;1609.03333333333;89.3333333333333
88118;2023;5;5;0;100;0;113640;1090.6;109.6
88119;2023;2;2;0;100;0;70270;584.5;121
88120;2023;3;3;0;100;0;84600;908;99
88121;2023;4;4;0;100;0;141250;909.5;145
88122;2023;1;1;0;100;0;173000;1821;95
88123;2023;1;1;0;100;0;35000;438;80
88124;2023;7;6;1;85.7142857142857;14.2857142857143;87170;892.571428571429;95.4285714285714
88126;2023;11;9;2;81.8181818181818;18.1818181818182;138292.727272727;1242.54545454545;114.090909090909
88127;2023;1;1;0;100;0;85000;810;105
88128;2023;2;2;0;100;0;162500;1487.5;110.5
88130;2023;1;1;0;100;0;205500;2815;73
88131;2023;1;1;0;100;0;209000;1742;120
88132;2023;7;6;1;85.7142857142857;14.2857142857143;242648.571428571;2043;120.142857142857
88133;2023;1;0;1;0;100;133595;772;173
88134;2023;10;10;0;100;0;224266.1;1566.1;146.3
88135;2023;12;8;4;66.6666666666667;33.3333333333333;125683.333333333;1260.75;96.6666666666667
88136;2023;15;13;2;86.6666666666667;13.3333333333333;202636.733333333;1864;108.4
88138;2023;2;2;0;100;0;93250;810.5;126
88140;2023;2;2;0;100;0;145800;1481.5;114.5
88141;2023;2;2;0;100;0;158510.5;1558.5;102
88142;2023;5;5;0;100;0;199130;1651.8;117.8
88143;2023;2;2;0;100;0;157500;1449;103.5
88145;2023;3;3;0;100;0;161833.333333333;1505.33333333333;111.333333333333
88146;2023;3;3;0;100;0;131416.666666667;1325.66666666667;101.333333333333
88147;2023;6;6;0;100;0;164665;1989;86.1666666666667
88148;2023;17;13;4;76.4705882352941;23.5294117647059;167582.235294118;1629.35294117647;104.470588235294
88150;2023;1;1;0;100;0;171000;1267;135
88151;2023;11;11;0;100;0;113286.363636364;1110.18181818182;100.727272727273
88153;2023;2;2;0;100;0;84975;729;121
88155;2023;3;3;0;100;0;112166.666666667;1264.66666666667;91.3333333333333
88157;2023;5;5;0;100;0;194800;2066.4;94
88158;2023;20;15;5;75;25;140000;1556.4;98.95
88159;2023;3;3;0;100;0;220333.333333333;2293.66666666667;96.3333333333333
88160;2023;391;144;247;36.8286445012788;63.1713554987212;130810.631713555;1516.61636828645;82.537084398977
88161;2023;4;4;0;100;0;121436;1843.25;109.25
88162;2023;1;1;0;100;0;187900;2185;86
88163;2023;11;11;0;100;0;149966.363636364;1501.90909090909;103.454545454545
88165;2023;22;21;1;95.4545454545455;4.54545454545455;131822.136363636;1403.36363636364;92.8636363636364
88166;2023;4;4;0;100;0;63096.25;755.5;84.25
88167;2023;4;4;0;100;0;111776.75;1369.75;84.5
88169;2023;3;3;0;100;0;100866.666666667;978.333333333333;103
88170;2023;3;2;1;66.6666666666667;33.3333333333333;150000;1897;77.6666666666667
88172;2023;1;1;0;100;0;139000;1479;94
88173;2023;5;5;0;100;0;195350;1927.2;110.6
88175;2023;4;4;0;100;0;204879.25;1361.5;143.75
88176;2023;11;11;0;100;0;73227.2727272727;791.181818181818;95.4545454545455
88177;2023;7;6;1;85.7142857142857;14.2857142857143;182494.285714286;2094.71428571429;94.5714285714286
88178;2023;19;18;1;94.7368421052632;5.26315789473684;212446.052631579;1960.21052631579;110.947368421053
88179;2023;1;1;0;100;0;133775;904;148
88180;2023;1;1;0;100;0;59915;731;82
88181;2023;28;22;6;78.5714285714286;21.4285714285714;147075.892857143;1471.57142857143;97.5714285714286
88182;2023;3;3;0;100;0;169743.333333333;1743;94.6666666666667
88184;2023;2;2;0;100;0;122500;1175;105.5
88186;2023;4;4;0;100;0;100825;1089.75;86.25
88188;2023;12;11;1;91.6666666666667;8.33333333333333;108720.833333333;1344.08333333333;85.75
88190;2023;4;3;1;75;25;124375;1441.5;82.5
88192;2023;1;1;0;100;0;68000;453;150
88194;2023;3;3;0;100;0;214533.333333333;1257.66666666667;146.666666666667
88195;2023;2;2;0;100;0;122625;1080.5;115
88196;2023;159;58;101;36.4779874213836;63.5220125786163;269111.855345912;3436.40880503145;74.6163522012579
88197;2023;2;2;0;100;0;209500;1346;154
88198;2023;11;11;0;100;0;224680;2622.09090909091;103.363636363636
88202;2023;1;1;0;100;0;190000;1900;100
88203;2023;3;3;0;100;0;160916.666666667;1268.33333333333;122.333333333333
88205;2023;1;1;0;100;0;244500;2876;85
88206;2023;6;6;0;100;0;91467.3333333333;923.5;97.1666666666667
88208;2023;3;3;0;100;0;91833.3333333333;898.333333333333;112
88209;2023;83;51;32;61.4457831325301;38.5542168674699;148934.43373494;1645.56626506024;88.7349397590361
88212;2023;1;1;0;100;0;25000;403;62
88213;2023;1;1;0;100;0;48000;1067;45
88214;2023;1;1;0;100;0;76000;447;170
88215;2023;2;2;0;100;0;177750;1710.5;98.5
88216;2023;3;3;0;100;0;66633.3333333333;849.666666666667;80.6666666666667
88218;2023;20;15;5;75;25;159805.5;1501.25;103.35
88219;2023;2;2;0;100;0;137750;1195;111
88223;2023;2;2;0;100;0;100375;814.5;113
88224;2023;2;2;0;100;0;209375;2470.5;84.5
88225;2023;24;24;0;100;0;195460.416666667;1943.125;100.583333333333
88226;2023;2;2;0;100;0;98690;756;129.5
88231;2023;3;3;0;100;0;123333.333333333;1476;88.3333333333333
88232;2023;3;3;0;100;0;145898.333333333;964.666666666667;148
88233;2023;2;2;0;100;0;195000;1829.5;108
88236;2023;5;5;0;100;0;104620;1241.8;97
88237;2023;7;7;0;100;0;180416.857142857;1598.28571428571;133.714285714286
88238;2023;5;5;0;100;0;108700;897.6;128.6
88240;2023;2;2;0;100;0;254000;1958.5;120.5
88241;2023;4;4;0;100;0;131488.75;972.5;152
88242;2023;1;1;0;100;0;128250;2375;54
88243;2023;5;5;0;100;0;119900;1188.4;99.8
88244;2023;6;5;1;83.3333333333333;16.6666666666667;186950;1856.16666666667;94.5
88245;2023;3;3;0;100;0;298666.666666667;2568;123.333333333333
88246;2023;6;5;1;83.3333333333333;16.6666666666667;120415.833333333;1247.33333333333;94
88247;2023;9;9;0;100;0;103835.222222222;1185;86.2222222222222
88248;2023;2;2;0;100;0;79500;592;141
88250;2023;5;3;2;60;40;127220;1248.2;103.2
88251;2023;8;8;0;100;0;194350;1672;116
88252;2023;1;1;0;100;0;35000;438;80
88253;2023;4;2;2;50;50;227737.5;1476;150.75
88254;2023;1;1;0;100;0;99500;1036;96
88256;2023;5;5;0;100;0;199120;1895.4;106.6
88257;2023;4;4;0;100;0;142800;923.5;141.25
88258;2023;8;8;0;100;0;89482.5;852.5;108.375
88259;2023;2;2;0;100;0;107500;901.5;126
88260;2023;3;3;0;100;0;68333.3333333333;1011;69.6666666666667
88261;2023;3;3;0;100;0;193333.333333333;1619;125
88262;2023;4;4;0;100;0;127025;1274.75;100.75
88263;2023;2;2;0;100;0;212442.5;1578.5;139
88264;2023;1;0;1;0;100;199500;1662;120
88266;2023;10;5;5;50;50;96907;1562;73.3
88267;2023;6;6;0;100;0;77666.6666666667;818.833333333333;94
88268;2023;2;2;0;100;0;140000;1685;83.5
88269;2023;6;5;1;83.3333333333333;16.6666666666667;119116.666666667;1613;69.8333333333333
88270;2023;15;15;0;100;0;88573.6666666667;1032.46666666667;95.4
88271;2023;3;3;0;100;0;138783.333333333;1371.66666666667;100.333333333333
88272;2023;2;2;0;100;0;88500;536.5;164
88273;2023;1;1;0;100;0;115000;1885;61
88274;2023;1;1;0;100;0;35000;422;83
88275;2023;1;1;0;100;0;135400;1991;68
88276;2023;1;1;0;100;0;110000;803;137
88277;2023;1;1;0;100;0;125000;1136;110
88279;2023;1;1;0;100;0;80000;842;95
88281;2023;3;3;0;100;0;73000;948.333333333333;101
88284;2023;5;3;2;60;40;155733;1447.4;100.4
88285;2023;1;1;0;100;0;110000;1000;110
88286;2023;1;1;0;100;0;147000;896;164
88289;2023;8;7;1;87.5;12.5;145239.875;1184.25;129.125
88290;2023;2;2;0;100;0;75000;770;98
88291;2023;1;1;0;100;0;72000;562;128
88292;2023;6;6;0;100;0;86405.5;921;99.8333333333333
88293;2023;2;2;0;100;0;169812.5;1587.5;105.5
88294;2023;2;2;0;100;0;107800;1113;100.5
88295;2023;1;1;0;100;0;204250;2348;87
88297;2023;3;3;0;100;0;186616.666666667;1665;114
88298;2023;1;1;0;100;0;138000;1062;130
88301;2023;3;3;0;100;0;133626.666666667;1046.66666666667;120
88302;2023;14;8;6;57.1428571428571;42.8571428571429;127414.714285714;1374.57142857143;87
88304;2023;41;25;16;60.9756097560976;39.0243902439024;111319.243902439;1145.85365853659;94.2926829268293
88306;2023;1;1;0;100;0;140981;2820;50
88308;2023;1;1;0;100;0;72000;900;80
88309;2023;1;1;0;100;0;87500;858;102
88310;2023;9;8;1;88.8888888888889;11.1111111111111;73833.3333333333;798.444444444444;99.6666666666667
88312;2023;3;3;0;100;0;129500;1223.66666666667;102
88313;2023;5;5;0;100;0;145780.2;1239.2;123.6
88315;2023;4;4;0;100;0;246850;1541.5;143
88316;2023;1;1;0;100;0;157000;1353;116
88317;2023;9;8;1;88.8888888888889;11.1111111111111;96738.8888888889;1217.44444444444;81.3333333333333
88319;2023;32;26;6;81.25;18.75;94191.28125;1236.03125;82.5
88320;2023;10;10;0;100;0;187297;1601.2;120.4
88321;2023;58;48;10;82.7586206896552;17.2413793103448;128330.034482759;1335.96551724138;96.9137931034483
88322;2023;3;3;0;100;0;139666.666666667;1525.66666666667;91.6666666666667
88324;2023;3;3;0;100;0;92666.6666666667;999;88.3333333333333
88325;2023;3;3;0;100;0;91666.6666666667;911.333333333333;92.3333333333333
88326;2023;6;6;0;100;0;168365;1367.33333333333;120
88327;2023;16;12;4;75;25;96405.3125;1175;81.625
88330;2023;1;1;0;100;0;35000;422;83
88331;2023;2;2;0;100;0;172000;1174;117.5
88333;2023;2;2;0;100;0;109300;1636.5;65.5
88334;2023;2;2;0;100;0;115000;990.5;106
88335;2023;2;2;0;100;0;155220;1347.5;116
88338;2023;1;1;0;100;0;65000;765;85
88340;2023;6;5;1;83.3333333333333;16.6666666666667;158625;1237;117.666666666667
88341;2023;3;2;1;66.6666666666667;33.3333333333333;142333.333333333;1611.66666666667;87.6666666666667
88343;2023;2;2;0;100;0;99000;1458.5;82.5
88345;2023;1;1;0;100;0;97300;3243;30
88346;2023;9;6;3;66.6666666666667;33.3333333333333;85222.2222222222;1066;80.2222222222222
88347;2023;2;2;0;100;0;115250;862.5;147
88348;2023;1;1;0;100;0;119940;1153;104
88349;2023;21;14;7;66.6666666666667;33.3333333333333;130528.333333333;1288;95.1904761904762
88350;2023;1;1;0;100;0;153900;850;181
88351;2023;24;17;7;70.8333333333333;29.1666666666667;130544.5;1266.41666666667;105.833333333333
88352;2023;1;1;0;100;0;105000;814;129
88353;2023;1;1;0;100;0;70000;972;72
88354;2023;3;3;0;100;0;110263.333333333;1069.33333333333;108
88355;2023;7;6;1;85.7142857142857;14.2857142857143;94160;1098.28571428571;86
88356;2023;4;4;0;100;0;103017.5;1004.75;105.25
88357;2023;8;8;0;100;0;111250;892.875;116
88358;2023;19;19;0;100;0;150421.789473684;1324.42105263158;114.894736842105
88359;2023;1;1;0;100;0;304000;1820;167
88361;2023;13;12;1;92.3076923076923;7.69230769230769;153596.153846154;1421.30769230769;119.769230769231
88362;2023;1;1;0;100;0;105600;440;240
88363;2023;2;2;0;100;0;158900;1020.5;136.5
88365;2023;2;2;0;100;0;135190;1564.5;86
88366;2023;1;1;0;100;0;290000;1429;203
88367;2023;45;41;4;91.1111111111111;8.88888888888889;121358.666666667;1171.82222222222;101.088888888889
88368;2023;1;1;0;100;0;265000;1840;144
88369;2023;13;11;2;84.6153846153846;15.3846153846154;147976.923076923;1366;122.384615384615
88370;2023;1;1;0;100;0;45000;1071;42
88371;2023;10;10;0;100;0;191670.5;1547.1;139.3
88372;2023;68;60;8;88.2352941176471;11.7647058823529;114003.088235294;1234.17647058824;91.5294117647059
88375;2023;4;2;2;50;50;115500;940.5;122.25
88376;2023;3;3;0;100;0;134166.666666667;1036;126
88377;2023;1;1;0;100;0;88000;880;100
88379;2023;1;1;0;100;0;133750;1537;87
88381;2023;2;2;0;100;0;87500;918;102.5
88383;2023;125;28;97;22.4;77.6;119466.256;1510.56;81.016
88385;2023;3;3;0;100;0;79933.3333333333;963.666666666667;80.6666666666667
88386;2023;2;2;0;100;0;161500;1596;103.5
88388;2023;2;2;0;100;0;152450;1442;100
88390;2023;4;4;0;100;0;96500;893.25;115.25
88391;2023;7;6;1;85.7142857142857;14.2857142857143;176097.285714286;1709.85714285714;103.714285714286
88393;2023;1;1;0;100;0;101500;806;126
88395;2023;3;3;0;100;0;136900;995.666666666667;121
88398;2023;1;1;0;100;0;140000;622;225
88399;2023;2;2;0;100;0;128250;978.5;122.5
88400;2023;2;2;0;100;0;70000;803.5;92.5
88401;2023;4;4;0;100;0;97812.5;858.75;111
88402;2023;2;2;0;100;0;125000;1139.5;115
88403;2023;1;1;0;100;0;60000;522;115
88407;2023;3;3;0;100;0;101436.666666667;868.666666666667;117.333333333333
88408;2023;26;25;1;96.1538461538462;3.84615384615385;132719.423076923;1470.73076923077;92.0769230769231
88409;2023;16;14;2;87.5;12.5;141396.875;1340.375;110.375
88410;2023;3;3;0;100;0;136266.666666667;912;157.666666666667
88411;2023;1;1;0;100;0;61600;446;138
88412;2023;7;7;0;100;0;108594.285714286;919.428571428571;122.857142857143
88413;2023;224;99;125;44.1964285714286;55.8035714285714;108333.294642857;1273.70982142857;82.9241071428571
88415;2023;34;17;17;50;50;162343.823529412;1812.32352941176;91.3235294117647
88416;2023;1;1;0;100;0;167000;1687;99
88417;2023;5;4;1;80;20;101740;1181.6;87.2
88418;2023;8;8;0;100;0;130362.5;1246.75;103.5
88419;2023;1;1;0;100;0;79200;870;91
88421;2023;2;2;0;100;0;87500;890;88.5
88423;2023;9;9;0;100;0;203831.111111111;2065.77777777778;104
88424;2023;32;26;6;81.25;18.75;148297.25;1696.0625;90.15625
88425;2023;3;3;0;100;0;87333.3333333333;526;151.666666666667
88426;2023;10;6;4;60;40;114120.5;1748.9;63.6
88428;2023;11;11;0;100;0;187075.181818182;1668.27272727273;119
88429;2023;35;29;6;82.8571428571429;17.1428571428571;198425.285714286;1892.4;105.685714285714
88430;2023;3;3;0;100;0;156333.333333333;1240.66666666667;127
88431;2023;1;1;0;100;0;114000;633;180
88432;2023;1;1;0;100;0;172702;1780;97
88435;2023;5;5;0;100;0;187152;1886.6;102
88438;2023;6;6;0;100;0;175478.333333333;1388.83333333333;129.5
88439;2023;11;11;0;100;0;298858.181818182;2030.72727272727;144.545454545455
88441;2023;1;1;0;100;0;75000;1500;50
88442;2023;1;1;0;100;0;160000;1818;88
88443;2023;1;1;0;100;0;175000;1023;171
88444;2023;5;5;0;100;0;128909.6;1246.4;105.2
88445;2023;16;10;6;62.5;37.5;150775;1593.375;92.875
88446;2023;2;2;0;100;0;134825;1371.5;97
88447;2023;25;24;1;96;4;161157.6;1741.56;94.28
88449;2023;1;1;0;100;0;2,00E+05;1471;136
88450;2023;1;1;0;100;0;40000;667;60
88451;2023;28;21;7;75;25;69938.0357142857;911.892857142857;80.3214285714286
88453;2023;2;2;0;100;0;102250;759.5;136
88456;2023;1;1;0;100;0;40000;580;69
88457;2023;4;4;0;100;0;162545.75;958.25;169.75
88458;2023;1;1;0;100;0;70000;700;100
88460;2023;9;9;0;100;0;190288.888888889;1457.55555555556;131.666666666667
88461;2023;2;2;0;100;0;30500;650;55
88462;2023;12;11;1;91.6666666666667;8.33333333333333;150341.666666667;1653.66666666667;100.25
88463;2023;9;8;1;88.8888888888889;11.1111111111111;207111.111111111;1558;126.555555555556
88464;2023;9;9;0;100;0;201305.555555556;1921.33333333333;113.333333333333
88465;2023;75;44;31;58.6666666666667;41.3333333333333;119929.453333333;1434.73333333333;86.3466666666667
88467;2023;7;6;1;85.7142857142857;14.2857142857143;164235.714285714;1437.42857142857;118.428571428571
88468;2023;26;22;4;84.6153846153846;15.3846153846154;128987.692307692;1478.73076923077;90.6923076923077
88470;2023;21;10;11;47.6190476190476;52.3809523809524;129693.952380952;2669.04761904762;53.9523809523809
88471;2023;2;2;0;100;0;152500;3782;70.5
88473;2023;2;2;0;100;0;59500;798;78
88475;2023;1;1;0;100;0;60000;909;66
88476;2023;2;2;0;100;0;178075;1070;185
88479;2023;3;3;0;100;0;74333.3333333333;1562.66666666667;93.3333333333333
88480;2023;1;1;0;100;0;453000;1888;240
88481;2023;14;11;3;78.5714285714286;21.4285714285714;131564.285714286;1351.14285714286;95.8571428571429
88482;2023;1;1;0;100;0;80000;941;85
88483;2023;13;13;0;100;0;180380.769230769;1827.23076923077;99.3076923076923
88484;2023;13;13;0;100;0;133900;1239.76923076923;102.307692307692
88486;2023;17;13;4;76.4705882352941;23.5294117647059;184754.117647059;1941.52941176471;93.4705882352941
88487;2023;29;27;2;93.1034482758621;6.89655172413793;126580.344827586;1494.31034482759;92.7931034482759
88488;2023;3;3;0;100;0;136833.333333333;1310.33333333333;103.666666666667
88490;2023;2;2;0;100;0;76000;571;133.5
88492;2023;2;2;0;100;0;183250;1832.5;100
88493;2023;1;1;0;100;0;190000;1056;180
88494;2023;1;1;0;100;0;138000;958;144
88497;2023;3;3;0;100;0;174633.333333333;1821.33333333333;95.6666666666667
88498;2023;5;4;1;80;20;62298.2;706.8;90
88499;2023;2;1;1;50;50;113000;1060;105.5
88500;2023;15;11;4;73.3333333333333;26.6666666666667;209466.333333333;2645.4;81
88501;2023;1;1;0;100;0;55000;786;70
88502;2023;1;1;0;100;0;274000;1405;195
88503;2023;4;3;1;75;25;72500;803.25;85.25
88504;2023;3;3;0;100;0;87666.6666666667;965.666666666667;93.6666666666667
88505;2023;1;1;0;100;0;241800;1765;137
88506;2023;1;1;0;100;0;85000;1000;85
88507;2023;1;1;0;100;0;95000;792;120
88508;2023;7;7;0;100;0;143700;945.714285714286;147.857142857143
88510;2023;1;1;0;100;0;60000;545;110
88511;2023;1;1;0;100;0;165000;1170;141
88512;2023;3;3;0;100;0;286333.333333333;1625.33333333333;166.666666666667
88513;2023;15;15;0;100;0;121162.666666667;1398.2;81.8666666666667
88514;2023;1;1;0;100;0;150000;1014;148
88515;2023;1;1;0;100;0;78000;867;90
88516;2023;76;33;43;43.421052631579;56.578947368421;102640.052631579;1410.44736842105;71.5789473684211
88519;2023;5;4;1;80;20;146780;1265;115.4
88520;2023;4;4;0;100;0;96500;1692.25;64.75
88521;2023;3;3;0;100;0;115533.333333333;1094;105.333333333333
88522;2023;1;1;0;100;0;20000;1053;19
88523;2023;1;1;0;100;0;38000;507;75
88524;2023;3;3;0;100;0;93333.3333333333;698;132
88525;2023;1;1;0;100;0;145000;659;220
88526;2023;4;4;0;100;0;200250;2183;137
88528;2023;1;1;0;100;0;65000;1226;53
88529;2023;1;1;0;100;0;172500;2029;85
88530;2023;25;24;1;96;4;146275.4;1528.48;96
88531;2023;37;26;11;70.2702702702703;29.7297297297297;260037.891891892;3442.97297297297;77.7027027027027
89002;2023;2;2;0;100;0;55000;885.5;62
89003;2023;26;26;0;100;0;168136.461538462;1549.30769230769;110.384615384615
89004;2023;3;3;0;100;0;97666.6666666667;864.333333333333;113.666666666667
89005;2023;10;8;2;80;20;65450;835.1;77.7
89006;2023;1;1;0;100;0;65000;774;84
89007;2023;4;4;0;100;0;81750;995;93.75
89008;2023;2;2;0;100;0;160100;1627;104.5
89009;2023;3;3;0;100;0;41800;627.666666666667;72.3333333333333
89010;2023;2;2;0;100;0;77500;942.5;83
89011;2023;1;1;0;100;0;65000;722;90
89013;2023;30;28;2;93.3333333333333;6.66666666666667;139626.333333333;1640.46666666667;87.1666666666667
89014;2023;10;10;0;100;0;87500;904.8;101.3
89015;2023;12;12;0;100;0;87879.1666666667;1028.66666666667;88.8333333333333
89016;2023;2;2;0;100;0;88000;434.5;205.5
89017;2023;3;3;0;100;0;101326.666666667;1187.33333333333;87.3333333333333
89018;2023;14;14;0;100;0;134782.5;1863;98.6428571428571
89019;2023;4;4;0;100;0;70050;927.25;87.5
89020;2023;2;2;0;100;0;53000;753.5;71
89021;2023;6;6;0;100;0;144483.333333333;1606.33333333333;87.8333333333333
89023;2023;11;11;0;100;0;134148.272727273;1763.45454545455;75.8181818181818
89024;2023;532;200;332;37.593984962406;62.406015037594;132380.490601504;1814.35902255639;73.1823308270677
89025;2023;82;48;34;58.5365853658537;41.4634146341463;123773.609756098;1498.73170731707;81.280487804878
89027;2023;2;2;0;100;0;88500;1167;76
89029;2023;9;9;0;100;0;130866.666666667;1708.33333333333;85.8888888888889
89030;2023;6;6;0;100;0;112833.333333333;1319.5;90.3333333333333
89031;2023;5;5;0;100;0;198573;1606.2;125.2
89033;2023;4;4;0;100;0;146462.5;1285;112.25
89034;2023;3;3;0;100;0;86833.3333333333;1418.66666666667;85.3333333333333
89035;2023;3;3;0;100;0;120166.666666667;1305;92
89036;2023;4;4;0;100;0;131125;1805.5;74.5
89037;2023;3;3;0;100;0;123333.333333333;1123.33333333333;112
89038;2023;1;1;0;100;0;160000;1280;125
89039;2023;3;3;0;100;0;49333.3333333333;673;73.3333333333333
89040;2023;3;3;0;100;0;85333.3333333333;1155.66666666667;71
89041;2023;3;3;0;100;0;207116.666666667;1448.33333333333;126
89042;2023;4;4;0;100;0;103312.5;1252.5;73.25
89044;2023;4;4;0;100;0;118375;1282.5;90.5
89045;2023;4;4;0;100;0;187412.5;1335.25;148
89046;2023;19;19;0;100;0;82840.5263157895;1113.10526315789;78.6842105263158
89048;2023;4;4;0;100;0;173500;1358.5;130.5
89049;2023;2;2;0;100;0;64000;671;87.5
89050;2023;13;13;0;100;0;119796.153846154;1495.61538461538;77.8461538461538
89051;2023;8;8;0;100;0;111337.5;1512.25;73.5
89053;2023;5;5;0;100;0;182930;3240.2;90.6
89054;2023;20;20;0;100;0;128364.85;1877.6;74.6
89055;2023;30;30;0;100;0;102771.8;1104.53333333333;88.8333333333333
89056;2023;4;4;0;100;0;185250;1627.25;122.75
89057;2023;1;1;0;100;0;67000;893;75
89058;2023;3;3;0;100;0;139333.333333333;1310;105.666666666667
89059;2023;11;11;0;100;0;122854.545454545;1376.36363636364;89.1818181818182
89060;2023;9;9;0;100;0;145944.444444444;1616.55555555556;89.5555555555556
89061;2023;3;3;0;100;0;109333.333333333;966.333333333333;114
89062;2023;4;4;0;100;0;137740;1058;143.5
89063;2023;13;13;0;100;0;178606.153846154;1851.61538461538;93.6923076923077
89066;2023;14;14;0;100;0;131670.142857143;1247.85714285714;107.071428571429
89067;2023;23;22;1;95.6521739130435;4.34782608695652;126829.347826087;1346.5652173913;94.0434782608696
89068;2023;26;23;3;88.4615384615385;11.5384615384615;170188.923076923;2373.76923076923;72.8076923076923
89069;2023;5;5;0;100;0;81700;917.8;91.8
89071;2023;2;2;0;100;0;137500;1168.5;121.5
89072;2023;7;7;0;100;0;116671.428571429;1435.71428571429;81.4285714285714
89073;2023;24;24;0;100;0;128939;1617.70833333333;77
89074;2023;30;29;1;96.6666666666667;3.33333333333333;153818;1939.43333333333;83.1666666666667
89075;2023;8;8;0;100;0;188325;1601.5;120.875
89076;2023;16;16;0;100;0;101518.125;1141.6875;90.4375
89077;2023;14;12;2;85.7142857142857;14.2857142857143;170200;1696.78571428571;102.785714285714
89079;2023;5;5;0;100;0;157980;1641.2;102.2
89080;2023;2;2;0;100;0;184500;1142;161
89083;2023;17;16;1;94.1176470588235;5.88235294117647;192529.411764706;1811;109.529411764706
89084;2023;3;3;0;100;0;92333.3333333333;1193;77.6666666666667
89085;2023;15;15;0;100;0;117946.666666667;1791;71.2
89086;2023;99;99;0;100;0;125950.101010101;1371.17171717172;95.1616161616162
89087;2023;3;3;0;100;0;128333.333333333;978;126.333333333333
89088;2023;4;4;0;100;0;183725;1724.25;106.25
89089;2023;5;5;0;100;0;99300;1204;82.2
89091;2023;11;11;0;100;0;55756.2727272727;854.727272727273;68.1818181818182
89092;2023;3;3;0;100;0;125450;1528.66666666667;84
89093;2023;9;9;0;100;0;147604.444444444;1937.88888888889;93.4444444444444
89094;2023;12;12;0;100;0;159485.833333333;2180.33333333333;89.25
89095;2023;4;4;0;100;0;98553.5;904.5;123.5
89096;2023;12;12;0;100;0;158020.833333333;1460.33333333333;106.583333333333
89099;2023;26;25;1;96.1538461538462;3.84615384615385;114450;1269.84615384615;96.7692307692308
89100;2023;20;20;0;100;0;202649.25;2125.95;106.2
89101;2023;4;4;0;100;0;95250;1174.25;77.25
89102;2023;28;28;0;100;0;162527.857142857;1734.25;94.3928571428571
89104;2023;5;5;0;100;0;162500;1291;127.8
89105;2023;5;5;0;100;0;99000;1187;94.4
89108;2023;1;1;0;100;0;135000;1262;107
89111;2023;6;6;0;100;0;173100;1184.66666666667;138
89112;2023;1;1;0;100;0;47500;833;57
89113;2023;7;7;0;100;0;125295.714285714;1499.85714285714;85.7142857142857
89115;2023;1;1;0;100;0;302000;2359;128
89116;2023;8;8;0;100;0;155337.5;1380.25;119.375
89117;2023;3;3;0;100;0;74870;1257;60.3333333333333
89118;2023;5;5;0;100;0;89096;988.2;82.6
89119;2023;8;8;0;100;0;80575;902.125;95.75
89120;2023;4;4;0;100;0;90500;846.25;103.25
89122;2023;8;8;0;100;0;101250;1208.125;86.875
89123;2023;4;4;0;100;0;68650;1000;65.25
89124;2023;17;17;0;100;0;166520;1775.05882352941;90.7058823529412
89125;2023;15;15;0;100;0;96319.1333333333;1092;85.3333333333333
89127;2023;8;8;0;100;0;182375;1868.25;97
89128;2023;6;6;0;100;0;102633.333333333;1237.16666666667;90.8333333333333
89129;2023;6;6;0;100;0;105116.666666667;1104.83333333333;97
89130;2023;21;21;0;100;0;105438.714285714;1303.90476190476;83.0952380952381
89131;2023;6;6;0;100;0;73400;878.833333333333;84.8333333333333
89132;2023;2;2;0;100;0;64890;700;92
89133;2023;6;6;0;100;0;172935.833333333;1425.5;126.333333333333
89134;2023;2;2;0;100;0;150000;1130.5;120.5
89136;2023;8;8;0;100;0;252133.75;2363.25;109.125
89137;2023;6;6;0;100;0;125500;1067;119.166666666667
89139;2023;14;14;0;100;0;120424.357142857;1165.07142857143;105.571428571429
89141;2023;1;1;0;100;0;17000;586;29
89142;2023;22;22;0;100;0;134125;1448.22727272727;95.8181818181818
89143;2023;7;7;0;100;0;153066.142857143;1992;86.8571428571429
89144;2023;14;14;0;100;0;181214.285714286;1839.57142857143;108.571428571429
89145;2023;4;4;0;100;0;114250;1291.75;90.75
89146;2023;1;1;0;100;0;37500;1250;30
89147;2023;1;1;0;100;0;208800;1044;200
89148;2023;4;4;0;100;0;78000;902;75.75
89149;2023;4;4;0;100;0;110862.5;774.75;140.75
89150;2023;3;3;0;100;0;141833.333333333;1643;88
89151;2023;29;29;0;100;0;106670.275862069;1293.96551724138;81
89152;2023;14;13;1;92.8571428571429;7.14285714285714;115742.857142857;1420.14285714286;83.7857142857143
89153;2023;8;6;2;75;25;118441.25;2121;72.25
89154;2023;9;9;0;100;0;207438.888888889;1970.66666666667;106.888888888889
89155;2023;9;8;1;88.8888888888889;11.1111111111111;147061.111111111;1667;89.4444444444444
89156;2023;5;5;0;100;0;124070;1194.6;107.4
89158;2023;8;8;0;100;0;86050;747.375;110.25
89159;2023;12;12;0;100;0;153600.166666667;1749.83333333333;87.8333333333333
89160;2023;8;8;0;100;0;209568.75;1554.125;138.375
89161;2023;3;3;0;100;0;195158.666666667;1208.66666666667;151.333333333333
89162;2023;3;3;0;100;0;166333.333333333;1791;95
89163;2023;9;9;0;100;0;98105.1111111111;1293.33333333333;84
89164;2023;1;1;0;100;0;15000;577;26
89165;2023;3;3;0;100;0;105333.333333333;1030.66666666667;101
89167;2023;12;12;0;100;0;121600;1349.41666666667;88.1666666666667
89169;2023;10;10;0;100;0;113300;1264;98.9
89170;2023;2;2;0;100;0;108000;1440.5;74
89171;2023;2;2;0;100;0;84500;790;109.5
89172;2023;7;7;0;100;0;187642.857142857;1671.14285714286;114
89173;2023;9;9;0;100;0;152246.666666667;1271.55555555556;113.888888888889
89175;2023;3;3;0;100;0;65000;842;76
89176;2023;4;4;0;100;0;47500;647;79.25
89177;2023;1;1;0;100;0;48000;873;55
89179;2023;7;7;0;100;0;76585.7142857143;1038.14285714286;70.8571428571429
89180;2023;3;3;0;100;0;139833.333333333;1222;115.333333333333
89181;2023;2;2;0;100;0;134500;1004;151
89182;2023;2;2;0;100;0;112500;574.5;181
89183;2023;2;2;0;100;0;101000;1091.5;100
89186;2023;3;3;0;100;0;123542.666666667;1421.66666666667;83.3333333333333
89187;2023;3;3;0;100;0;42540;741;78.6666666666667
89188;2023;4;4;0;100;0;75000;845;86.5
89189;2023;8;8;0;100;0;131642.5;1683.375;77.5
89190;2023;3;3;0;100;0;154166.666666667;1180.66666666667;114
89194;2023;2;2;0;100;0;72500;1194.5;62
89195;2023;15;15;0;100;0;173014.933333333;1898.33333333333;93.4
89196;2023;16;16;0;100;0;190917.875;1559.9375;118.8125
89197;2023;5;5;0;100;0;110400;1317.4;89.2
89198;2023;9;8;1;88.8888888888889;11.1111111111111;170400;1891.77777777778;91.5555555555556
89199;2023;1;1;0;100;0;155000;1761;88
89200;2023;4;4;0;100;0;159950;1295.75;137.75
89201;2023;20;20;0;100;0;149411.8;1499.85;98.9
89202;2023;3;3;0;100;0;221666.666666667;1846.33333333333;110.666666666667
89204;2023;10;10;0;100;0;107539.9;1205.1;85.6
89205;2023;2;2;0;100;0;172230;1670;110
89206;2023;102;71;31;69.6078431372549;30.3921568627451;102932.607843137;1359.29411764706;76.5196078431373
89207;2023;1;1;0;100;0;108900;1266;86
89208;2023;7;7;0;100;0;167900;1551.14285714286;105.857142857143
89209;2023;3;3;0;100;0;144333.333333333;1259.33333333333;127.666666666667
89210;2023;1;1;0;100;0;82000;872;94
89211;2023;2;2;0;100;0;172500;1065.5;138.5
89212;2023;4;4;0;100;0;122725;1373.25;80
89214;2023;2;2;0;100;0;131250;1712.5;79
89215;2023;3;3;0;100;0;90166.6666666667;936;107
89216;2023;6;6;0;100;0;111790.5;1122.16666666667;98.6666666666667
89217;2023;1;1;0;100;0;55000;917;60
89218;2023;16;14;2;87.5;12.5;144777.5;1620.5625;89.25
89219;2023;1;1;0;100;0;86000;1036;83
89220;2023;3;3;0;100;0;71666.6666666667;781.333333333333;87
89221;2023;7;7;0;100;0;98762;1032.28571428571;93.4285714285714
89222;2023;4;4;0;100;0;111875;1143.75;113.5
89223;2023;9;9;0;100;0;103616.666666667;961.333333333333;107.555555555556
89224;2023;1;1;0;100;0;125000;758;165
89226;2023;1;1;0;100;0;57000;456;125
89227;2023;7;7;0;100;0;118498.571428571;1532.28571428571;77.8571428571429
89228;2023;13;13;0;100;0;173407.692307692;1284.07692307692;148.846153846154
89229;2023;2;2;0;100;0;231050;1840.5;121.5
89230;2023;6;6;0;100;0;117583.333333333;1550.33333333333;78.5
89232;2023;3;3;0;100;0;88700;1254.66666666667;86.6666666666667
89233;2023;2;2;0;100;0;51000;793;62.5
89234;2023;4;4;0;100;0;54375;598;89.25
89235;2023;6;6;0;100;0;167458.333333333;1515.16666666667;99.6666666666667
89236;2023;16;16;0;100;0;206562.5;1755.4375;113.8125
89237;2023;7;7;0;100;0;121142.857142857;981;137.142857142857
89238;2023;8;8;0;100;0;87343.75;1027.25;81.5
89239;2023;17;15;2;88.2352941176471;11.7647058823529;202542.941176471;2439.58823529412;86.3529411764706
89240;2023;2;2;0;100;0;152750;1754.5;93
89242;2023;15;15;0;100;0;110393.333333333;1456.33333333333;77.0666666666667
89245;2023;12;12;0;100;0;196250;1653.91666666667;112.5
89246;2023;5;5;0;100;0;100700;1143.8;88.8
89247;2023;4;4;0;100;0;64505;773.5;79.25
89249;2023;1;1;0;100;0;95000;931;102
89250;2023;3;3;0;100;0;95666.6666666667;1012;90.6666666666667
89251;2023;16;16;0;100;0;124841.875;1320.1875;91.4375
89252;2023;3;3;0;100;0;92833.3333333333;930.666666666667;88.3333333333333
89253;2023;3;3;0;100;0;47833.3333333333;764;62.6666666666667
89254;2023;11;10;1;90.9090909090909;9.09090909090909;237083.636363636;2135.72727272727;85.4545454545455
89255;2023;7;7;0;100;0;203158.571428571;2185.71428571429;97.4285714285714
89256;2023;3;3;0;100;0;131016.666666667;1527;84.6666666666667
89257;2023;74;62;12;83.7837837837838;16.2162162162162;95560.4054054054;1400.97297297297;75.2567567567568
89259;2023;1;1;0;100;0;36000;632;57
89261;2023;3;3;0;100;0;245166.666666667;1455;171.333333333333
89262;2023;4;4;0;100;0;87250;801;114.75
89263;2023;37;33;4;89.1891891891892;10.8108108108108;183313.945945946;2122.54054054054;90.1351351351351
89264;2023;6;6;0;100;0;141500;1848;74.5
89265;2023;9;9;0;100;0;270234;1941.22222222222;136.777777777778
89266;2023;3;3;0;100;0;58333.3333333333;718.666666666667;81.3333333333333
89268;2023;8;8;0;100;0;148728.75;1436.375;110.625
89271;2023;2;2;0;100;0;144302;1188;115.5
89272;2023;2;2;0;100;0;136500;1511.5;96.5
89273;2023;10;10;0;100;0;119364;1513.4;83.1
89274;2023;10;10;0;100;0;141000;1538.6;89.3
89276;2023;13;13;0;100;0;109623.076923077;1078.84615384615;97.5384615384615
89277;2023;6;5;1;83.3333333333333;16.6666666666667;104735;964.333333333333;105
89278;2023;5;5;0;100;0;145440;1554.6;92.6
89279;2023;13;12;1;92.3076923076923;7.69230769230769;130911.153846154;1749;74.3846153846154
89280;2023;4;4;0;100;0;61000;867.25;77
89281;2023;7;7;0;100;0;105607.142857143;1568.14285714286;73.7142857142857
89282;2023;6;6;0;100;0;199591.666666667;1356.5;143.5
89283;2023;9;9;0;100;0;95055.5555555556;1039.88888888889;95.1111111111111
89284;2023;3;3;0;100;0;76406;861;92.6666666666667
89285;2023;5;5;0;100;0;145000;1588.8;97.8
89286;2023;13;13;0;100;0;132931.538461538;1587;88.6923076923077
89287;2023;52;45;7;86.5384615384615;13.4615384615385;159800.884615385;1646.73076923077;97.6153846153846
89288;2023;2;2;0;100;0;51700;851;60
89289;2023;5;5;0;100;0;152520;1219.2;121.6
89291;2023;5;1;4;20;80;116000;1316;83.4
89292;2023;6;6;0;100;0;108500;928.166666666667;111.5
89295;2023;21;21;0;100;0;211449.380952381;2064.71428571429;102.571428571429
89296;2023;1;1;0;100;0;70000;551;127
89297;2023;1;1;0;100;0;255000;1466;174
89298;2023;9;9;0;100;0;154666.666666667;1246.66666666667;128
89299;2023;4;4;0;100;0;84250;830.5;100.25
89300;2023;1;1;0;100;0;150000;750;200
89302;2023;4;4;0;100;0;176737.5;1563;118.5
89303;2023;7;7;0;100;0;73785.7142857143;796;94
89304;2023;4;4;0;100;0;126250;1135.5;106
89306;2023;5;5;0;100;0;128223;1392.6;92.4
89307;2023;8;8;0;100;0;130954.375;1261.75;104.375
89309;2023;44;43;1;97.7272727272727;2.27272727272727;140285.909090909;1547.36363636364;91.2727272727273
89311;2023;10;10;0;100;0;141638.7;1408.7;104.9
89312;2023;3;3;0;100;0;53333.3333333333;949.333333333333;52.6666666666667
89313;2023;5;5;0;100;0;212300;1827.8;104.4
89314;2023;1;1;0;100;0;55000;688;80
89315;2023;4;4;0;100;0;122250;1321.75;114.25
89316;2023;2;2;0;100;0;211700;1354;132.5
89318;2023;6;6;0;100;0;124133.333333333;1688.83333333333;74.8333333333333
89319;2023;8;8;0;100;0;180779.25;1475.75;119.375
89321;2023;9;9;0;100;0;77552.2222222222;941.333333333333;85.1111111111111
89323;2023;3;3;0;100;0;156666.666666667;1483;105.666666666667
89324;2023;14;14;0;100;0;132145;1412.64285714286;96.1428571428571
89325;2023;2;2;0;100;0;29250;498.5;58.5
89326;2023;10;10;0;100;0;182000;1875.7;94.6
89327;2023;3;3;0;100;0;181666.666666667;1814.33333333333;108.666666666667
89328;2023;2;2;0;100;0;143000;1685;86
89329;2023;5;5;0;100;0;48260;592.6;84.6
89331;2023;7;7;0;100;0;144992.428571429;1392.57142857143;106.285714285714
89332;2023;9;9;0;100;0;165955.555555556;1667;101.333333333333
89334;2023;6;6;0;100;0;181100;1272.83333333333;131.166666666667
89335;2023;10;10;0;100;0;140737.5;1482.3;96
89336;2023;1;1;0;100;0;75000;833;90
89337;2023;4;4;0;100;0;150225;1368.25;115.75
89338;2023;20;17;3;85;15;193620;2234.05;86
89339;2023;3;3;0;100;0;177333.333333333;1156.33333333333;153
89341;2023;5;5;0;100;0;197200;1393.2;145
89342;2023;7;7;0;100;0;176689.142857143;2134.42857142857;85.7142857142857
89344;2023;17;17;0;100;0;146079.411764706;1383.11764705882;90.8235294117647
89345;2023;37;29;8;78.3783783783784;21.6216216216216;69368.2972972973;860.135135135135;82.0810810810811
89346;2023;53;43;10;81.1320754716981;18.8679245283019;158473.547169811;1827.62264150943;88.1132075471698
89347;2023;3;3;0;100;0;126618;1365.33333333333;86.3333333333333
89348;2023;30;29;1;96.6666666666667;3.33333333333333;139606.666666667;1545.46666666667;97.8666666666667
89349;2023;10;10;0;100;0;121733;1208.3;101.6
89350;2023;1;1;0;100;0;244010;1298;188
89351;2023;6;6;0;100;0;121058.333333333;1403.66666666667;84.6666666666667
89352;2023;4;4;0;100;0;273475;2469.5;106.5
89353;2023;3;3;0;100;0;91000;1036;79.6666666666667
89354;2023;14;13;1;92.8571428571429;7.14285714285714;140693.214285714;1629.85714285714;92.8571428571429
89355;2023;3;3;0;100;0;130000;1526.33333333333;91.3333333333333
89359;2023;6;6;0;100;0;145491.833333333;1223.66666666667;121
89360;2023;7;7;0;100;0;290304.428571429;2294.85714285714;129.142857142857
89361;2023;4;4;0;100;0;154327.5;1243;125.75
89362;2023;5;5;0;100;0;95060;991.6;93
89363;2023;3;3;0;100;0;125633.333333333;1697.33333333333;78.3333333333333
89364;2023;8;8;0;100;0;85845.625;1262.25;68.375
89365;2023;11;11;0;100;0;91772.7272727273;987.727272727273;89.5454545454545
89367;2023;14;14;0;100;0;142392.857142857;1447.28571428571;100.5
89368;2023;17;17;0;100;0;113334.705882353;1721.76470588235;71.2352941176471
89369;2023;9;9;0;100;0;155034.444444444;1822.33333333333;88.2222222222222
89370;2023;13;12;1;92.3076923076923;7.69230769230769;143131.461538462;2042.61538461538;81.4615384615385
89371;2023;2;2;0;100;0;60747.5;905.5;70
89373;2023;5;5;0;100;0;195700;1568.6;116.2
89375;2023;2;2;0;100;0;63500;827.5;77
89376;2023;2;2;0;100;0;108000;1166;91.5
89378;2023;2;2;0;100;0;143000;1154.5;125
89379;2023;1;1;0;100;0;670000;3873;173
89380;2023;13;10;3;76.9230769230769;23.0769230769231;267918.846153846;3714.92307692308;79.5384615384615
89382;2023;20;18;2;90;10;150523.5;1451.65;113.15
89383;2023;1;1;0;100;0;147500;1844;80
89384;2023;8;8;0;100;0;183475;1376;125
89386;2023;2;2;0;100;0;90000;984;92.5
89387;2023;345;154;191;44.6376811594203;55.3623188405797;141799.794202899;1869.57101449275;75.3913043478261
89388;2023;9;9;0;100;0;82111.1111111111;905.444444444444;92.7777777777778
89390;2023;7;7;0;100;0;142642.857142857;1360.57142857143;107
89391;2023;18;18;0;100;0;133888.888888889;1579.27777777778;89.8333333333333
89392;2023;6;6;0;100;0;96666.6666666667;1291.83333333333;76
89393;2023;3;3;0;100;0;89633.3333333333;878.333333333333;106.666666666667
89394;2023;3;3;0;100;0;168166.666666667;1158.66666666667;132.333333333333
89395;2023;5;5;0;100;0;119176;1386.6;94.8
89397;2023;6;6;0;100;0;121383.333333333;1982.83333333333;75.1666666666667
89398;2023;6;6;0;100;0;167225;1703.66666666667;104.166666666667
89399;2023;13;13;0;100;0;166743.846153846;1854.69230769231;96.8461538461538
89400;2023;8;8;0;100;0;106725;1152.875;93
89402;2023;3;3;0;100;0;126333.333333333;1049.66666666667;121.333333333333
89403;2023;1;1;0;100;0;42000;1050;40
89404;2023;3;3;0;100;0;158383.333333333;1354.33333333333;118.333333333333
89405;2023;6;6;0;100;0;130250;945.166666666667;141.5
89406;2023;1;1;0;100;0;65000;867;75
89407;2023;11;11;0;100;0;87327.7272727273;1200.09090909091;74
89408;2023;5;5;0;100;0;148300;2292;84
89409;2023;1;1;0;100;0;67000;957;70
89411;2023;15;15;0;100;0;123793.333333333;1286.66666666667;95.1333333333333
89412;2023;2;2;0;100;0;532500;2763;169.5
89414;2023;32;19;13;59.375;40.625;115291.71875;1301.0625;85.46875
89415;2023;1;1;0;100;0;150000;1071;140
89416;2023;8;8;0;100;0;73487.5;921.125;80.75
89417;2023;1;1;0;100;0;80000;1067;75
89418;2023;39;31;8;79.4871794871795;20.5128205128205;123563.846153846;1435.74358974359;94.3076923076923
89419;2023;33;26;7;78.7878787878788;21.2121212121212;120779.696969697;1598.15151515152;79.3636363636364
89420;2023;18;18;0;100;0;100357.166666667;1109.27777777778;95.1111111111111
89424;2023;2;2;0;100;0;87000;1222;70.5
89425;2023;7;7;0;100;0;94150;1044.42857142857;92
89426;2023;6;6;0;100;0;107950;1160.5;100.833333333333
89427;2023;6;6;0;100;0;116250;1195.5;98.3333333333333
89428;2023;10;10;0;100;0;194676.1;1969.8;106.3
89431;2023;3;3;0;100;0;191763.333333333;1701;123.333333333333
89432;2023;8;8;0;100;0;160146.25;2002.375;93.125
89433;2023;4;4;0;100;0;130250;1294;104.5
89434;2023;3;3;0;100;0;95666.6666666667;1114.33333333333;83.3333333333333
89436;2023;13;13;0;100;0;106341.538461538;1035.84615384615;103.923076923077
89437;2023;1;1;0;100;0;182500;1304;140
89438;2023;15;15;0;100;0;154700;1875.33333333333;81.2666666666667
89439;2023;11;11;0;100;0;150695.454545455;1294.27272727273;123.363636363636
89440;2023;4;4;0;100;0;102375;1269.5;78.75
89441;2023;24;23;1;95.8333333333333;4.16666666666667;86326.9166666667;935.875;94.5833333333333
89442;2023;5;5;0;100;0;170000;1587.2;104.4
89443;2023;10;10;0;100;0;149155;1823.7;78.1
89446;2023;4;4;0;100;0;300625;3256.25;94.75
89447;2023;1;1;0;100;0;21000;477;44
89449;2023;34;34;0;100;0;201267.735294118;2016.05882352941;106.323529411765
89450;2023;9;9;0;100;0;161127.777777778;1533.77777777778;103.333333333333
89451;2023;2;2;0;100;0;92000;1366.5;68
89452;2023;4;4;0;100;0;61500;1196;51
89453;2023;9;9;0;100;0;145185.111111111;1556.77777777778;93.2222222222222
89456;2023;6;6;0;100;0;163885.833333333;1420.83333333333;113.166666666667
89459;2023;11;11;0;100;0;181520.909090909;1707.90909090909;127.727272727273
89460;2023;36;34;2;94.4444444444444;5.55555555555556;141960;1879;78.75
89461;2023;15;15;0;100;0;94818.6666666667;953.2;105
89462;2023;4;4;0;100;0;167550;1679.25;103.5
89464;2023;76;63;13;82.8947368421053;17.1052631578947;120233.052631579;1562.92105263158;80.8552631578947
89465;2023;3;3;0;100;0;198116.666666667;1963.66666666667;91.6666666666667
89466;2023;4;4;0;100;0;209800.5;1512.5;152
89467;2023;10;10;0;100;0;186450;1662.9;114.7
89468;2023;8;8;0;100;0;114500;1277.875;89.5
89469;2023;13;13;0;100;0;175896.153846154;1356.30769230769;132
89470;2023;2;2;0;100;0;38750;534;75.5
89471;2023;6;6;0;100;0;179775;1843.5;99.1666666666667
89472;2023;7;7;0;100;0;136543.428571429;1237.57142857143;102.142857142857
89474;2023;1;1;0;100;0;134000;1411;95
89475;2023;4;4;0;100;0;62360;784.5;79.25
89477;2023;2;2;0;100;0;198850;1321.5;155
89478;2023;16;15;1;93.75;6.25;128329.375;1388.875;92.0625
89479;2023;5;5;0;100;0;160400;1525.8;108.8
89480;2023;24;24;0;100;0;170239.583333333;2074.04166666667;88.6666666666667
89481;2023;1;1;0;100;0;60000;938;64
89482;2023;1;1;0;100;0;78000;2000;39
89483;2023;4;4;0;100;0;102625;1327;88
89485;2023;3;3;0;100;0;58333.3333333333;665;88.6666666666667
89486;2023;1;1;0;100;0;61215;1020;60
90001;2023;8;7;1;87.5;12.5;104187.5;1288.25;82.375
90002;2023;4;4;0;100;0;191450;1729.75;122.25
90003;2023;11;9;2;81.8181818181818;18.1818181818182;244172.727272727;2259;118.181818181818
90004;2023;2;1;1;50;50;163687;1804.5;89.5
90005;2023;3;3;0;100;0;126000;3262;58.6666666666667
90006;2023;4;4;0;100;0;104525;950.5;108.25
90007;2023;3;3;0;100;0;131833.333333333;1549.66666666667;84
90008;2023;38;24;14;63.1578947368421;36.8421052631579;180334.210526316;1913.10526315789;93.8421052631579
90009;2023;48;31;17;64.5833333333333;35.4166666666667;124145.416666667;1276.5625;96.8958333333333
90010;2023;632;100;532;15.8227848101266;84.1772151898734;104288.327531646;1375.87816455696;74.4066455696203
90011;2023;2;2;0;100;0;222025;2498;86.5
90012;2023;8;7;1;87.5;12.5;238949.375;2100.75;121.5
90013;2023;3;3;0;100;0;242200;2310.66666666667;105.666666666667
90014;2023;6;6;0;100;0;202200;1506;136
90016;2023;1;1;0;100;0;323300;2811;115
90017;2023;10;3;7;30;70;131080;1313.9;99.5
90018;2023;4;4;0;100;0;180000;1634.25;112
90019;2023;3;2;1;66.6666666666667;33.3333333333333;237916.666666667;1627.33333333333;161.333333333333
90020;2023;4;4;0;100;0;197887.5;1753.25;112.5
90022;2023;27;20;7;74.0740740740741;25.9259259259259;177106.481481481;1999.14814814815;89.4074074074074
90023;2023;7;5;2;71.4285714285714;28.5714285714286;160001.428571429;1538.42857142857;104.285714285714
90025;2023;3;3;0;100;0;197366.666666667;1819;107.666666666667
90026;2023;13;9;4;69.2307692307692;30.7692307692308;162841.923076923;1976.92307692308;84.1538461538462
90027;2023;3;3;0;100;0;184900;1755.33333333333;102
90028;2023;4;4;0;100;0;275550;2504.5;107.5
90029;2023;17;7;10;41.1764705882353;58.8235294117647;143182.352941176;1522;91.8823529411765
90030;2023;2;2;0;100;0;149500;1003.5;162.5
90031;2023;1;1;0;100;0;297800;2127;140
90032;2023;37;17;20;45.945945945946;54.0540540540541;164179.459459459;1596.13513513514;98.7027027027027
90033;2023;58;29;29;50;50;140611.034482759;1563.24137931034;90.2413793103448
90034;2023;2;2;0;100;0;268595;1875;143
90035;2023;3;2;1;66.6666666666667;33.3333333333333;338166.666666667;2217;148
90036;2023;4;3;1;75;25;255225;1947.75;125.75
90037;2023;11;9;2;81.8181818181818;18.1818181818182;178544.090909091;1677.90909090909;105.636363636364
90039;2023;45;32;13;71.1111111111111;28.8888888888889;189031.333333333;1841.91111111111;104.911111111111
90041;2023;15;13;2;86.6666666666667;13.3333333333333;162931.6;1566.26666666667;109.733333333333
90042;2023;13;13;0;100;0;244878.461538462;2066.38461538462;121.307692307692
90043;2023;6;5;1;83.3333333333333;16.6666666666667;173406.666666667;1305.83333333333;130.333333333333
90045;2023;1;1;0;100;0;140000;1321;106
90046;2023;3;3;0;100;0;271833.333333333;2641;109
90047;2023;5;5;0;100;0;202724;1791.4;116.4
90048;2023;2;2;0;100;0;270550;2402.5;114.5
90049;2023;6;5;1;83.3333333333333;16.6666666666667;165516.666666667;1729.33333333333;95.3333333333333
90051;2023;4;4;0;100;0;221168.75;1345.5;159.25
90052;2023;23;16;7;69.5652173913043;30.4347826086957;123665.217391304;1247.73913043478;107.869565217391
90053;2023;16;10;6;62.5;37.5;134717.5625;1574.875;83.75
90054;2023;5;5;0;100;0;196968;1779.8;113.4
90055;2023;5;4;1;80;20;235820;2182.4;109.4
90056;2023;20;19;1;95;5;193255.5;1815.65;108.45
90057;2023;6;5;1;83.3333333333333;16.6666666666667;238458.333333333;2238.33333333333;111.166666666667
90058;2023;6;6;0;100;0;213933.333333333;1548.16666666667;140.5
90059;2023;1;1;0;100;0;115000;1885;61
90062;2023;4;4;0;100;0;220600;2527.25;86.5
90063;2023;4;4;0;100;0;232800;1874;119.75
90064;2023;2;2;0;100;0;184000;1479.5;114
90065;2023;15;11;4;73.3333333333333;26.6666666666667;140335.333333333;1566.33333333333;97.8666666666667
90067;2023;5;5;0;100;0;306959.2;2074.8;158.6
90068;2023;14;11;3;78.5714285714286;21.4285714285714;215785.714285714;2022.28571428571;105.428571428571
90069;2023;16;11;5;68.75;31.25;133892.5625;1425;96.0625
90070;2023;6;6;0;100;0;243330;1803.83333333333;138.333333333333
90071;2023;5;5;0;100;0;220131;1865.8;120.2
90072;2023;8;6;2;75;25;145262.5;1622.125;85.375
90074;2023;4;3;1;75;25;226500;1998.75;119.5
90075;2023;27;21;6;77.7777777777778;22.2222222222222;197610.555555556;2090.44444444444;93.2592592592593
90076;2023;6;5;1;83.3333333333333;16.6666666666667;181041.666666667;1740;104.666666666667
90077;2023;3;2;1;66.6666666666667;33.3333333333333;153300;1551.33333333333;98.3333333333333
90078;2023;1;1;0;100;0;286000;1946;147
90079;2023;2;2;0;100;0;207237.5;1780;111
90080;2023;5;5;0;100;0;202875.2;2006.2;99.8
90081;2023;6;6;0;100;0;193858.333333333;1552.66666666667;126.833333333333
90082;2023;1;1;0;100;0;255000;2656;96
90083;2023;1;1;0;100;0;474750;2931;162
90084;2023;3;3;0;100;0;223000;1822.33333333333;123.333333333333
90085;2023;1;1;0;100;0;270000;2523;107
90086;2023;1;1;0;100;0;217000;1973;110
90087;2023;6;5;1;83.3333333333333;16.6666666666667;216873.333333333;2026.66666666667;105
90088;2023;6;5;1;83.3333333333333;16.6666666666667;160666.666666667;1705.33333333333;93.3333333333333
90089;2023;11;6;5;54.5454545454545;45.4545454545455;147324;1602.72727272727;100.818181818182
90090;2023;1;1;0;100;0;169600;2043;83
90091;2023;4;4;0;100;0;269362.5;2271.25;112.25
90093;2023;6;5;1;83.3333333333333;16.6666666666667;160291.666666667;1705.16666666667;104.333333333333
90094;2023;6;5;1;83.3333333333333;16.6666666666667;386416.666666667;3457.33333333333;98.1666666666667
90095;2023;4;4;0;100;0;171750;1825;101
90096;2023;2;2;0;100;0;213900;2085;105
90097;2023;9;7;2;77.7777777777778;22.2222222222222;194044.444444444;1838.77777777778;110.555555555556
90098;2023;5;5;0;100;0;240680;2810.4;96.2
90099;2023;63;20;43;31.7460317460317;68.2539682539683;105380.492063492;1372.44444444444;75.5714285714286
90100;2023;1;1;0;100;0;150000;1364;110
90101;2023;2;2;0;100;0;423000;2773;149.5
90102;2023;5;5;0;100;0;166000;1812;105
90103;2023;8;7;1;87.5;12.5;186526.875;1295.625;149.375
90104;2023;10;7;3;70;30;190050;2035.8;94.2
90105;2023;1;1;0;100;0;230000;1917;120
91001;2023;4;4;0;100;0;223850;1987;116
91016;2023;47;39;8;82.9787234042553;17.0212765957447;170902.978723404;2299.36170212766;78.3404255319149
91017;2023;19;15;4;78.9473684210526;21.0526315789474;297502.789473684;3134;100.947368421053
91021;2023;170;32;138;18.8235294117647;81.1764705882353;189003.423529412;3422.96470588235;57.4235294117647
91027;2023;276;97;179;35.1449275362319;64.8550724637681;242146.40942029;3692.59782608696;67.3659420289855
91035;2023;3;3;0;100;0;289482.333333333;2590;109.666666666667
91037;2023;1;1;0;100;0;5,00E+05;5495;91
91038;2023;7;7;0;100;0;345128.857142857;2196.71428571429;158.428571428571
91041;2023;10;9;1;90;10;429297;3785.8;121.2
91044;2023;41;25;16;60.9756097560976;39.0243902439024;331958.170731707;4196.12195121951;86.3170731707317
91045;2023;78;62;16;79.4871794871795;20.5128205128205;279291.153846154;3374.07692307692;85.8846153846154
91047;2023;12;9;3;75;25;273883.333333333;3035.41666666667;91.0833333333333
91064;2023;54;31;23;57.4074074074074;42.5925925925926;476874.796296296;5197.2962962963;90.7222222222222
91069;2023;2;2;0;100;0;260500;2043.5;117.5
91079;2023;2;2;0;100;0;503900;3386.5;146.5
91080;2023;13;10;3;76.9230769230769;23.0769230769231;252092.307692308;2681.30769230769;101.076923076923
91081;2023;4;4;0;100;0;253875;2014.5;130.25
91085;2023;39;30;9;76.9230769230769;23.0769230769231;255779.384615385;2877.89743589744;94.4358974358974
91086;2023;103;67;36;65.0485436893204;34.9514563106796;261546.310679612;3080.22330097087;87.0097087378641
91093;2023;7;7;0;100;0;328935.714285714;3416.14285714286;95.1428571428571
91095;2023;26;24;2;92.3076923076923;7.69230769230769;304740.769230769;3859.19230769231;87.0769230769231
91097;2023;102;39;63;38.2352941176471;61.7647058823529;223052.215686275;2879.45098039216;78.1176470588235
91098;2023;3;3;0;100;0;320920;2035;153.333333333333
91099;2023;39;27;12;69.2307692307692;30.7692307692308;273667.974358974;2870.30769230769;97.4358974358974
91100;2023;4;4;0;100;0;277650;2405.25;114.25
91103;2023;253;113;140;44.6640316205534;55.3359683794466;239478.185770751;3430.45454545455;72.3873517786561
91105;2023;41;39;2;95.1219512195122;4.8780487804878;315917.073170732;3376.85365853659;95.4146341463415
91106;2023;9;9;0;100;0;663742.111111111;4378.11111111111;108.888888888889
91109;2023;14;12;2;85.7142857142857;14.2857142857143;257468.928571429;2780.92857142857;97.2857142857143
91111;2023;23;21;2;91.304347826087;8.69565217391304;335078.652173913;3584.60869565217;95.2608695652174
91114;2023;283;130;153;45.9363957597173;54.0636042402827;298051.332155477;3771.48763250883;80.0388692579505
91115;2023;48;34;14;70.8333333333333;29.1666666666667;266057.9375;3337.95833333333;83.7916666666667
91121;2023;6;6;0;100;0;317331.833333333;3391.66666666667;99
91122;2023;79;51;28;64.5569620253165;35.4430379746835;386937.493670886;4460.55696202532;91.2151898734177
91129;2023;47;34;13;72.3404255319149;27.6595744680851;254518.510638298;3147.04255319149;84.468085106383
91130;2023;17;14;3;82.3529411764706;17.6470588235294;269375.588235294;2499.88235294118;111.823529411765
91131;2023;8;8;0;100;0;208082;2678.125;84.125
91132;2023;12;8;4;66.6666666666667;33.3333333333333;262216.666666667;3139.16666666667;85
91135;2023;22;22;0;100;0;329164.090909091;3532.59090909091;97.6818181818182
91136;2023;17;14;3;82.3529411764706;17.6470588235294;277678.117647059;3738.94117647059;83.6470588235294
91137;2023;6;6;0;100;0;213783.333333333;2416;92
91145;2023;1;1;0;100;0;265000;3841;69
91148;2023;1;1;0;100;0;273900;1640;167
91156;2023;24;20;4;83.3333333333333;16.6666666666667;336123.333333333;3408.875;101.583333333333
91159;2023;15;13;2;86.6666666666667;13.3333333333333;282680;3112.53333333333;94.7333333333333
91161;2023;237;35;202;14.7679324894515;85.2320675105485;190657.907172996;3048.13080168776;67.6244725738397
91174;2023;606;133;473;21.9471947194719;78.052805280528;161628.51650165;2853.55775577558;58.539603960396
91175;2023;14;12;2;85.7142857142857;14.2857142857143;238962.5;2713.64285714286;90.9285714285714
91179;2023;50;27;23;54;46;243545;3089.1;83.92
91180;2023;4;4;0;100;0;517250;3301;154
91184;2023;3;3;0;100;0;360850;2658;134.333333333333
91186;2023;11;10;1;90.9090909090909;9.09090909090909;332909.090909091;3260.36363636364;107.090909090909
91191;2023;95;42;53;44.2105263157895;55.7894736842105;269699.894736842;3590.74736842105;77.3578947368421
91195;2023;11;7;4;63.6363636363636;36.3636363636364;286024.818181818;3562.18181818182;85.6363636363636
91198;2023;23;20;3;86.9565217391304;13.0434782608696;301178.826086957;2999.26086956522;104.391304347826
91200;2023;121;46;75;38.0165289256198;61.9834710743802;205378.818181818;3068.86776859504;70.3884297520661
91201;2023;261;166;95;63.6015325670498;36.3984674329502;309325.103448276;3754.89655172414;84.6168582375479
91204;2023;4;4;0;100;0;324275;3075.5;110.25
91207;2023;51;37;14;72.5490196078431;27.4509803921569;275713.470588235;3313.39215686275;89.9607843137255
91215;2023;94;28;66;29.7872340425532;70.2127659574468;166574.670212766;2311.39361702128;72.5744680851064
91216;2023;109;71;38;65.1376146788991;34.8623853211009;275974.541284404;4001.97247706422;69.8990825688073
91223;2023;309;96;213;31.0679611650485;68.9320388349515;155995.579288026;2615.53721682848;62.5728155339806
91225;2023;32;19;13;59.375;40.625;426907.1875;3650.0625;111.09375
91226;2023;76;53;23;69.7368421052632;30.2631578947368;265223.105263158;3214.73684210526;83.4342105263158
91228;2023;478;60;418;12.5523012552301;87.4476987447699;163692.491631799;2451.81380753138;69.2489539748954
91232;2023;47;26;21;55.3191489361702;44.6808510638298;259774.744680851;3063.42553191489;90.1702127659574
91235;2023;59;20;39;33.8983050847458;66.1016949152542;201668.389830508;3195.81355932203;63.5762711864407
91240;2023;9;7;2;77.7777777777778;22.2222222222222;376192.222222222;3205.88888888889;118.222222222222
91243;2023;20;17;3;85;15;319992.5;3388.85;107.85
91244;2023;17;13;4;76.4705882352941;23.5294117647059;278966.823529412;3440.11764705882;78.4117647058823
91247;2023;4;4;0;100;0;257750;2822.25;95
91248;2023;1;1;0;100;0;220000;2785;79
91249;2023;39;29;10;74.3589743589744;25.6410256410256;289613;3096.76923076923;96.8974358974359
91272;2023;181;84;97;46.4088397790055;53.5911602209945;422004.91160221;4428.07182320442;97.0110497237569
91273;2023;9;8;1;88.8888888888889;11.1111111111111;246055.555555556;2972.77777777778;86.7777777777778
91274;2023;10;6;4;60;40;362903;3699.3;105.7
91275;2023;23;20;3;86.9565217391304;13.0434782608696;379643.434782609;3767.60869565217;104.086956521739
91284;2023;16;15;1;93.75;6.25;305721;3075.25;103.75
91286;2023;56;15;41;26.7857142857143;73.2142857142857;135516.928571429;1964.10714285714;66.8214285714286
91292;2023;9;9;0;100;0;319603.333333333;3263.55555555556;99.5555555555556
91293;2023;12;10;2;83.3333333333333;16.6666666666667;254533.333333333;2968;90.9166666666667
91294;2023;12;12;0;100;0;241302.166666667;2814.83333333333;89.3333333333333
91312;2023;97;66;31;68.0412371134021;31.9587628865979;440844.381443299;5049.14432989691;90.2783505154639
91315;2023;70;67;3;95.7142857142857;4.28571428571429;285302.142857143;3243.22857142857;93.2571428571429
91318;2023;24;21;3;87.5;12.5;296203.166666667;3176.20833333333;93.0416666666667
91319;2023;1;1;0;100;0;555000;4549;122
91326;2023;226;47;179;20.7964601769912;79.2035398230089;218661.955752212;3625.06637168142;61.3097345132743
91330;2023;49;27;22;55.1020408163265;44.8979591836735;208994.448979592;3063.91836734694;71.3469387755102
91332;2023;22;18;4;81.8181818181818;18.1818181818182;309969.909090909;3555.27272727273;95.5454545454545
91333;2023;45;34;11;75.5555555555556;24.4444444444444;271242.533333333;3383.33333333333;84.2666666666667
91338;2023;54;43;11;79.6296296296296;20.3703703703704;347477.055555556;3604.12962962963;100.537037037037
91339;2023;100;64;36;64;36;273893.91;3563.51;79.21
91340;2023;66;46;20;69.6969696969697;30.3030303030303;255144.393939394;3042.34848484848;85.4393939393939
91345;2023;253;60;193;23.7154150197628;76.2845849802372;205662.806324111;3073.42292490119;67.9565217391304
91347;2023;72;51;21;70.8333333333333;29.1666666666667;292139.902777778;3508.36111111111;85.8333333333333
91359;2023;25;20;5;80;20;232480;2587.92;90.88
91363;2023;69;50;19;72.463768115942;27.536231884058;339771;3964.47826086957;90.2028985507246
91374;2023;3;3;0;100;0;304333.333333333;3149;98.3333333333333
91376;2023;66;44;22;66.6666666666667;33.3333333333333;293371.96969697;3459.33333333333;86.3787878787879
91377;2023;549;45;504;8.19672131147541;91.8032786885246;272490.007285975;4214.98360655738;66.9817850637523
91378;2023;5;0;5;0;100;210240;3176.6;68.2
91386;2023;175;106;69;60.5714285714286;39.4285714285714;278695.04;3181.61142857143;91.4457142857143
91390;2023;40;33;7;82.5;17.5;204296.975;2411.1;89.375
91393;2023;6;6;0;100;0;190250;2433;81.3333333333333
91399;2023;4;4;0;100;0;236625;2494.75;95.5
91405;2023;47;40;7;85.1063829787234;14.8936170212766;348368.085106383;3789.46808510638;97.5744680851064
91408;2023;18;18;0;100;0;345995;3221.38888888889;108.055555555556
91411;2023;6;5;1;83.3333333333333;16.6666666666667;378075;4474.83333333333;89.1666666666667
91412;2023;3;3;0;100;0;330316.666666667;2846.33333333333;124
91414;2023;1;1;0;100;0;190500;2140;89
91421;2023;233;127;106;54.5064377682403;45.4935622317597;298190.566523605;3916.10300429185;78.1716738197425
91425;2023;91;43;48;47.2527472527472;52.7472527472528;270906.054945055;3746.50549450549;71.956043956044
91432;2023;147;98;49;66.6666666666667;33.3333333333333;301109.102040816;4253.79591836735;77.734693877551
91433;2023;54;43;11;79.6296296296296;20.3703703703704;273751.388888889;3040.5;93.9444444444444
91434;2023;205;123;82;60;40;277320.912195122;3656.23902439024;77.0878048780488
91435;2023;5;5;0;100;0;431800;2529.6;163.4
91441;2023;8;8;0;100;0;325937.5;3295.625;109.625
91457;2023;39;33;6;84.6153846153846;15.3846153846154;317648.820512821;3449.07692307692;96.4358974358974
91458;2023;46;31;15;67.3913043478261;32.6086956521739;329685.782608696;3914.41304347826;90.5434782608696
91461;2023;42;36;6;85.7142857142857;14.2857142857143;273980.357142857;3131.21428571429;87.9761904761905
91463;2023;14;14;0;100;0;365278.571428571;3351.5;105.571428571429
91468;2023;19;18;1;94.7368421052632;5.26315789473684;376729.052631579;4321.36842105263;97.6842105263158
91469;2023;11;10;1;90.9090909090909;9.09090909090909;244464.636363636;2851.18181818182;85.3636363636364
91471;2023;182;93;89;51.0989010989011;48.9010989010989;350244.697802198;4659.04945054945;76.9230769230769
91473;2023;3;3;0;100;0;282500;3167.33333333333;92.6666666666667
91477;2023;335;108;227;32.2388059701493;67.7611940298507;316972.328358209;4442.3223880597;72.4477611940299
91479;2023;69;52;17;75.3623188405797;24.6376811594203;291290.739130435;4112.57971014493;76.2173913043478
91482;2023;9;7;2;77.7777777777778;22.2222222222222;311356.666666667;3090.44444444444;105.222222222222
91494;2023;38;29;9;76.3157894736842;23.6842105263158;320507.763157895;3397.63157894737;96.0789473684211
91495;2023;4;4;0;100;0;204675.5;2943.75;81.5
91507;2023;4;4;0;100;0;292050;3204.75;108.5
91508;2023;6;6;0;100;0;273658.333333333;2734.16666666667;106.166666666667
91511;2023;25;12;13;48;52;147579.6;2130.72;70.6
91514;2023;81;40;41;49.3827160493827;50.6172839506173;230417.024691358;3198.64197530864;75.3950617283951
91519;2023;5;5;0;100;0;207000;2136.4;97
91521;2023;264;71;193;26.8939393939394;73.1060606060606;174966.613636364;2557.81439393939;68.7348484848485
91525;2023;9;9;0;100;0;326805.555555556;2548.66666666667;129.333333333333
91533;2023;29;22;7;75.8620689655172;24.1379310344828;219645.896551724;2261.13793103448;103.034482758621
91534;2023;44;35;9;79.5454545454545;20.4545454545455;471542.090909091;5384.04545454545;93.7727272727273
91538;2023;5;5;0;100;0;466600;3368.6;141.4
91540;2023;55;42;13;76.3636363636364;23.6363636363636;252152.6;3213.4;81.7454545454545
91544;2023;2;2;0;100;0;185000;1667.5;113
91546;2023;10;10;0;100;0;297928.4;3132.9;99
91547;2023;6;6;0;100;0;228245.333333333;2036.33333333333;107.166666666667
91549;2023;364;191;173;52.4725274725275;47.5274725274725;272506.184065934;3630.98076923077;76.6126373626374
91552;2023;82;51;31;62.1951219512195;37.8048780487805;261130.365853659;3274.82926829268;81.4390243902439
91553;2023;87;60;27;68.9655172413793;31.0344827586207;318564.942528736;3452.45977011494;95.4367816091954
91556;2023;2;2;0;100;0;280000;3022.5;93.5
91560;2023;3;2;1;66.6666666666667;33.3333333333333;301288.333333333;2691.66666666667;121
91568;2023;17;17;0;100;0;380044.117647059;3214;121.235294117647
91570;2023;165;75;90;45.4545454545455;54.5454545454545;236835.03030303;3059.34545454545;78.7636363636364
91573;2023;160;73;87;45.625;54.375;254281.84375;3504.225;74.9
91577;2023;46;34;12;73.9130434782609;26.0869565217391;305688.260869565;3150.71739130435;102.891304347826
91578;2023;3;3;0;100;0;555000;2994.33333333333;171.333333333333
91579;2023;27;17;10;62.962962962963;37.037037037037;352301.851851852;3866.74074074074;89.1481481481482
91581;2023;6;6;0;100;0;455933.333333333;3000.83333333333;132.666666666667
91587;2023;59;37;22;62.7118644067797;37.2881355932203;364631.06779661;4049.8813559322;89.3389830508475
91589;2023;422;233;189;55.2132701421801;44.7867298578199;251158.587677725;3613.15165876777;71.5497630331754
91593;2023;16;15;1;93.75;6.25;286461.75;2530.9375;118.0625
91599;2023;17;16;1;94.1176470588235;5.88235294117647;200465.882352941;2715.58823529412;74.1176470588235
91600;2023;72;36;36;50;50;302278.263888889;3543.56944444444;87.7777777777778
91602;2023;5;3;2;60;40;230120;2663.4;94.4
91613;2023;3;3;0;100;0;209000;2185.66666666667;95.6666666666667
91617;2023;43;28;15;65.1162790697674;34.8837209302326;319911.906976744;3805.16279069767;87
91619;2023;2;2;0;100;0;316900;2733.5;120
91629;2023;8;8;0;100;0;221735.625;3411.5;63.625
91630;2023;19;17;2;89.4736842105263;10.5263157894737;304304.473684211;3050.63157894737;103.210526315789
91631;2023;23;21;2;91.304347826087;8.69565217391304;484356.52173913;4658.69565217391;130.086956521739
91634;2023;8;6;2;75;25;272822.5;3136.25;95.5
91635;2023;17;15;2;88.2352941176471;11.7647058823529;675574.941176471;5171.64705882353;131
91639;2023;8;7;1;87.5;12.5;292250;3281.625;92.125
91645;2023;137;80;57;58.3941605839416;41.6058394160584;544389.94890511;5340.3795620438;101.868613138686
91648;2023;11;5;6;45.4545454545455;54.5454545454545;242386.363636364;3091.90909090909;82.5454545454545
91649;2023;28;17;11;60.7142857142857;39.2857142857143;277385.142857143;3160.92857142857;88.2142857142857
91654;2023;9;9;0;100;0;275816.666666667;3314.33333333333;88.6666666666667
91657;2023;291;155;136;53.2646048109966;46.7353951890034;241721.484536082;3750.16838487973;65.9553264604811
91659;2023;41;31;10;75.609756097561;24.390243902439;314872.43902439;3594.53658536585;87.8780487804878
91661;2023;100;46;54;46;54;311280.67;4025.79;79.7
91662;2023;10;10;0;100;0;350325.5;4044.1;92.1
91665;2023;61;55;6;90.1639344262295;9.83606557377049;327138.540983607;3747.19672131148;91.8360655737705
91666;2023;23;18;5;78.2608695652174;21.7391304347826;348483.043478261;3959.30434782609;93.2173913043478
91667;2023;61;46;15;75.4098360655738;24.5901639344262;343089.163934426;3688.24590163934;96.0983606557377
91671;2023;9;9;0;100;0;315933.666666667;2873.77777777778;111.444444444444
91679;2023;11;8;3;72.7272727272727;27.2727272727273;379326.272727273;4432.36363636364;91.8181818181818
91685;2023;36;22;14;61.1111111111111;38.8888888888889;267103.333333333;3299.69444444444;82.4444444444444
91687;2023;259;105;154;40.5405405405405;59.4594594594595;231367.463320463;3354.6332046332;71.6563706563707
91689;2023;68;29;39;42.6470588235294;57.3529411764706;325359.573529412;4289.55882352941;79.3382352941177
91691;2023;293;123;170;41.9795221843003;58.0204778156997;286272.283276451;3592.14675767918;80.8668941979522
91692;2023;187;16;171;8.55614973262032;91.4438502673797;178440.882352941;2575.26203208556;71.9679144385027
92002;2023;589;205;384;34.804753820034;65.195246179966;446516.884550085;5820.1935483871;77.0797962648557
92004;2023;1170;100;1070;8.54700854700855;91.4529914529915;404843.35982906;6762.56068376068;58.5230769230769
92007;2023;202;34;168;16.8316831683168;83.1683168316832;328664.534653465;5401.67326732673;61.1138613861386
92009;2023;432;83;349;19.212962962963;80.787037037037;470514.231481481;7264.09027777778;62.3842592592593
92012;2023;1474;20;1454;1.35685210312076;98.6431478968792;526789.100407056;8916.20149253731;57.9056987788331
92014;2023;202;42;160;20.7920792079208;79.2079207920792;447503.45049505;6158.05940594059;71.1138613861386
92019;2023;297;18;279;6.06060606060606;93.9393939393939;339002.63973064;5113.44107744108;66.5117845117845
92020;2023;389;54;335;13.8817480719794;86.1182519280206;381178.267352185;6210.83804627249;61.866323907455
92022;2023;210;56;154;26.6666666666667;73.3333333333333;442648.966666667;6239.76666666667;69.9190476190476
92023;2023;507;132;375;26.0355029585799;73.9644970414201;464640.57790927;6521.81262327416;70.5641025641026
92024;2023;691;7;684;1.01302460202605;98.9869753979739;342646.136034732;7026.59044862518;49.2214182344428
92025;2023;839;240;599;28.6054827175209;71.3945172824791;398201.535160906;5923.47675804529;65.1120381406436
92026;2023;957;30;927;3.13479623824451;96.8652037617555;408900.893416928;7112.79728317659;57.7314524555904
92032;2023;176;31;145;17.6136363636364;82.3863636363636;356612.210227273;5138.67045454545;68.0795454545455
92033;2023;203;50;153;24.6305418719212;75.3694581280788;645890.251231527;7026.87684729064;89.3004926108374
92035;2023;392;40;352;10.2040816326531;89.7959183673469;477261.5;7233.93112244898;63.8494897959184
92036;2023;119;19;100;15.9663865546218;84.0336134453782;286919.260504202;4734.78991596639;61.4453781512605
92040;2023;725;34;691;4.68965517241379;95.3103448275862;452295.273103448;8025.70344827586;55.7820689655172
92044;2023;820;7;813;0.853658536585366;99.1463414634146;533370.012195122;9314.68292682927;56.4756097560976
92046;2023;229;44;185;19.2139737991266;80.7860262008734;404452.681222707;7147.43668122271;55.8995633187773
92047;2023;11;7;4;63.6363636363636;36.3636363636364;974526;8020.36363636364;112
92048;2023;483;76;407;15.7349896480331;84.2650103519669;454616.403726708;6131.51138716356;70.3933747412008
92049;2023;615;28;587;4.55284552845528;95.4471544715447;414134.873170732;7602.01300813008;54.5138211382114
92050;2023;462;119;343;25.7575757575758;74.2424242424242;375967.941558442;5845.59090909091;65.9393939393939
92051;2023;815;7;808;0.858895705521472;99.1411042944785;879181.439263804;10900.0748466258;78.6122699386503
92060;2023;299;23;276;7.69230769230769;92.3076923076923;373400.257525084;5698.98996655518;66.3311036789298
92062;2023;501;15;486;2.9940119760479;97.0059880239521;405658.612774451;7346.19361277445;56.125748502994
92063;2023;841;192;649;22.8299643281807;77.1700356718193;509761.651605232;6448.41854934602;75.4328180737218
92064;2023;309;34;275;11.0032362459547;88.9967637540453;612023.919093851;7338.11326860841;80.0323624595469
92071;2023;195;35;160;17.9487179487179;82.051282051282;549805.558974359;6746.73846153846;80.3179487179487
92072;2023;226;44;182;19.4690265486726;80.5309734513274;523890.924778761;6532.93362831858;75.8761061946903
92073;2023;448;60;388;13.3928571428571;86.6071428571429;506816.642857143;7346.85044642857;67.9107142857143
92075;2023;307;16;291;5.21172638436482;94.7882736156352;376640.022801303;7095.33876221498;53.557003257329
92076;2023;85;24;61;28.2352941176471;71.7647058823529;725947.8;6194.81176470588;107.941176470588
92077;2023;74;11;63;14.8648648648649;85.1351351351351;597821.675675676;6208.08108108108;93.8918918918919
92078;2023;103;8;95;7.76699029126214;92.2330097087379;199447.718446602;3527.95145631068;59.504854368932
93001;2023;453;36;417;7.94701986754967;92.0529801324503;201059.746136865;4212.48785871965;49.0485651214128
93005;2023;530;288;242;54.3396226415094;45.6603773584906;257267.545283019;3767.04339622642;71.6905660377358
93006;2023;233;43;190;18.4549356223176;81.5450643776824;330452.158798283;5941.01287553648;56.7381974248927
93007;2023;247;140;107;56.6801619433198;43.3198380566802;258207.097165992;3882.99190283401;69.085020242915
93008;2023;212;94;118;44.3396226415094;55.6603773584906;254399.721698113;4037.48113207547;65.938679245283
93010;2023;324;128;196;39.5061728395062;60.4938271604938;208007.462962963;3507.9475308642;62.7901234567901
93013;2023;100;17;83;17;83;211404.09;3842.59;56.2
93014;2023;175;49;126;28;72;166207.908571429;2464.05714285714;68.7085714285714
93015;2023;65;45;20;69.2307692307692;30.7692307692308;296224.953846154;3352.90769230769;91.4615384615385
93027;2023;134;28;106;20.8955223880597;79.1044776119403;182634.380597015;3397.88059701493;57.9029850746269
93029;2023;522;226;296;43.2950191570881;56.7049808429119;227190.683908046;3852.08237547893;61.5536398467433
93030;2023;28;7;21;25;75;199103.142857143;2819.82142857143;72.8214285714286
93031;2023;347;66;281;19.0201729106628;80.9798270893372;193044.53314121;2990.14985590778;65.657060518732
93032;2023;389;216;173;55.5269922879177;44.4730077120823;266011.982005141;3753.87917737789;72.172236503856
93033;2023;93;58;35;62.3655913978495;37.6344086021505;338581.967741935;4510.81720430108;76.8709677419355
93039;2023;57;4;53;7.01754385964912;92.9824561403509;242682.315789474;4197.78947368421;56.4736842105263
93045;2023;217;28;189;12.9032258064516;87.0967741935484;351968.01843318;7003.16589861751;50.0691244239631
93046;2023;494;193;301;39.0688259109312;60.9311740890688;221159.05465587;3419.22469635628;66.8421052631579
93047;2023;194;159;35;81.9587628865979;18.0412371134021;293633.092783505;3690.25257731959;84.1288659793814
93048;2023;1002;186;816;18.562874251497;81.437125748503;388000.189620758;6632.22954091816;58.8802395209581
93049;2023;195;82;113;42.0512820512821;57.948717948718;307417.887179487;4596.2;69.2769230769231
93050;2023;241;63;178;26.1410788381743;73.8589211618257;242054.033195021;3722.4979253112;66.9045643153527
93051;2023;660;140;520;21.2121212121212;78.7878787878788;276299.881818182;4430.68333333333;64.4287878787879
93053;2023;287;96;191;33.4494773519164;66.5505226480836;254187.216027875;3988.40069686411;64.7665505226481
93055;2023;496;24;472;4.83870967741935;95.1612903225807;317913.929435484;6172.45564516129;51.3387096774194
93057;2023;287;114;173;39.7212543554007;60.2787456445993;233798.508710801;3611.65156794425;65.5609756097561
93059;2023;174;52;122;29.8850574712644;70.1149425287356;181364.442528736;3278.16091954023;59.4137931034483
93061;2023;150;14;136;9.33333333333333;90.6666666666667;360525.62;6632.83333333333;54.5933333333333
93062;2023;176;45;131;25.5681818181818;74.4318181818182;329375.642045455;4459.91477272727;75.2784090909091
93063;2023;243;66;177;27.1604938271605;72.8395061728395;367984.382716049;5999.47325102881;63.1975308641975
93064;2023;390;74;316;18.974358974359;81.025641025641;261112.794871795;4280.08717948718;62.1589743589744
93066;2023;725;63;662;8.68965517241379;91.3103448275862;220118.551724138;4236.79034482759;52.6951724137931
93070;2023;557;24;533;4.30879712746858;95.6912028725314;333180.26032316;6550.57450628366;50.5960502692998
93071;2023;285;152;133;53.3333333333333;46.6666666666667;220741.610526316;3152.22807017544;73.7228070175439
93072;2023;155;74;81;47.741935483871;52.258064516129;203092.896774194;3235.69032258064;65.5612903225806
93073;2023;296;196;100;66.2162162162162;33.7837837837838;253588.871621622;3390.58783783784;77.8513513513514
93074;2023;71;28;43;39.4366197183099;60.5633802816901;215537.211267606;3689.08450704225;62.5211267605634
93077;2023;329;141;188;42.8571428571429;57.1428571428571;299896.696048632;4334.3009118541;70.6869300911854
93078;2023;248;114;134;45.9677419354839;54.0322580645161;214359.568548387;3154.82661290323;69.7822580645161
93079;2023;38;17;21;44.7368421052632;55.2631578947368;211414.973684211;3267.34210526316;66.6315789473684
94001;2023;67;13;54;19.4029850746269;80.5970149253731;204342.820895522;3281.85074626866;64.6716417910448
94002;2023;410;47;363;11.4634146341463;88.5365853658537;301434.763414634;5418.10243902439;56.6731707317073
94003;2023;164;47;117;28.6585365853659;71.3414634146341;365701.12195122;6112.89024390244;62.859756097561
94004;2023;138;33;105;23.9130434782609;76.0869565217391;231150.507246377;3424.32608695652;72.3768115942029
94011;2023;81;29;52;35.8024691358025;64.1975308641975;277942.950617284;4039.82716049383;71.2222222222222
94015;2023;208;67;141;32.2115384615385;67.7884615384615;444583.360576923;5972.375;74.7644230769231
94016;2023;216;54;162;25;75;344397.791666667;5719.34722222222;61.3564814814815
94017;2023;579;237;342;40.9326424870466;59.0673575129534;309045.222797927;4550.05872193437;69.727115716753
94018;2023;340;6;334;1.76470588235294;98.2352941176471;459814.058823529;7748.65882352941;58.7647058823529
94019;2023;233;63;170;27.0386266094421;72.9613733905579;308274.922746781;4000.71244635193;75.755364806867
94021;2023;147;22;125;14.9659863945578;85.0340136054422;267709.482993197;4116.32653061224;67.9183673469388
94022;2023;424;62;362;14.622641509434;85.377358490566;214996.002358491;3910.28537735849;57.3584905660377
94028;2023;621;63;558;10.1449275362319;89.8550724637681;260808.484702093;4068.71497584541;65.9114331723027
94033;2023;495;137;358;27.6767676767677;72.3232323232323;414125.864646465;6566.88888888889;62.6727272727273
94034;2023;258;31;227;12.015503875969;87.984496124031;236169.887596899;3635.46511627907;66.5813953488372
94037;2023;130;16;114;12.3076923076923;87.6923076923077;315345.238461538;6296;51.4230769230769
94038;2023;252;77;175;30.5555555555556;69.4444444444444;359217.392857143;4828.82936507936;74.3690476190476
94041;2023;501;37;464;7.38522954091816;92.6147704590818;268383.810379242;5372.46706586826;50.684630738523
94042;2023;213;46;167;21.5962441314554;78.4037558685446;423165.370892019;6433.30516431925;64.3380281690141
94043;2023;185;9;176;4.86486486486486;95.1351351351351;306140.697297297;6158.29189189189;52.3081081081081
94044;2023;258;70;188;27.1317829457364;72.8682170542636;239153.643410853;3610.00775193798;68.5736434108527
94046;2023;530;87;443;16.4150943396226;83.5849056603774;357373.935849057;5874.91132075472;60.522641509434
94047;2023;42;29;13;69.0476190476191;30.952380952381;319725.452380952;3760.04761904762;86.8571428571429
94048;2023;46;42;4;91.304347826087;8.69565217391304;428353.369565217;3487.28260869565;125.391304347826
94052;2023;412;53;359;12.8640776699029;87.1359223300971;449095.131067961;6754.29854368932;64.4635922330097
94053;2023;55;41;14;74.5454545454545;25.4545454545455;384016.290909091;4163.05454545455;94.4
94054;2023;127;34;93;26.7716535433071;73.2283464566929;232260.897637795;3642.92125984252;64.3149606299213
94055;2023;98;80;18;81.6326530612245;18.3673469387755;418283.704081633;4990.67346938776;90.3367346938775
94056;2023;23;18;5;78.2608695652174;21.7391304347826;319811.739130435;3695.78260869565;86.5652173913043
94058;2023;471;138;333;29.2993630573248;70.7006369426752;441748.932059448;6236.32059447983;70.3333333333333
94059;2023;198;42;156;21.2121212121212;78.7878787878788;283603.803030303;4117.06060606061;68.8888888888889
94060;2023;101;80;21;79.2079207920792;20.7920792079208;316308.881188119;3612.91089108911;89.2871287128713
94065;2023;43;16;27;37.2093023255814;62.7906976744186;347275.581395349;4675.32558139535;75.8837209302326
94067;2023;255;8;247;3.13725490196078;96.8627450980392;578194.898039216;9015.70980392157;63.1686274509804
94068;2023;976;293;683;30.0204918032787;69.9795081967213;468183.396516393;6431.27868852459;71.3647540983606
94069;2023;143;1;142;0.699300699300699;99.3006993006993;329377.153846154;6384.66433566434;53.3146853146853
94070;2023;39;31;8;79.4871794871795;20.5128205128205;447790.948717949;3561.84615384615;132.410256410256
94071;2023;260;135;125;51.9230769230769;48.0769230769231;368623.230769231;4303.76923076923;87.1769230769231
94073;2023;320;62;258;19.375;80.625;270878.434375;4239.68125;64.921875
94074;2023;52;27;25;51.9230769230769;48.0769230769231;243291.096153846;3441.07692307692;72.4423076923077
94075;2023;124;76;48;61.2903225806452;38.7096774193548;330497.088709677;4100.33064516129;86.1774193548387
94076;2023;434;76;358;17.5115207373272;82.4884792626728;286916.486175115;5353.48617511521;55.6981566820277
94077;2023;164;91;73;55.4878048780488;44.5121951219512;263476.932926829;3910.90243902439;70.0487804878049
94078;2023;199;73;126;36.6834170854271;63.3165829145729;190139.432160804;3441.15075376884;57.7386934673367
94079;2023;368;116;252;31.5217391304348;68.4782608695652;296925.190217391;4463.45108695652;67.3967391304348
94080;2023;766;33;733;4.30809399477807;95.6919060052219;500094.223237598;9025.91906005222;54.6422976501306
94081;2023;573;150;423;26.1780104712042;73.8219895287958;283654.739965096;4647.21640488656;62.2233856893543
95002;2023;15;14;1;93.3333333333333;6.66666666666667;311669;4124.46666666667;92.8666666666667
95008;2023;20;14;6;70;30;240288.1;2473.3;95.25
95011;2023;2;2;0;100;0;216500;1872;134.5
95012;2023;2;1;1;50;50;175000;2788;69.5
95014;2023;22;15;7;68.1818181818182;31.8181818181818;338307.727272727;4213.04545454545;82.7727272727273
95018;2023;843;337;506;39.9762752075919;60.0237247924081;236847.404507711;3711.49940688019;66.1376037959668
95019;2023;132;88;44;66.6666666666667;33.3333333333333;253224.742424242;3647.17424242424;72.5833333333333
95023;2023;5;5;0;100;0;278900;2623;109.6
95024;2023;4;4;0;100;0;308250;3529.75;103.25
95026;2023;32;20;12;62.5;37.5;262498.75;3285.78125;84.21875
95028;2023;13;10;3;76.9230769230769;23.0769230769231;308494.307692308;3675.76923076923;87.4615384615385
95039;2023;91;72;19;79.1208791208791;20.8791208791209;323061.571428571;3968.0989010989;83.5604395604396
95040;2023;6;6;0;100;0;352626.666666667;3181.5;115
95042;2023;26;21;5;80.7692307692308;19.2307692307692;322996.153846154;3772.23076923077;91.8846153846154
95046;2023;2;2;0;100;0;240500;2827.5;98.5
95051;2023;95;67;28;70.5263157894737;29.4736842105263;348160.4;4209;85.4105263157895
95052;2023;128;55;73;42.96875;57.03125;208779.5234375;3208.8984375;69.2265625
95054;2023;3;3;0;100;0;313933.333333333;3773.33333333333;86.6666666666667
95055;2023;10;9;1;90;10;284480;3163.6;104.5
95056;2023;23;16;7;69.5652173913043;30.4347826086957;223722.869565217;3384.60869565217;67.4782608695652
95058;2023;16;16;0;100;0;271891.5625;3167.3125;89.25
95059;2023;7;7;0;100;0;356407.142857143;2780.71428571429;135.142857142857
95060;2023;80;53;27;66.25;33.75;321576.3125;3956.25;84.6
95061;2023;5;4;1;80;20;347800;3098.6;112.6
95063;2023;273;106;167;38.8278388278388;61.1721611721612;278741.608058608;4644.17216117216;61.2417582417582
95074;2023;2;2;0;100;0;357150;4098.5;87
95078;2023;16;13;3;81.25;18.75;271161.5;3110.375;90.125
95088;2023;9;5;4;55.5555555555556;44.4444444444444;218777.777777778;3095.55555555556;72.8888888888889
95091;2023;46;40;6;86.9565217391304;13.0434782608696;306929.369565217;3322.60869565217;95.8695652173913
95094;2023;1;1;0;100;0;188000;2350;80
95101;2023;4;4;0;100;0;253450;2561.25;100.75
95102;2023;7;6;1;85.7142857142857;14.2857142857143;295428.571428571;2915;97.8571428571429
95110;2023;4;4;0;100;0;327890;3409.75;96.75
95116;2023;32;27;5;84.375;15.625;286456.71875;3174.0625;92.0625
95119;2023;6;6;0;100;0;207719.333333333;2683.5;83
95120;2023;30;29;1;96.6666666666667;3.33333333333333;340838.333333333;3768.76666666667;95.7
95127;2023;560;107;453;19.1071428571429;80.8928571428571;204590.335714286;3370.84285714286;64.6607142857143
95134;2023;54;42;12;77.7777777777778;22.2222222222222;295120.37037037;3592.85185185185;85.2592592592593
95139;2023;5;5;0;100;0;288509;3326.2;92.2
95142;2023;25;22;3;88;12;200244.2;2883.84;73.08
95149;2023;45;39;6;86.6666666666667;13.3333333333333;319355.177777778;3762.6;91.2
95150;2023;10;9;1;90;10;245597;2465.9;97.8
95151;2023;2;2;0;100;0;258275;3308;88.5
95157;2023;1;1;0;100;0;371800;3380;110
95166;2023;5;5;0;100;0;300080;2388.2;124.2
95169;2023;2;2;0;100;0;264745;3401;78.5
95170;2023;3;2;1;66.6666666666667;33.3333333333333;269000;2928.33333333333;93.6666666666667
95176;2023;270;137;133;50.7407407407407;49.2592592592593;343806.611111111;4560.28888888889;77
95177;2023;16;15;1;93.75;6.25;283051.4375;2646.0625;106.875
95181;2023;3;3;0;100;0;195816.666666667;3263.33333333333;61.6666666666667
95183;2023;76;44;32;57.8947368421053;42.1052631578947;298937.868421053;3443.34210526316;88.0789473684211
95197;2023;265;97;168;36.6037735849057;63.3962264150943;288256.449056604;3945.91320754717;73.2150943396226
95199;2023;165;71;94;43.030303030303;56.969696969697;256772.472727273;3509.00606060606;74.9878787878788
95203;2023;246;113;133;45.9349593495935;54.0650406504065;337554.910569106;4431.4674796748;78.6016260162602
95205;2023;80;45;35;56.25;43.75;257875.4;3558.3;77.7875
95210;2023;132;31;101;23.4848484848485;76.5151515151515;410296.583333333;5565.34848484848;72.6515151515152
95211;2023;27;24;3;88.8888888888889;11.1111111111111;341439.62962963;3571.07407407407;101.333333333333
95212;2023;2;2;0;100;0;223410;2941.5;75.5
95213;2023;8;8;0;100;0;384232.625;3379.5;114.125
95218;2023;181;96;85;53.0386740331492;46.9613259668508;279632.878453039;3568.2817679558;80.5524861878453
95219;2023;285;97;188;34.0350877192982;65.9649122807018;291204.459649123;4232.75789473684;70.6631578947368
95229;2023;106;51;55;48.1132075471698;51.8867924528302;277002.79245283;3406.42452830189;84.3018867924528
95241;2023;18;14;4;77.7777777777778;22.2222222222222;288881.5;3269.27777777778;91
95250;2023;96;86;10;89.5833333333333;10.4166666666667;243666.833333333;3127.64583333333;83.8125
95252;2023;435;90;345;20.6896551724138;79.3103448275862;232141.055172414;3351.0275862069;69.6183908045977
95253;2023;6;5;1;83.3333333333333;16.6666666666667;324541.5;3033.5;117.166666666667
95254;2023;4;2;2;50;50;267570;3462.5;79
95256;2023;34;30;4;88.2352941176471;11.7647058823529;329525.617647059;3982.20588235294;85.6176470588235
95257;2023;69;48;21;69.5652173913043;30.4347826086957;362619.246376812;4484.36231884058;85.5942028985507
95258;2023;3;3;0;100;0;373500;3304.66666666667;110.333333333333
95268;2023;185;53;132;28.6486486486486;71.3513513513514;174996.416216216;2763.3027027027;64.7135135135135
95270;2023;8;7;1;87.5;12.5;340837.5;3150.25;107
95271;2023;3;3;0;100;0;245133.333333333;2385.66666666667;112.666666666667
95277;2023;143;68;75;47.5524475524476;52.4475524475524;233145.748251748;3143.34965034965;74.8461538461538
95280;2023;147;113;34;76.8707482993197;23.1292517006803;252308.904761905;3630.78911564626;73.3673469387755
95287;2023;4;3;1;75;25;373220.5;2297.25;172.25
95288;2023;73;41;32;56.1643835616438;43.8356164383562;317269.863013699;3999.47945205479;84.5205479452055
95295;2023;2;2;0;100;0;250000;2150.5;114.5
95298;2023;5;5;0;100;0;398800;3406.4;115.6
95301;2023;5;5;0;100;0;290900;2427.4;117
95304;2023;5;5;0;100;0;383510;3151;125
95306;2023;322;184;138;57.1428571428571;42.8571428571429;314754.785714286;4178.95652173913;77.3975155279503
95308;2023;8;7;1;87.5;12.5;337376;2896.875;119
95309;2023;2;2;0;100;0;100395;1106;89
95313;2023;171;84;87;49.1228070175439;50.8771929824561;373059.198830409;4572.28070175439;83.3684210526316
95316;2023;3;2;1;66.6666666666667;33.3333333333333;116666.666666667;1280;91.3333333333333
95323;2023;161;138;23;85.7142857142857;14.2857142857143;293243.782608696;3262.17391304348;92.4534161490683
95328;2023;7;4;3;57.1428571428571;42.8571428571429;296100;3065.57142857143;96.5714285714286
95331;2023;1;1;0;100;0;379000;3716;102
95341;2023;4;4;0;100;0;283125;2629.25;106
95348;2023;5;5;0;100;0;280800;3206.4;95
95351;2023;108;57;51;52.7777777777778;47.2222222222222;228311.37037037;3219.0462962963;73.4537037037037
95352;2023;49;34;15;69.3877551020408;30.6122448979592;327800.673469388;3482.30612244898;95.3673469387755
95353;2023;31;24;7;77.4193548387097;22.5806451612903;294158.387096774;3566.87096774194;85.2903225806452
95355;2023;59;46;13;77.9661016949153;22.0338983050847;243187.491525424;3053.91525423729;81.5423728813559
95365;2023;4;3;1;75;25;244500;2850;85.75
95369;2023;31;18;13;58.0645161290323;41.9354838709677;364656.612903226;4405.70967741936;84.5483870967742
95370;2023;33;27;6;81.8181818181818;18.1818181818182;278210.515151515;3414.33333333333;84.6060606060606
95371;2023;57;51;6;89.4736842105263;10.5263157894737;268095.263157895;3250.85964912281;87.7368421052632
95379;2023;3;3;0;100;0;342316.666666667;3935.33333333333;88.3333333333333
95387;2023;1;1;0;100;0;385000;2917;132
95388;2023;63;50;13;79.3650793650794;20.6349206349206;260496.603174603;3123.7619047619;84.6349206349206
95392;2023;56;41;15;73.2142857142857;26.7857142857143;314741.982142857;3908.5;85.5178571428571
95394;2023;92;53;39;57.6086956521739;42.3913043478261;283623.423913043;3682.51086956522;78.4673913043478
95395;2023;8;8;0;100;0;365861.625;3950;101.375
95409;2023;19;9;10;47.3684210526316;52.6315789473684;250401.052631579;3840.15789473684;70.8947368421053
95422;2023;3;3;0;100;0;422904.333333333;3512;122
95424;2023;190;110;80;57.8947368421053;42.1052631578947;277437.221052632;3660.99473684211;77.5105263157895
95426;2023;20;15;5;75;25;441280;5093.85;97.9
95427;2023;124;63;61;50.8064516129032;49.1935483870968;258130.741935484;3562.25;74.258064516129
95428;2023;254;69;185;27.1653543307087;72.8346456692913;337163.826771654;4356.63385826772;77.6614173228347
95429;2023;4;4;0;100;0;336250;3426.75;99.25
95430;2023;46;32;14;69.5652173913043;30.4347826086957;289045;3098.82608695652;92.6086956521739
95436;2023;11;10;1;90.9090909090909;9.09090909090909;323095.454545455;3095.90909090909;110
95438;2023;4;0;4;0;100;179500;3128.5;68.75
95445;2023;4;3;1;75;25;310975;3263.25;113.75
95446;2023;24;23;1;95.8333333333333;4.16666666666667;343528.125;3863.45833333333;97.1666666666667
95447;2023;4;4;0;100;0;333506.25;2265.5;144.25
95450;2023;17;15;2;88.2352941176471;11.7647058823529;360852.352941176;3754.35294117647;98.5882352941177
95452;2023;12;6;6;50;50;240337.5;3345.25;73.25
95456;2023;10;10;0;100;0;280545;3642.2;85.5
95459;2023;8;8;0;100;0;403692;3411.5;124.25
95462;2023;4;4;0;100;0;238750;2534.25;99.25
95476;2023;142;105;37;73.943661971831;26.056338028169;303181.105633803;3552.71830985915;90.2676056338028
95480;2023;56;54;2;96.4285714285714;3.57142857142857;364907.571428571;3815.80357142857;97.5892857142857
95483;2023;1;1;0;100;0;353000;3530;100
95487;2023;110;43;67;39.0909090909091;60.9090909090909;192934.154545455;3121.58181818182;63.5272727272727
95488;2023;98;63;35;64.2857142857143;35.7142857142857;294131.142857143;4250.40816326531;74.1836734693878
95489;2023;9;7;2;77.7777777777778;22.2222222222222;370388.888888889;4045.55555555556;90
95491;2023;115;50;65;43.4782608695652;56.5217391304348;295878.217391304;3802.21739130435;78.2521739130435
95493;2023;3;3;0;100;0;293200;2426.66666666667;119.666666666667
95500;2023;340;68;272;20;80;206274.494117647;3392.12058823529;65.2794117647059
95504;2023;61;54;7;88.5245901639344;11.4754098360656;338622.967213115;4040.98360655738;87.3770491803279
95509;2023;27;25;2;92.5925925925926;7.40740740740741;273703.703703704;3058.77777777778;92.0740740740741
95510;2023;4;2;2;50;50;262725;3597.5;75.5
95523;2023;4;3;1;75;25;468500;3048.5;116
95527;2023;19;4;15;21.0526315789474;78.9473684210526;202578.947368421;4173.84210526316;51.3684210526316
95529;2023;14;12;2;85.7142857142857;14.2857142857143;274357.142857143;3309.57142857143;94.2857142857143
95535;2023;4;2;2;50;50;252750;2905.25;85.25
95539;2023;149;67;82;44.9664429530201;55.0335570469799;308004.731543624;3866.86577181208;77.8255033557047
95541;2023;4;4;0;100;0;256612.5;2498;101
95543;2023;7;6;1;85.7142857142857;14.2857142857143;267417.857142857;2854.42857142857;99.5714285714286
95554;2023;11;11;0;100;0;273622.727272727;3188.09090909091;88.2727272727273
95555;2023;202;43;159;21.2871287128713;78.7128712871287;285683.321782178;4124.56435643564;69.5940594059406
95563;2023;179;106;73;59.2178770949721;40.7821229050279;325518.810055866;4194.35754189944;79.4692737430168
95566;2023;36;33;3;91.6666666666667;8.33333333333333;304250.416666667;3293.86111111111;96.8333333333333
95572;2023;225;75;150;33.3333333333333;66.6666666666667;224687.511111111;3307.04444444444;69.2311111111111
95574;2023;61;47;14;77.0491803278689;22.9508196721311;450379.737704918;4400.22950819672;105.262295081967
95580;2023;23;19;4;82.6086956521739;17.3913043478261;409801.304347826;3190.21739130435;128.304347826087
95582;2023;269;109;160;40.5204460966543;59.4795539033457;279972.19330855;4032.75092936803;71.7620817843866
95584;2023;6;6;0;100;0;349917;3576.66666666667;94.3333333333333
95585;2023;275;86;189;31.2727272727273;68.7272727272727;202930.770909091;2653.35636363636;78.0872727272727
95592;2023;14;14;0;100;0;298196.428571429;3219.07142857143;100.214285714286
95594;2023;15;12;3;80;20;344752.666666667;3542.53333333333;101.066666666667
95598;2023;156;64;92;41.025641025641;58.974358974359;326122.346153846;4095.78205128205;79.0320512820513
95604;2023;53;26;27;49.0566037735849;50.9433962264151;215620;2865.79245283019;80.1698113207547
95607;2023;310;156;154;50.3225806451613;49.6774193548387;278235.748387097;3616.0064516129;77.7451612903226
95610;2023;5;5;0;100;0;316316;2620.6;120.8
95612;2023;32;25;7;78.125;21.875;269612.21875;3619.9375;78.34375
95625;2023;11;9;2;81.8181818181818;18.1818181818182;214790.909090909;2811.72727272727;78.9090909090909
95627;2023;5;5;0;100;0;377720;3628.6;120.6
95628;2023;16;10;6;62.5;37.5;298878.125;3796.0625;91.8125
95637;2023;146;92;54;63.013698630137;36.986301369863;285150.726027397;3882.2602739726;79.1712328767123
95641;2023;31;16;15;51.6129032258064;48.3870967741936;237054.838709677;3551.67741935484;69.6129032258064
95651;2023;11;9;2;81.8181818181818;18.1818181818182;264427.272727273;2244.45454545455;114.181818181818
95652;2023;53;49;4;92.4528301886792;7.54716981132075;306106.603773585;3521.67924528302;88.0754716981132
95656;2023;12;12;0;100;0;317458.333333333;2745.83333333333;116.666666666667
95658;2023;11;11;0;100;0;381568.181818182;3371;120.454545454545
95660;2023;5;5;0;100;0;373600;3750.2;104.6
95675;2023;12;5;7;41.6666666666667;58.3333333333333;271166.666666667;3686.25;75.75
95676;2023;2;2;0;100;0;371650;2555;147
95678;2023;10;8;2;80;20;375823;4292.6;85.7
95680;2023;144;45;99;31.25;68.75;174609.027777778;2621.68055555556;68.3125
95682;2023;1;1;0;100;0;2,00E+05;3333;60
95690;2023;3;3;0;100;0;391683.333333333;2706;147.666666666667
;2023;8530;;;49.4724501758499;50.5275498241501;227263.892262603;3154.71969519343;73.2712778429074
